PokerStars Game #20095384632:  Hold'em No Limit ($0.10/$0.25) - 2008/09/02 15:14:37 ET
Table 'Rauma' 9-max Seat #7 is the button
Seat 1: powerle ($10 in chips) 
Seat 2: Sortime ($41.10 in chips) 
Seat 4: takikardiko ($24.40 in chips) 
Seat 6: quadtan ($25.70 in chips) 
Seat 7: Mendarik ($8.25 in chips) 
Seat 8: jaibox ($15.25 in chips) 
Seat 9: Alameda22 ($25 in chips) 
jaibox: posts small blind $0.10
Alameda22: posts big blind $0.25
theshu1: sits out 
*** HOLE CARDS ***
Dealt to Alameda22 [4d 2s]
powerle: folds 
Sortime: folds 
takikardiko: folds 
quadtan: folds 
Mendarik: folds 
jaibox: calls $0.15
helenwait has returned
Alameda22: checks 
*** FLOP *** [Tc Qd Qs]
jaibox: checks 
Alameda22: checks 
*** TURN *** [Tc Qd Qs] [7d]
jaibox: bets $0.25
Alameda22: folds 
Uncalled bet ($0.25) returned to jaibox
jaibox collected $0.50 from pot
jaibox: doesn't show hand 
*** SUMMARY ***
Total pot $0.50 | Rake $0 
Board [Tc Qd Qs 7d]
Seat 1: powerle folded before Flop (didn't bet)
Seat 2: Sortime folded before Flop (didn't bet)
Seat 4: takikardiko folded before Flop (didn't bet)
Seat 6: quadtan folded before Flop (didn't bet)
Seat 7: Mendarik (button) folded before Flop (didn't bet)
Seat 8: jaibox (small blind) collected ($0.50)
Seat 9: Alameda22 (big blind) folded on the Turn



PokerStars Game #20095411581:  Hold'em No Limit ($0.10/$0.25) - 2008/09/02 15:15:46 ET
Table 'Rauma' 9-max Seat #8 is the button
Seat 1: powerle ($10 in chips) 
Seat 2: Sortime ($41.10 in chips) 
Seat 3: helenwait ($21.90 in chips) 
Seat 4: takikardiko ($24.40 in chips) 
Seat 6: quadtan ($25.70 in chips) 
Seat 7: Mendarik ($8.25 in chips) 
Seat 8: jaibox ($15.50 in chips) 
Seat 9: Alameda22 ($24.75 in chips) 
Alameda22: posts small blind $0.10
powerle: posts big blind $0.25
theshu1: sits out 
*** HOLE CARDS ***
Dealt to Alameda22 [As 6h]
Sortime: folds 
helenwait: folds 
takikardiko: folds 
quadtan: folds 
quadtan leaves the table
Mendarik: folds 
jaibox: folds 
Alameda22: folds 
Uncalled bet ($0.15) returned to powerle
powerle collected $0.20 from pot
powerle: doesn't show hand 
*** SUMMARY ***
Total pot $0.20 | Rake $0 
Seat 1: powerle (big blind) collected ($0.20)
Seat 2: Sortime folded before Flop (didn't bet)
Seat 3: helenwait folded before Flop (didn't bet)
Seat 4: takikardiko folded before Flop (didn't bet)
Seat 6: quadtan folded before Flop (didn't bet)
Seat 7: Mendarik folded before Flop (didn't bet)
Seat 8: jaibox (button) folded before Flop (didn't bet)
Seat 9: Alameda22 (small blind) folded before Flop



PokerStars Game #20095426689:  Hold'em No Limit ($0.10/$0.25) - 2008/09/02 15:16:22 ET
Table 'Rauma' 9-max Seat #9 is the button
Seat 1: powerle ($10.10 in chips) 
Seat 2: Sortime ($41.10 in chips) 
Seat 3: helenwait ($21.90 in chips) 
Seat 4: takikardiko ($24.40 in chips) 
Seat 7: Mendarik ($8.25 in chips) 
Seat 8: jaibox ($15.50 in chips) 
Seat 9: Alameda22 ($24.65 in chips) 
powerle: posts small blind $0.10
Sortime: posts big blind $0.25
theshu1: sits out 
*** HOLE CARDS ***
Dealt to Alameda22 [Ah 6h]
lxamE joins the table at seat #6 
helenwait: raises $0.50 to $0.75
takikardiko: folds 
Mendarik: folds 
jaibox: folds 
Alameda22: folds 
powerle: folds 
Sortime: folds 
Uncalled bet ($0.50) returned to helenwait
helenwait collected $0.60 from pot
helenwait: doesn't show hand 
*** SUMMARY ***
Total pot $0.60 | Rake $0 
Seat 1: powerle (small blind) folded before Flop
Seat 2: Sortime (big blind) folded before Flop
Seat 3: helenwait collected ($0.60)
Seat 4: takikardiko folded before Flop (didn't bet)
Seat 7: Mendarik folded before Flop (didn't bet)
Seat 8: jaibox folded before Flop (didn't bet)
Seat 9: Alameda22 (button) folded before Flop (didn't bet)



PokerStars Game #20095445604:  Hold'em No Limit ($0.10/$0.25) - 2008/09/02 15:17:07 ET
Table 'Rauma' 9-max Seat #1 is the button
Seat 1: powerle ($10 in chips) 
Seat 2: Sortime ($40.85 in chips) 
Seat 3: helenwait ($22.25 in chips) 
Seat 4: takikardiko ($24.40 in chips) 
Seat 7: Mendarik ($8.25 in chips) 
Seat 8: jaibox ($15.50 in chips) 
Seat 9: Alameda22 ($24.65 in chips) 
Sortime: posts small blind $0.10
helenwait: posts big blind $0.25
theshu1: sits out 
lxamE: sits out 
*** HOLE CARDS ***
Dealt to Alameda22 [8s 9d]
takikardiko: folds 
Mendarik: folds 
jaibox: folds 
Alameda22: folds 
powerle: raises $0.50 to $0.75
Sortime: folds 
helenwait: folds 
Uncalled bet ($0.50) returned to powerle
powerle collected $0.60 from pot
powerle: doesn't show hand 
*** SUMMARY ***
Total pot $0.60 | Rake $0 
Seat 1: powerle (button) collected ($0.60)
Seat 2: Sortime (small blind) folded before Flop
Seat 3: helenwait (big blind) folded before Flop
Seat 4: takikardiko folded before Flop (didn't bet)
Seat 7: Mendarik folded before Flop (didn't bet)
Seat 8: jaibox folded before Flop (didn't bet)
Seat 9: Alameda22 folded before Flop (didn't bet)



PokerStars Game #20095460930:  Hold'em No Limit ($0.10/$0.25) - 2008/09/02 15:17:44 ET
Table 'Rauma' 9-max Seat #2 is the button
Seat 1: powerle ($10.35 in chips) 
Seat 2: Sortime ($40.75 in chips) 
Seat 3: helenwait ($22 in chips) 
Seat 4: takikardiko ($24.40 in chips) 
Seat 7: Mendarik ($8.25 in chips) 
Seat 8: jaibox ($15.50 in chips) 
Seat 9: Alameda22 ($24.65 in chips) 
helenwait: posts small blind $0.10
takikardiko: posts big blind $0.25
theshu1: sits out 
lxamE: sits out 
*** HOLE CARDS ***
Dealt to Alameda22 [Jc 5d]
Mendarik: folds 
jaibox: folds 
Alameda22: folds 
powerle: calls $0.25
Sortime: folds 
helenwait: calls $0.15
takikardiko: checks 
*** FLOP *** [5c 4c 7h]
helenwait: checks 
takikardiko: checks 
powerle: checks 
*** TURN *** [5c 4c 7h] [Jh]
helenwait: checks 
takikardiko: checks 
powerle: bets $0.50
helenwait: folds 
takikardiko: folds 
Uncalled bet ($0.50) returned to powerle
powerle collected $0.75 from pot
powerle: doesn't show hand 
*** SUMMARY ***
Total pot $0.75 | Rake $0 
Board [5c 4c 7h Jh]
Seat 1: powerle collected ($0.75)
Seat 2: Sortime (button) folded before Flop (didn't bet)
Seat 3: helenwait (small blind) folded on the Turn
Seat 4: takikardiko (big blind) folded on the Turn
Seat 7: Mendarik folded before Flop (didn't bet)
Seat 8: jaibox folded before Flop (didn't bet)
Seat 9: Alameda22 folded before Flop (didn't bet)



PokerStars Game #20095483897:  Hold'em No Limit ($0.10/$0.25) - 2008/09/02 15:18:39 ET
Table 'Rauma' 9-max Seat #3 is the button
Seat 1: powerle ($10.85 in chips) 
Seat 2: Sortime ($40.75 in chips) 
Seat 3: helenwait ($21.75 in chips) 
Seat 4: takikardiko ($24.15 in chips) 
Seat 5: theshu1 ($21.60 in chips) 
Seat 7: Mendarik ($8.25 in chips) 
Seat 8: jaibox ($15.50 in chips) 
Seat 9: Alameda22 ($24.65 in chips) 
takikardiko: posts small blind $0.10
theshu1: posts big blind $0.25
lxamE: sits out 
*** HOLE CARDS ***
Dealt to Alameda22 [Th Js]
Mendarik: folds 
jaibox: folds 
Alameda22: folds 
powerle: folds 
Sortime: folds 
helenwait: raises $0.50 to $0.75
takikardiko: folds 
theshu1: folds 
Uncalled bet ($0.50) returned to helenwait
helenwait collected $0.60 from pot
helenwait: doesn't show hand 
*** SUMMARY ***
Total pot $0.60 | Rake $0 
Seat 1: powerle folded before Flop (didn't bet)
Seat 2: Sortime folded before Flop (didn't bet)
Seat 3: helenwait (button) collected ($0.60)
Seat 4: takikardiko (small blind) folded before Flop
Seat 5: theshu1 (big blind) folded before Flop
Seat 7: Mendarik folded before Flop (didn't bet)
Seat 8: jaibox folded before Flop (didn't bet)
Seat 9: Alameda22 folded before Flop (didn't bet)



PokerStars Game #20095499010:  Hold'em No Limit ($0.10/$0.25) - 2008/09/02 15:19:15 ET
Table 'Rauma' 9-max Seat #4 is the button
Seat 1: powerle ($10.85 in chips) 
Seat 2: Sortime ($40.75 in chips) 
Seat 3: helenwait ($22.10 in chips) 
Seat 4: takikardiko ($24.05 in chips) 
Seat 5: theshu1 ($21.35 in chips) 
Seat 6: lxamE ($5 in chips) 
Seat 7: Mendarik ($8.25 in chips) 
Seat 8: jaibox ($15.50 in chips) 
Seat 9: Alameda22 ($24.65 in chips) 
theshu1: posts small blind $0.10
lxamE: posts big blind $0.25
*** HOLE CARDS ***
Dealt to Alameda22 [8c 4c]
Mendarik: raises $0.25 to $0.50
jaibox: folds 
Alameda22: folds 
powerle: folds 
Sortime: folds 
helenwait: folds 
takikardiko: folds 
theshu1: folds 
lxamE: folds 
Uncalled bet ($0.25) returned to Mendarik
Mendarik collected $0.60 from pot
Mendarik: shows [As Ac] (a pair of Aces)
*** SUMMARY ***
Total pot $0.60 | Rake $0 
Seat 1: powerle folded before Flop (didn't bet)
Seat 2: Sortime folded before Flop (didn't bet)
Seat 3: helenwait folded before Flop (didn't bet)
Seat 4: takikardiko (button) folded before Flop (didn't bet)
Seat 5: theshu1 (small blind) folded before Flop
Seat 6: lxamE (big blind) folded before Flop
Seat 7: Mendarik collected ($0.60)
Seat 8: jaibox folded before Flop (didn't bet)
Seat 9: Alameda22 folded before Flop (didn't bet)



PokerStars Game #20095523455:  Hold'em No Limit ($0.10/$0.25) - 2008/09/02 15:20:14 ET
Table 'Rauma' 9-max Seat #5 is the button
Seat 1: powerle ($10.85 in chips) 
Seat 2: Sortime ($40.75 in chips) 
Seat 3: helenwait ($22.10 in chips) 
Seat 4: takikardiko ($24.05 in chips) 
Seat 5: theshu1 ($21.25 in chips) 
Seat 6: lxamE ($4.75 in chips) 
Seat 8: jaibox ($15.50 in chips) 
Seat 9: Alameda22 ($24.65 in chips) 
lxamE: posts small blind $0.10
Mendarik: is sitting out 
jaibox: posts big blind $0.25
*** HOLE CARDS ***
Dealt to Alameda22 [6d 4d]
Mendarik leaves the table
Alameda22: folds 
powerle: folds 
Sortime: folds 
helenwait: folds 
takikardiko: calls $0.25
Crazy685 joins the table at seat #7 
theshu1: folds 
lxamE: folds 
jaibox: checks 
*** FLOP *** [Jd 6h 3d]
jaibox: checks 
takikardiko: bets $0.50
jaibox: folds 
Uncalled bet ($0.50) returned to takikardiko
takikardiko collected $0.60 from pot
takikardiko: doesn't show hand 
*** SUMMARY ***
Total pot $0.60 | Rake $0 
Board [Jd 6h 3d]
Seat 1: powerle folded before Flop (didn't bet)
Seat 2: Sortime folded before Flop (didn't bet)
Seat 3: helenwait folded before Flop (didn't bet)
Seat 4: takikardiko collected ($0.60)
Seat 5: theshu1 (button) folded before Flop (didn't bet)
Seat 6: lxamE (small blind) folded before Flop
Seat 8: jaibox (big blind) folded on the Flop
Seat 9: Alameda22 folded before Flop (didn't bet)



PokerStars Game #20095542864:  Hold'em No Limit ($0.10/$0.25) - 2008/09/02 15:21:00 ET
Table 'Rauma' 9-max Seat #6 is the button
Seat 1: powerle ($10.85 in chips) 
Seat 2: Sortime ($40.75 in chips) 
Seat 3: helenwait ($22.10 in chips) 
Seat 4: takikardiko ($24.40 in chips) 
Seat 5: theshu1 ($21.25 in chips) 
Seat 6: lxamE ($4.65 in chips) 
Seat 8: jaibox ($15.25 in chips) 
Seat 9: Alameda22 ($24.65 in chips) 
Crazy685 will be allowed to play after the button
jaibox: posts small blind $0.10
Alameda22: posts big blind $0.25
*** HOLE CARDS ***
Dealt to Alameda22 [6h 9c]
powerle: folds 
Sortime: folds 
helenwait: folds 
takikardiko: folds 
theshu1: folds 
lxamE: raises $0.75 to $1
jaibox: folds 
Alameda22: folds 
Uncalled bet ($0.75) returned to lxamE
lxamE collected $0.60 from pot
lxamE: doesn't show hand 
*** SUMMARY ***
Total pot $0.60 | Rake $0 
Seat 1: powerle folded before Flop (didn't bet)
Seat 2: Sortime folded before Flop (didn't bet)
Seat 3: helenwait folded before Flop (didn't bet)
Seat 4: takikardiko folded before Flop (didn't bet)
Seat 5: theshu1 folded before Flop (didn't bet)
Seat 6: lxamE (button) collected ($0.60)
Seat 8: jaibox (small blind) folded before Flop
Seat 9: Alameda22 (big blind) folded before Flop



PokerStars Game #20095559286:  Hold'em No Limit ($0.10/$0.25) - 2008/09/02 15:21:39 ET
Table 'Rauma' 9-max Seat #8 is the button
Seat 1: powerle ($10.85 in chips) 
Seat 2: Sortime ($40.75 in chips) 
Seat 3: helenwait ($22.10 in chips) 
Seat 4: takikardiko ($24.40 in chips) 
Seat 5: theshu1 ($21.25 in chips) 
Seat 6: lxamE ($5 in chips) 
Seat 7: Crazy685 ($25 in chips) 
Seat 8: jaibox ($15.15 in chips) 
Seat 9: Alameda22 ($24.40 in chips) 
Alameda22: posts small blind $0.10
powerle: posts big blind $0.25
Crazy685: posts big blind $0.25
*** HOLE CARDS ***
Dealt to Alameda22 [5c Qs]
Sortime: folds 
helenwait: folds 
takikardiko: raises $1.25 to $1.50
theshu1: folds 
lxamE: folds 
Crazy685: folds 
jaibox: folds 
Alameda22: folds 
powerle: folds 
Uncalled bet ($1.25) returned to takikardiko
takikardiko collected $0.85 from pot
takikardiko: doesn't show hand 
*** SUMMARY ***
Total pot $0.85 | Rake $0 
Seat 1: powerle (big blind) folded before Flop
Seat 2: Sortime folded before Flop (didn't bet)
Seat 3: helenwait folded before Flop (didn't bet)
Seat 4: takikardiko collected ($0.85)
Seat 5: theshu1 folded before Flop (didn't bet)
Seat 6: lxamE folded before Flop (didn't bet)
Seat 7: Crazy685 folded before Flop
Seat 8: jaibox (button) folded before Flop (didn't bet)
Seat 9: Alameda22 (small blind) folded before Flop



PokerStars Game #20095571645:  Hold'em No Limit ($0.10/$0.25) - 2008/09/02 15:22:08 ET
Table 'Rauma' 9-max Seat #9 is the button
Seat 1: powerle ($10.60 in chips) 
Seat 2: Sortime ($40.75 in chips) 
Seat 3: helenwait ($22.10 in chips) 
Seat 4: takikardiko ($25 in chips) 
Seat 5: theshu1 ($21.25 in chips) 
Seat 6: lxamE ($5 in chips) 
Seat 7: Crazy685 ($24.75 in chips) 
Seat 8: jaibox ($15.15 in chips) 
Seat 9: Alameda22 ($24.30 in chips) 
powerle: posts small blind $0.10
Sortime: posts big blind $0.25
*** HOLE CARDS ***
Dealt to Alameda22 [Ad Kc]
helenwait: folds 
takikardiko: folds 
theshu1: folds 
lxamE: folds 
Crazy685: calls $0.25
jaibox: folds 
Alameda22: raises $1 to $1.25
powerle: folds 
Sortime: folds 
Crazy685: folds 
Uncalled bet ($1) returned to Alameda22
Alameda22 collected $0.85 from pot
Alameda22: doesn't show hand 
*** SUMMARY ***
Total pot $0.85 | Rake $0 
Seat 1: powerle (small blind) folded before Flop
Seat 2: Sortime (big blind) folded before Flop
Seat 3: helenwait folded before Flop (didn't bet)
Seat 4: takikardiko folded before Flop (didn't bet)
Seat 5: theshu1 folded before Flop (didn't bet)
Seat 6: lxamE folded before Flop (didn't bet)
Seat 7: Crazy685 folded before Flop
Seat 8: jaibox folded before Flop (didn't bet)
Seat 9: Alameda22 (button) collected ($0.85)



PokerStars Game #20095604297:  Hold'em No Limit ($0.10/$0.25) - 2008/09/02 15:23:25 ET
Table 'Rauma' 9-max Seat #1 is the button
Seat 1: powerle ($10.50 in chips) 
Seat 2: Sortime ($40.50 in chips) 
Seat 3: helenwait ($22.10 in chips) 
Seat 4: takikardiko ($25 in chips) 
Seat 5: theshu1 ($21.25 in chips) 
Seat 6: lxamE ($5 in chips) 
Seat 7: Crazy685 ($24.50 in chips) 
Seat 8: jaibox ($15.15 in chips) 
Seat 9: Alameda22 ($24.90 in chips) 
Sortime: posts small blind $0.10
helenwait: posts big blind $0.25
*** HOLE CARDS ***
Dealt to Alameda22 [5s 2c]
takikardiko: folds 
theshu1: raises $0.75 to $1
lxamE: folds 
Crazy685: folds 
jaibox: folds 
Alameda22: folds 
powerle: folds 
Sortime: folds 
helenwait: folds 
Uncalled bet ($0.75) returned to theshu1
theshu1 collected $0.60 from pot
theshu1: doesn't show hand 
*** SUMMARY ***
Total pot $0.60 | Rake $0 
Seat 1: powerle (button) folded before Flop (didn't bet)
Seat 2: Sortime (small blind) folded before Flop
Seat 3: helenwait (big blind) folded before Flop
Seat 4: takikardiko folded before Flop (didn't bet)
Seat 5: theshu1 collected ($0.60)
Seat 6: lxamE folded before Flop (didn't bet)
Seat 7: Crazy685 folded before Flop (didn't bet)
Seat 8: jaibox folded before Flop (didn't bet)
Seat 9: Alameda22 folded before Flop (didn't bet)



PokerStars Game #20095619265:  Hold'em No Limit ($0.10/$0.25) - 2008/09/02 15:24:00 ET
Table 'Rauma' 9-max Seat #2 is the button
Seat 1: powerle ($10.50 in chips) 
Seat 2: Sortime ($40.40 in chips) 
Seat 3: helenwait ($21.85 in chips) 
Seat 4: takikardiko ($25 in chips) 
Seat 5: theshu1 ($21.60 in chips) 
Seat 6: lxamE ($5 in chips) 
Seat 7: Crazy685 ($24.50 in chips) 
Seat 8: jaibox ($15.15 in chips) 
Seat 9: Alameda22 ($24.90 in chips) 
helenwait: posts small blind $0.10
takikardiko: posts big blind $0.25
*** HOLE CARDS ***
Dealt to Alameda22 [Jh 2d]
theshu1: folds 
lxamE: folds 
Crazy685: folds 
jaibox: calls $0.25
Alameda22: folds 
powerle: folds 
Sortime: folds 
helenwait: calls $0.15
takikardiko: checks 
*** FLOP *** [Kc Th 8s]
helenwait: checks 
takikardiko: checks 
jaibox: checks 
*** TURN *** [Kc Th 8s] [Kd]
helenwait: checks 
takikardiko: checks 
jaibox: checks 
*** RIVER *** [Kc Th 8s Kd] [8h]
helenwait: bets $0.25
takikardiko: folds 
jaibox: folds 
Uncalled bet ($0.25) returned to helenwait
helenwait collected $0.75 from pot
helenwait: doesn't show hand 
*** SUMMARY ***
Total pot $0.75 | Rake $0 
Board [Kc Th 8s Kd 8h]
Seat 1: powerle folded before Flop (didn't bet)
Seat 2: Sortime (button) folded before Flop (didn't bet)
Seat 3: helenwait (small blind) collected ($0.75)
Seat 4: takikardiko (big blind) folded on the River
Seat 5: theshu1 folded before Flop (didn't bet)
Seat 6: lxamE folded before Flop (didn't bet)
Seat 7: Crazy685 folded before Flop (didn't bet)
Seat 8: jaibox folded on the River
Seat 9: Alameda22 folded before Flop (didn't bet)



PokerStars Game #20095650620:  Hold'em No Limit ($0.10/$0.25) - 2008/09/02 15:25:14 ET
Table 'Rauma' 9-max Seat #3 is the button
Seat 1: powerle ($10.50 in chips) 
Seat 2: Sortime ($40.40 in chips) 
Seat 3: helenwait ($22.35 in chips) 
Seat 4: takikardiko ($24.75 in chips) 
Seat 5: theshu1 ($21.60 in chips) 
Seat 6: lxamE ($5 in chips) 
Seat 7: Crazy685 ($24.50 in chips) 
Seat 8: jaibox ($14.90 in chips) 
Seat 9: Alameda22 ($24.90 in chips) 
takikardiko: posts small blind $0.10
theshu1: posts big blind $0.25
*** HOLE CARDS ***
Dealt to Alameda22 [8s Kc]
lxamE: folds 
Crazy685: calls $0.25
jaibox: folds 
Alameda22: folds 
powerle: calls $0.25
Sortime: folds 
helenwait: folds 
takikardiko: folds 
theshu1: raises $1.50 to $1.75
Crazy685: folds 
powerle: folds 
Uncalled bet ($1.50) returned to theshu1
theshu1 collected $0.85 from pot
theshu1: doesn't show hand 
*** SUMMARY ***
Total pot $0.85 | Rake $0 
Seat 1: powerle folded before Flop
Seat 2: Sortime folded before Flop (didn't bet)
Seat 3: helenwait (button) folded before Flop (didn't bet)
Seat 4: takikardiko (small blind) folded before Flop
Seat 5: theshu1 (big blind) collected ($0.85)
Seat 6: lxamE folded before Flop (didn't bet)
Seat 7: Crazy685 folded before Flop
Seat 8: jaibox folded before Flop (didn't bet)
Seat 9: Alameda22 folded before Flop (didn't bet)



PokerStars Game #20095664484:  Hold'em No Limit ($0.10/$0.25) - 2008/09/02 15:25:46 ET
Table 'Rauma' 9-max Seat #4 is the button
Seat 1: powerle ($10.25 in chips) 
Seat 2: Sortime ($40.40 in chips) 
Seat 3: helenwait ($22.35 in chips) 
Seat 4: takikardiko ($24.65 in chips) 
Seat 5: theshu1 ($22.20 in chips) 
Seat 6: lxamE ($5 in chips) 
Seat 7: Crazy685 ($24.25 in chips) 
Seat 8: jaibox ($14.90 in chips) 
Seat 9: Alameda22 ($24.90 in chips) 
theshu1: posts small blind $0.10
lxamE: posts big blind $0.25
*** HOLE CARDS ***
Dealt to Alameda22 [4s 8c]
Crazy685: folds 
jaibox: folds 
Alameda22: folds 
powerle: folds 
Sortime: folds 
helenwait: folds 
takikardiko: folds 
theshu1: calls $0.15
lxamE: checks 
*** FLOP *** [7c 9d Ad]
theshu1: checks 
lxamE: bets $0.50
theshu1: calls $0.50
*** TURN *** [7c 9d Ad] [6d]
theshu1: bets $1.50
lxamE: calls $1.50
*** RIVER *** [7c 9d Ad 6d] [Ks]
theshu1: checks 
lxamE: checks 
*** SHOW DOWN ***
theshu1: shows [Jc Kc] (a pair of Kings)
lxamE: shows [2c Ac] (a pair of Aces)
lxamE collected $4.30 from pot
*** SUMMARY ***
Total pot $4.50 | Rake $0.20 
Board [7c 9d Ad 6d Ks]
Seat 1: powerle folded before Flop (didn't bet)
Seat 2: Sortime folded before Flop (didn't bet)
Seat 3: helenwait folded before Flop (didn't bet)
Seat 4: takikardiko (button) folded before Flop (didn't bet)
Seat 5: theshu1 (small blind) showed [Jc Kc] and lost with a pair of Kings
Seat 6: lxamE (big blind) showed [2c Ac] and won ($4.30) with a pair of Aces
Seat 7: Crazy685 folded before Flop (didn't bet)
Seat 8: jaibox folded before Flop (didn't bet)
Seat 9: Alameda22 folded before Flop (didn't bet)



PokerStars Game #20095691131:  Hold'em No Limit ($0.10/$0.25) - 2008/09/02 15:26:49 ET
Table 'Rauma' 9-max Seat #5 is the button
Seat 1: powerle ($10.25 in chips) 
Seat 2: Sortime ($40.40 in chips) 
Seat 3: helenwait ($22.35 in chips) 
Seat 4: takikardiko ($24.65 in chips) 
Seat 5: theshu1 ($19.95 in chips) 
Seat 6: lxamE ($7.05 in chips) 
Seat 7: Crazy685 ($24.25 in chips) 
Seat 8: jaibox ($14.90 in chips) 
Seat 9: Alameda22 ($24.90 in chips) 
lxamE: posts small blind $0.10
Crazy685: posts big blind $0.25
*** HOLE CARDS ***
Dealt to Alameda22 [4s 5h]
jaibox: folds 
Alameda22: folds 
jaibox leaves the table
powerle: calls $0.25
Sortime: folds 
helenwait: folds 
takikardiko: folds 
theshu1: calls $0.25
lxamE: folds 
Crazy685: checks 
*** FLOP *** [Kh 9h Jh]
Crazy685: checks 
powerle: checks 
theshu1: checks 
*** TURN *** [Kh 9h Jh] [2c]
Crazy685: bets $1
powerle: folds 
theshu1: folds 
Uncalled bet ($1) returned to Crazy685
Crazy685 collected $0.85 from pot
Crazy685: doesn't show hand 
*** SUMMARY ***
Total pot $0.85 | Rake $0 
Board [Kh 9h Jh 2c]
Seat 1: powerle folded on the Turn
Seat 2: Sortime folded before Flop (didn't bet)
Seat 3: helenwait folded before Flop (didn't bet)
Seat 4: takikardiko folded before Flop (didn't bet)
Seat 5: theshu1 (button) folded on the Turn
Seat 6: lxamE (small blind) folded before Flop
Seat 7: Crazy685 (big blind) collected ($0.85)
Seat 8: jaibox folded before Flop (didn't bet)
Seat 9: Alameda22 folded before Flop (didn't bet)



PokerStars Game #20095717689:  Hold'em No Limit ($0.10/$0.25) - 2008/09/02 15:27:51 ET
Table 'Rauma' 9-max Seat #6 is the button
Seat 1: powerle ($10 in chips) 
Seat 2: Sortime ($40.40 in chips) 
Seat 3: helenwait ($22.35 in chips) 
Seat 4: takikardiko ($24.65 in chips) 
Seat 5: theshu1 ($19.70 in chips) 
Seat 6: lxamE ($6.95 in chips) 
Seat 7: Crazy685 ($24.85 in chips) 
Seat 9: Alameda22 ($24.90 in chips) 
Crazy685: posts small blind $0.10
Alameda22: posts big blind $0.25
*** HOLE CARDS ***
Dealt to Alameda22 [6h 6c]
powerle: folds 
Sortime: folds 
helenwait: folds 
takikardiko: raises $0.75 to $1
theshu1: folds 
lxamE: folds 
Crazy685: folds 
Alameda22: calls $0.75
*** FLOP *** [2d Qc 3d]
Alameda22: checks 
takikardiko: bets $1.50
Alameda22: folds 
Uncalled bet ($1.50) returned to takikardiko
takikardiko collected $2 from pot
takikardiko: doesn't show hand 
*** SUMMARY ***
Total pot $2.10 | Rake $0.10 
Board [2d Qc 3d]
Seat 1: powerle folded before Flop (didn't bet)
Seat 2: Sortime folded before Flop (didn't bet)
Seat 3: helenwait folded before Flop (didn't bet)
Seat 4: takikardiko collected ($2)
Seat 5: theshu1 folded before Flop (didn't bet)
Seat 6: lxamE (button) folded before Flop (didn't bet)
Seat 7: Crazy685 (small blind) folded before Flop
Seat 9: Alameda22 (big blind) folded on the Flop



PokerStars Game #20095742964:  Hold'em No Limit ($0.10/$0.25) - 2008/09/02 15:28:50 ET
Table 'Rauma' 9-max Seat #7 is the button
Seat 1: powerle ($10 in chips) 
Seat 2: Sortime ($40.40 in chips) 
Seat 3: helenwait ($22.35 in chips) 
Seat 4: takikardiko ($25.65 in chips) 
Seat 5: theshu1 ($19.70 in chips) 
Seat 6: lxamE ($6.95 in chips) 
Seat 7: Crazy685 ($24.75 in chips) 
Seat 9: Alameda22 ($23.90 in chips) 
Alameda22: posts small blind $0.10
powerle: posts big blind $0.25
*** HOLE CARDS ***
Dealt to Alameda22 [8c 2d]
Sortime: folds 
helenwait: folds 
takikardiko: folds 
theshu1: raises $0.75 to $1
lxamE: folds 
Crazy685: calls $1
Alameda22: folds 
powerle: calls $0.75
*** FLOP *** [4h Td 3c]
powerle: bets $2
theshu1: folds 
oberst_dicht joins the table at seat #8 
Crazy685: calls $2
*** TURN *** [4h Td 3c] [Ts]
powerle: bets $2
Crazy685: raises $2 to $4
powerle: raises $3 to $7 and is all-in
Crazy685: calls $3
*** RIVER *** [4h Td 3c Ts] [9d]
*** SHOW DOWN ***
powerle: shows [9s 9c] (a full house, Nines full of Tens)
Crazy685: mucks hand 
Crazy685 said, "oh my god"
powerle collected $20.10 from pot
Crazy685 said, "what a river"
*** SUMMARY ***
Total pot $21.10 | Rake $1 
Board [4h Td 3c Ts 9d]
Seat 1: powerle (big blind) showed [9s 9c] and won ($20.10) with a full house, Nines full of Tens
Seat 2: Sortime folded before Flop (didn't bet)
Seat 3: helenwait folded before Flop (didn't bet)
Seat 4: takikardiko folded before Flop (didn't bet)
Seat 5: theshu1 folded on the Flop
Seat 6: lxamE folded before Flop (didn't bet)
Seat 7: Crazy685 (button) mucked [7h Th]
Seat 9: Alameda22 (small blind) folded before Flop



PokerStars Game #20095769913:  Hold'em No Limit ($0.10/$0.25) - 2008/09/02 15:29:54 ET
Table 'Rauma' 9-max Seat #9 is the button
Seat 1: powerle ($20.10 in chips) 
Seat 2: Sortime ($40.40 in chips) 
Seat 3: helenwait ($22.35 in chips) 
Seat 4: takikardiko ($25.65 in chips) 
Seat 5: theshu1 ($18.70 in chips) 
Seat 6: lxamE ($6.95 in chips) 
Seat 7: Crazy685 ($14.75 in chips) 
Seat 8: oberst_dicht ($15.40 in chips) 
Seat 9: Alameda22 ($23.80 in chips) 
powerle: posts small blind $0.10
Sortime: posts big blind $0.25
oberst_dicht: posts big blind $0.25
*** HOLE CARDS ***
Dealt to Alameda22 [As Js]
helenwait: folds 
takikardiko: folds 
theshu1: folds 
Crazy685 said, "2 outer. brilliant"
lxamE: folds 
Crazy685: raises $0.75 to $1
helenwait leaves the table
oberst_dicht: folds 
Alameda22: folds 
powerle: folds 
Sortime: calls $0.75
*** FLOP *** [9c 3d Qc]
Sortime: checks 
Crazy685: checks 
*** TURN *** [9c 3d Qc] [Kh]
murphy-mcben joins the table at seat #3 
Sortime: bets $0.75
Crazy685: calls $0.75
*** RIVER *** [9c 3d Qc Kh] [7s]
Sortime: checks 
Crazy685 said, "lol wheres my 2 outer"
Crazy685: checks 
*** SHOW DOWN ***
Sortime: shows [Jh Qh] (a pair of Queens)
Crazy685: mucks hand 
Sortime collected $3.70 from pot
*** SUMMARY ***
Total pot $3.85 | Rake $0.15 
Board [9c 3d Qc Kh 7s]
Seat 1: powerle (small blind) folded before Flop
Seat 2: Sortime (big blind) showed [Jh Qh] and won ($3.70) with a pair of Queens
Seat 3: helenwait folded before Flop (didn't bet)
Seat 4: takikardiko folded before Flop (didn't bet)
Seat 5: theshu1 folded before Flop (didn't bet)
Seat 6: lxamE folded before Flop (didn't bet)
Seat 7: Crazy685 mucked [Td Ts]
Seat 8: oberst_dicht folded before Flop
Seat 9: Alameda22 (button) folded before Flop (didn't bet)



PokerStars Game #20095804999:  Hold'em No Limit ($0.10/$0.25) - 2008/09/02 15:31:14 ET
Table 'Rauma' 9-max Seat #1 is the button
Seat 1: powerle ($20 in chips) 
Seat 2: Sortime ($42.35 in chips) 
Seat 3: murphy-mcben ($8 in chips) 
Seat 4: takikardiko ($25.65 in chips) 
Seat 5: theshu1 ($18.70 in chips) 
Seat 6: lxamE ($6.95 in chips) 
Seat 7: Crazy685 ($23.25 in chips) 
Seat 8: oberst_dicht ($15.15 in chips) 
Seat 9: Alameda22 ($23.80 in chips) 
Sortime: posts small blind $0.10
murphy-mcben: posts big blind $0.25
*** HOLE CARDS ***
Dealt to Alameda22 [Ac Td]
takikardiko: folds 
theshu1: raises $0.50 to $0.75
lxamE: folds 
Crazy685: folds 
oberst_dicht: folds 
Alameda22: folds 
powerle: folds 
Sortime: calls $0.65
murphy-mcben: folds 
*** FLOP *** [5s Qc 2c]
Sortime: checks 
theshu1: bets $1.50
Sortime: folds 
Uncalled bet ($1.50) returned to theshu1
theshu1 collected $1.70 from pot
theshu1: doesn't show hand 
*** SUMMARY ***
Total pot $1.75 | Rake $0.05 
Board [5s Qc 2c]
Seat 1: powerle (button) folded before Flop (didn't bet)
Seat 2: Sortime (small blind) folded on the Flop
Seat 3: murphy-mcben (big blind) folded before Flop
Seat 4: takikardiko folded before Flop (didn't bet)
Seat 5: theshu1 collected ($1.70)
Seat 6: lxamE folded before Flop (didn't bet)
Seat 7: Crazy685 folded before Flop (didn't bet)
Seat 8: oberst_dicht folded before Flop (didn't bet)
Seat 9: Alameda22 folded before Flop (didn't bet)



PokerStars Game #20095830751:  Hold'em No Limit ($0.10/$0.25) - 2008/09/02 15:32:15 ET
Table 'Rauma' 9-max Seat #2 is the button
Seat 1: powerle ($20 in chips) 
Seat 2: Sortime ($41.60 in chips) 
Seat 3: murphy-mcben ($7.75 in chips) 
Seat 4: takikardiko ($25.65 in chips) 
Seat 5: theshu1 ($19.65 in chips) 
Seat 6: lxamE ($6.95 in chips) 
Seat 7: Crazy685 ($23.25 in chips) 
Seat 8: oberst_dicht ($15.15 in chips) 
Seat 9: Alameda22 ($23.80 in chips) 
murphy-mcben: posts small blind $0.10
takikardiko: posts big blind $0.25
*** HOLE CARDS ***
Dealt to Alameda22 [2c Ts]
theshu1: folds 
lxamE: folds 
Crazy685: folds 
oberst_dicht: folds 
Alameda22: folds 
powerle: folds 
Sortime: raises $0.75 to $1
murphy-mcben: folds 
takikardiko: folds 
Uncalled bet ($0.75) returned to Sortime
Sortime collected $0.60 from pot
Sortime: doesn't show hand 
*** SUMMARY ***
Total pot $0.60 | Rake $0 
Seat 1: powerle folded before Flop (didn't bet)
Seat 2: Sortime (button) collected ($0.60)
Seat 3: murphy-mcben (small blind) folded before Flop
Seat 4: takikardiko (big blind) folded before Flop
Seat 5: theshu1 folded before Flop (didn't bet)
Seat 6: lxamE folded before Flop (didn't bet)
Seat 7: Crazy685 folded before Flop (didn't bet)
Seat 8: oberst_dicht folded before Flop (didn't bet)
Seat 9: Alameda22 folded before Flop (didn't bet)



PokerStars Game #20095849137:  Hold'em No Limit ($0.10/$0.25) - 2008/09/02 15:32:57 ET
Table 'Rauma' 9-max Seat #3 is the button
Seat 1: powerle ($20 in chips) 
Seat 2: Sortime ($41.95 in chips) 
Seat 3: murphy-mcben ($7.65 in chips) 
Seat 4: takikardiko ($25.40 in chips) 
Seat 5: theshu1 ($19.65 in chips) 
Seat 6: lxamE ($6.95 in chips) 
Seat 7: Crazy685 ($23.25 in chips) 
Seat 8: oberst_dicht ($15.15 in chips) 
Seat 9: Alameda22 ($23.80 in chips) 
takikardiko: posts small blind $0.10
theshu1: posts big blind $0.25
*** HOLE CARDS ***
Dealt to Alameda22 [4c Js]
lxamE: folds 
Crazy685: folds 
oberst_dicht: folds 
Alameda22: folds 
powerle: folds 
Sortime: calls $0.25
murphy-mcben: calls $0.25
takikardiko: calls $0.15
theshu1: checks 
*** FLOP *** [Qh Ts 9c]
takikardiko: bets $0.75
theshu1: calls $0.75
Sortime: calls $0.75
murphy-mcben: calls $0.75
*** TURN *** [Qh Ts 9c] [5h]
takikardiko: bets $3.50
theshu1: calls $3.50
Sortime: folds 
murphy-mcben: folds 
*** RIVER *** [Qh Ts 9c 5h] [3c]
takikardiko: bets $5
theshu1: folds 
Uncalled bet ($5) returned to takikardiko
takikardiko collected $10.50 from pot
*** SUMMARY ***
Total pot $11 | Rake $0.50 
Board [Qh Ts 9c 5h 3c]
Seat 1: powerle folded before Flop (didn't bet)
Seat 2: Sortime folded on the Turn
Seat 3: murphy-mcben (button) folded on the Turn
Seat 4: takikardiko (small blind) collected ($10.50)
Seat 5: theshu1 (big blind) folded on the River
Seat 6: lxamE folded before Flop (didn't bet)
Seat 7: Crazy685 folded before Flop (didn't bet)
Seat 8: oberst_dicht folded before Flop (didn't bet)
Seat 9: Alameda22 folded before Flop (didn't bet)



PokerStars Game #20095897127:  Hold'em No Limit ($0.10/$0.25) - 2008/09/02 15:34:47 ET
Table 'Rauma' 9-max Seat #4 is the button
Seat 1: powerle ($20 in chips) 
Seat 2: Sortime ($40.95 in chips) 
Seat 3: murphy-mcben ($6.65 in chips) 
Seat 4: takikardiko ($31.40 in chips) 
Seat 5: theshu1 ($15.15 in chips) 
Seat 6: lxamE ($6.95 in chips) 
Seat 7: Crazy685 ($23.25 in chips) 
Seat 8: oberst_dicht ($15.15 in chips) 
Seat 9: Alameda22 ($23.80 in chips) 
theshu1: posts small blind $0.10
lxamE: posts big blind $0.25
*** HOLE CARDS ***
Dealt to Alameda22 [Kc 4c]
Crazy685: folds 
oberst_dicht: folds 
Alameda22: folds 
powerle: folds 
Sortime: folds 
murphy-mcben: folds 
takikardiko: folds 
theshu1: folds 
Uncalled bet ($0.15) returned to lxamE
theshu1 leaves the table
lxamE collected $0.20 from pot
*** SUMMARY ***
Total pot $0.20 | Rake $0 
Seat 1: powerle folded before Flop (didn't bet)
Seat 2: Sortime folded before Flop (didn't bet)
Seat 3: murphy-mcben folded before Flop (didn't bet)
Seat 4: takikardiko (button) folded before Flop (didn't bet)
Seat 5: theshu1 (small blind) folded before Flop
Seat 6: lxamE (big blind) collected ($0.20)
Seat 7: Crazy685 folded before Flop (didn't bet)
Seat 8: oberst_dicht folded before Flop (didn't bet)
Seat 9: Alameda22 folded before Flop (didn't bet)



PokerStars Game #20095917432:  Hold'em No Limit ($0.10/$0.25) - 2008/09/02 15:35:34 ET
Table 'Rauma' 9-max Seat #6 is the button
Seat 1: powerle ($20 in chips) 
Seat 2: Sortime ($40.95 in chips) 
Seat 3: murphy-mcben ($6.65 in chips) 
Seat 4: takikardiko ($31.40 in chips) 
Seat 6: lxamE ($7.05 in chips) 
Seat 7: Crazy685 ($23.25 in chips) 
Seat 8: oberst_dicht ($15.15 in chips) 
Seat 9: Alameda22 ($23.80 in chips) 
Crazy685: posts small blind $0.10
oberst_dicht: posts big blind $0.25
*** HOLE CARDS ***
Dealt to Alameda22 [3s 7c]
Alameda22: folds 
powerle: folds 
dukitup joins the table at seat #5 
Sortime: folds 
murphy-mcben: folds 
takikardiko: folds 
lxamE: folds 
Crazy685: folds 
Uncalled bet ($0.15) returned to oberst_dicht
oberst_dicht collected $0.20 from pot
oberst_dicht: doesn't show hand 
*** SUMMARY ***
Total pot $0.20 | Rake $0 
Seat 1: powerle folded before Flop (didn't bet)
Seat 2: Sortime folded before Flop (didn't bet)
Seat 3: murphy-mcben folded before Flop (didn't bet)
Seat 4: takikardiko folded before Flop (didn't bet)
Seat 6: lxamE (button) folded before Flop (didn't bet)
Seat 7: Crazy685 (small blind) folded before Flop
Seat 8: oberst_dicht (big blind) collected ($0.20)
Seat 9: Alameda22 folded before Flop (didn't bet)



PokerStars Game #20095927725:  Hold'em No Limit ($0.10/$0.25) - 2008/09/02 15:35:58 ET
Table 'Rauma' 9-max Seat #7 is the button
Seat 1: powerle ($20 in chips) 
Seat 2: Sortime ($40.95 in chips) 
Seat 3: murphy-mcben ($6.65 in chips) 
Seat 4: takikardiko ($31.40 in chips) 
Seat 5: dukitup ($5 in chips) 
Seat 6: lxamE ($7.05 in chips) 
Seat 7: Crazy685 ($23.15 in chips) 
Seat 8: oberst_dicht ($15.25 in chips) 
Seat 9: Alameda22 ($23.80 in chips) 
oberst_dicht: posts small blind $0.10
Alameda22: posts big blind $0.25
dukitup: posts big blind $0.25
*** HOLE CARDS ***
Dealt to Alameda22 [Ah 6s]
powerle: folds 
powerle is sitting out
Sortime: calls $0.25
murphy-mcben: folds 
powerle leaves the table
takikardiko: folds 
dukitup: checks 
lxamE: folds 
Crazy685: folds 
oberst_dicht: calls $0.15
ciDoR joins the table at seat #1 
Alameda22: checks 
*** FLOP *** [7s 7d 3c]
oberst_dicht: bets $1
Alameda22: folds 
Sortime: folds 
dukitup: folds 
Uncalled bet ($1) returned to oberst_dicht
oberst_dicht collected $0.95 from pot
*** SUMMARY ***
Total pot $1 | Rake $0.05 
Board [7s 7d 3c]
Seat 1: powerle folded before Flop (didn't bet)
Seat 2: Sortime folded on the Flop
Seat 3: murphy-mcben folded before Flop (didn't bet)
Seat 4: takikardiko folded before Flop (didn't bet)
Seat 5: dukitup folded on the Flop
Seat 6: lxamE folded before Flop (didn't bet)
Seat 7: Crazy685 (button) folded before Flop (didn't bet)
Seat 8: oberst_dicht (small blind) collected ($0.95)
Seat 9: Alameda22 (big blind) folded on the Flop



PokerStars Game #20095951206:  Hold'em No Limit ($0.10/$0.25) - 2008/09/02 15:36:53 ET
Table 'Rauma' 9-max Seat #8 is the button
Seat 1: ciDoR ($5 in chips) 
Seat 2: Sortime ($40.70 in chips) 
Seat 3: murphy-mcben ($6.65 in chips) 
Seat 4: takikardiko ($31.40 in chips) 
Seat 5: dukitup ($4.75 in chips) 
Seat 6: lxamE ($7.05 in chips) 
Seat 7: Crazy685 ($23.15 in chips) 
Seat 8: oberst_dicht ($15.95 in chips) 
Seat 9: Alameda22 ($23.55 in chips) 
Alameda22: posts small blind $0.10
ciDoR: posts big blind $0.25
*** HOLE CARDS ***
Dealt to Alameda22 [Jh 3s]
Sortime: folds 
murphy-mcben: folds 
takikardiko: folds 
dukitup: folds 
lxamE: folds 
Crazy685: folds 
oberst_dicht: folds 
Alameda22: folds 
Uncalled bet ($0.15) returned to ciDoR
ciDoR collected $0.20 from pot
*** SUMMARY ***
Total pot $0.20 | Rake $0 
Seat 1: ciDoR (big blind) collected ($0.20)
Seat 2: Sortime folded before Flop (didn't bet)
Seat 3: murphy-mcben folded before Flop (didn't bet)
Seat 4: takikardiko folded before Flop (didn't bet)
Seat 5: dukitup folded before Flop (didn't bet)
Seat 6: lxamE folded before Flop (didn't bet)
Seat 7: Crazy685 folded before Flop (didn't bet)
Seat 8: oberst_dicht (button) folded before Flop (didn't bet)
Seat 9: Alameda22 (small blind) folded before Flop



PokerStars Game #20095969281:  Hold'em No Limit ($0.10/$0.25) - 2008/09/02 15:37:35 ET
Table 'Rauma' 9-max Seat #9 is the button
Seat 1: ciDoR ($5.10 in chips) 
Seat 2: Sortime ($40.70 in chips) 
Seat 3: murphy-mcben ($6.65 in chips) 
Seat 4: takikardiko ($31.40 in chips) 
Seat 5: dukitup ($4.75 in chips) 
Seat 6: lxamE ($7.05 in chips) 
Seat 7: Crazy685 ($23.15 in chips) 
Seat 8: oberst_dicht ($15.95 in chips) 
Seat 9: Alameda22 ($23.45 in chips) 
ciDoR: posts small blind $0.10
Sortime: posts big blind $0.25
*** HOLE CARDS ***
Dealt to Alameda22 [5c 8h]
murphy-mcben: folds 
takikardiko: folds 
dukitup: folds 
lxamE: raises $0.75 to $1
Crazy685: folds 
oberst_dicht: folds 
Alameda22: folds 
ciDoR: folds 
Sortime: folds 
Uncalled bet ($0.75) returned to lxamE
lxamE collected $0.60 from pot
*** SUMMARY ***
Total pot $0.60 | Rake $0 
Seat 1: ciDoR (small blind) folded before Flop
Seat 2: Sortime (big blind) folded before Flop
Seat 3: murphy-mcben folded before Flop (didn't bet)
Seat 4: takikardiko folded before Flop (didn't bet)
Seat 5: dukitup folded before Flop (didn't bet)
Seat 6: lxamE collected ($0.60)
Seat 7: Crazy685 folded before Flop (didn't bet)
Seat 8: oberst_dicht folded before Flop (didn't bet)
Seat 9: Alameda22 (button) folded before Flop (didn't bet)



PokerStars Game #20095985742:  Hold'em No Limit ($0.10/$0.25) - 2008/09/02 15:38:14 ET
Table 'Rauma' 9-max Seat #1 is the button
Seat 1: ciDoR ($5 in chips) 
Seat 2: Sortime ($40.45 in chips) 
Seat 3: murphy-mcben ($6.65 in chips) 
Seat 4: takikardiko ($31.40 in chips) 
Seat 5: dukitup ($4.75 in chips) 
Seat 6: lxamE ($7.40 in chips) 
Seat 7: Crazy685 ($23.15 in chips) 
Seat 8: oberst_dicht ($15.95 in chips) 
Seat 9: Alameda22 ($23.45 in chips) 
Sortime: posts small blind $0.10
murphy-mcben: posts big blind $0.25
*** HOLE CARDS ***
Dealt to Alameda22 [Tc Ad]
takikardiko: folds 
dukitup: folds 
lxamE: folds 
Crazy685: calls $0.25
oberst_dicht: folds 
Alameda22: folds 
ciDoR: folds 
Sortime: calls $0.15
murphy-mcben: raises $0.75 to $1
Crazy685: calls $0.75
Sortime: folds 
*** FLOP *** [3s Td 2h]
murphy-mcben: bets $1.75
Crazy685: raises $5.25 to $7
murphy-mcben: folds 
Uncalled bet ($5.25) returned to Crazy685
Crazy685 collected $5.50 from pot
*** SUMMARY ***
Total pot $5.75 | Rake $0.25 
Board [3s Td 2h]
Seat 1: ciDoR (button) folded before Flop (didn't bet)
Seat 2: Sortime (small blind) folded before Flop
Seat 3: murphy-mcben (big blind) folded on the Flop
Seat 4: takikardiko folded before Flop (didn't bet)
Seat 5: dukitup folded before Flop (didn't bet)
Seat 6: lxamE folded before Flop (didn't bet)
Seat 7: Crazy685 collected ($5.50)
Seat 8: oberst_dicht folded before Flop (didn't bet)
Seat 9: Alameda22 folded before Flop (didn't bet)



PokerStars Game #20096013872:  Hold'em No Limit ($0.10/$0.25) - 2008/09/02 15:39:20 ET
Table 'Rauma' 9-max Seat #2 is the button
Seat 1: ciDoR ($5 in chips) 
Seat 2: Sortime ($40.20 in chips) 
Seat 3: murphy-mcben ($3.90 in chips) 
Seat 4: takikardiko ($31.40 in chips) 
Seat 5: dukitup ($4.75 in chips) 
Seat 6: lxamE ($7.40 in chips) 
Seat 7: Crazy685 ($25.90 in chips) 
Seat 8: oberst_dicht ($15.95 in chips) 
Seat 9: Alameda22 ($23.45 in chips) 
murphy-mcben: posts small blind $0.10
takikardiko: posts big blind $0.25
*** HOLE CARDS ***
Dealt to Alameda22 [6h 9s]
dukitup: folds 
lxamE: raises $0.75 to $1
Crazy685: folds 
oberst_dicht: folds 
Alameda22: folds 
ciDoR: folds 
Sortime: folds 
murphy-mcben: folds 
takikardiko: folds 
Uncalled bet ($0.75) returned to lxamE
lxamE collected $0.60 from pot
lxamE: doesn't show hand 
*** SUMMARY ***
Total pot $0.60 | Rake $0 
Seat 1: ciDoR folded before Flop (didn't bet)
Seat 2: Sortime (button) folded before Flop (didn't bet)
Seat 3: murphy-mcben (small blind) folded before Flop
Seat 4: takikardiko (big blind) folded before Flop
Seat 5: dukitup folded before Flop (didn't bet)
Seat 6: lxamE collected ($0.60)
Seat 7: Crazy685 folded before Flop (didn't bet)
Seat 8: oberst_dicht folded before Flop (didn't bet)
Seat 9: Alameda22 folded before Flop (didn't bet)



PokerStars Game #20096032117:  Hold'em No Limit ($0.10/$0.25) - 2008/09/02 15:40:04 ET
Table 'Rauma' 9-max Seat #3 is the button
Seat 1: ciDoR ($5 in chips) 
Seat 2: Sortime ($40.20 in chips) 
Seat 3: murphy-mcben ($3.80 in chips) 
Seat 4: takikardiko ($31.15 in chips) 
Seat 5: dukitup ($4.75 in chips) 
Seat 6: lxamE ($7.75 in chips) 
Seat 7: Crazy685 ($25.90 in chips) 
Seat 8: oberst_dicht ($15.95 in chips) 
Seat 9: Alameda22 ($23.45 in chips) 
takikardiko: posts small blind $0.10
dukitup: posts big blind $0.25
*** HOLE CARDS ***
Dealt to Alameda22 [2s Td]
lxamE: folds 
lxamE leaves the table
Crazy685: calls $0.25
oberst_dicht: folds 
jst_the_nuts joins the table at seat #6 
Alameda22: folds 
ciDoR: folds 
Sortime: folds 
murphy-mcben: calls $0.25
takikardiko: folds 
dukitup: checks 
*** FLOP *** [4c 2d 5c]
dukitup: checks 
Crazy685: checks 
murphy-mcben: checks 
*** TURN *** [4c 2d 5c] [7h]
dukitup: bets $0.75
Crazy685: calls $0.75
murphy-mcben: raises $2.80 to $3.55 and is all-in
dukitup: raises $0.95 to $4.50 and is all-in
Crazy685: folds 
Uncalled bet ($0.95) returned to dukitup
*** RIVER *** [4c 2d 5c 7h] [7d]
*** SHOW DOWN ***
dukitup: shows [3c 7c] (three of a kind, Sevens)
murphy-mcben: shows [Kc 7s] (three of a kind, Sevens - King kicker)
murphy-mcben collected $8.30 from pot
*** SUMMARY ***
Total pot $8.70 | Rake $0.40 
Board [4c 2d 5c 7h 7d]
Seat 1: ciDoR folded before Flop (didn't bet)
Seat 2: Sortime folded before Flop (didn't bet)
Seat 3: murphy-mcben (button) showed [Kc 7s] and won ($8.30) with three of a kind, Sevens
Seat 4: takikardiko (small blind) folded before Flop
Seat 5: dukitup (big blind) showed [3c 7c] and lost with three of a kind, Sevens
Seat 6: lxamE folded before Flop (didn't bet)
Seat 7: Crazy685 folded on the Turn
Seat 8: oberst_dicht folded before Flop (didn't bet)
Seat 9: Alameda22 folded before Flop (didn't bet)



PokerStars Game #20096064354:  Hold'em No Limit ($0.10/$0.25) - 2008/09/02 15:41:21 ET
Table 'Rauma' 9-max Seat #4 is the button
Seat 1: ciDoR ($5 in chips) 
Seat 2: Sortime ($40.20 in chips) 
Seat 3: murphy-mcben ($8.30 in chips) 
Seat 4: takikardiko ($31.05 in chips) 
Seat 5: dukitup ($0.95 in chips) 
Seat 6: jst_the_nuts ($9.60 in chips) 
Seat 7: Crazy685 ($24.90 in chips) 
Seat 8: oberst_dicht ($15.95 in chips) 
Seat 9: Alameda22 ($23.45 in chips) 
dukitup: posts small blind $0.10
jst_the_nuts: posts big blind $0.25
*** HOLE CARDS ***
Dealt to Alameda22 [4s Js]
Crazy685: folds 
oberst_dicht: folds 
Alameda22: folds 
ciDoR: folds 
Sortime: folds 
murphy-mcben: folds 
takikardiko: raises $0.75 to $1
dukitup: folds 
jst_the_nuts: calls $0.75
*** FLOP *** [9h 8d 7d]
jst_the_nuts: checks 
takikardiko: bets $1.50
jst_the_nuts: folds 
Uncalled bet ($1.50) returned to takikardiko
takikardiko collected $2 from pot
takikardiko: doesn't show hand 
*** SUMMARY ***
Total pot $2.10 | Rake $0.10 
Board [9h 8d 7d]
Seat 1: ciDoR folded before Flop (didn't bet)
Seat 2: Sortime folded before Flop (didn't bet)
Seat 3: murphy-mcben folded before Flop (didn't bet)
Seat 4: takikardiko (button) collected ($2)
Seat 5: dukitup (small blind) folded before Flop
Seat 6: jst_the_nuts (big blind) folded on the Flop
Seat 7: Crazy685 folded before Flop (didn't bet)
Seat 8: oberst_dicht folded before Flop (didn't bet)
Seat 9: Alameda22 folded before Flop (didn't bet)



PokerStars Game #20096090002:  Hold'em No Limit ($0.10/$0.25) - 2008/09/02 15:42:23 ET
Table 'Rauma' 9-max Seat #5 is the button
Seat 1: ciDoR ($5 in chips) 
Seat 2: Sortime ($40.20 in chips) 
Seat 3: murphy-mcben ($8.30 in chips) 
Seat 4: takikardiko ($32.05 in chips) 
Seat 5: dukitup ($0.85 in chips) 
Seat 6: jst_the_nuts ($8.60 in chips) 
Seat 7: Crazy685 ($24.90 in chips) 
Seat 8: oberst_dicht ($15.95 in chips) 
Seat 9: Alameda22 ($23.45 in chips) 
jst_the_nuts: posts small blind $0.10
Crazy685: posts big blind $0.25
*** HOLE CARDS ***
Dealt to Alameda22 [4s Js]
oberst_dicht: folds 
Alameda22: folds 
ciDoR: folds 
Sortime: folds 
murphy-mcben: calls $0.25
takikardiko: folds 
dukitup: raises $0.60 to $0.85 and is all-in
jst_the_nuts: calls $0.75
Crazy685: folds 
murphy-mcben: calls $0.60
*** FLOP *** [Tc 2h 3d]
jst_the_nuts: bets $0.75
murphy-mcben: folds 
Uncalled bet ($0.75) returned to jst_the_nuts
*** TURN *** [Tc 2h 3d] [5d]
*** RIVER *** [Tc 2h 3d 5d] [4c]
*** SHOW DOWN ***
jst_the_nuts: shows [Th 8c] (a pair of Tens)
dukitup: shows [6c 5c] (a straight, Deuce to Six)
dukitup collected $2.70 from pot
*** SUMMARY ***
Total pot $2.80 | Rake $0.10 
Board [Tc 2h 3d 5d 4c]
Seat 1: ciDoR folded before Flop (didn't bet)
Seat 2: Sortime folded before Flop (didn't bet)
Seat 3: murphy-mcben folded on the Flop
Seat 4: takikardiko folded before Flop (didn't bet)
Seat 5: dukitup (button) showed [6c 5c] and won ($2.70) with a straight, Deuce to Six
Seat 6: jst_the_nuts (small blind) showed [Th 8c] and lost with a pair of Tens
Seat 7: Crazy685 (big blind) folded before Flop
Seat 8: oberst_dicht folded before Flop (didn't bet)
Seat 9: Alameda22 folded before Flop (didn't bet)



PokerStars Game #20096113905:  Hold'em No Limit ($0.10/$0.25) - 2008/09/02 15:43:20 ET
Table 'Rauma' 9-max Seat #6 is the button
Seat 1: ciDoR ($5 in chips) 
Seat 2: Sortime ($40.20 in chips) 
Seat 3: murphy-mcben ($7.45 in chips) 
Seat 4: takikardiko ($32.05 in chips) 
Seat 5: dukitup ($7.70 in chips) 
Seat 6: jst_the_nuts ($7.75 in chips) 
Seat 7: Crazy685 ($24.65 in chips) 
Seat 8: oberst_dicht ($15.95 in chips) 
Seat 9: Alameda22 ($23.45 in chips) 
Crazy685: posts small blind $0.10
oberst_dicht: posts big blind $0.25
*** HOLE CARDS ***
Dealt to Alameda22 [6h 9d]
Alameda22: folds 
ciDoR: folds 
Sortime: calls $0.25
murphy-mcben: folds 
takikardiko: calls $0.25
dukitup: folds 
jst_the_nuts: folds 
Crazy685: calls $0.15
oberst_dicht: checks 
*** FLOP *** [Ks 5s 7d]
Crazy685: checks 
oberst_dicht: checks 
Sortime: checks 
takikardiko: bets $1
Crazy685: folds 
oberst_dicht: folds 
Sortime: folds 
Uncalled bet ($1) returned to takikardiko
takikardiko collected $0.95 from pot
*** SUMMARY ***
Total pot $1 | Rake $0.05 
Board [Ks 5s 7d]
Seat 1: ciDoR folded before Flop (didn't bet)
Seat 2: Sortime folded on the Flop
Seat 3: murphy-mcben folded before Flop (didn't bet)
Seat 4: takikardiko collected ($0.95)
Seat 5: dukitup folded before Flop (didn't bet)
Seat 6: jst_the_nuts (button) folded before Flop (didn't bet)
Seat 7: Crazy685 (small blind) folded on the Flop
Seat 8: oberst_dicht (big blind) folded on the Flop
Seat 9: Alameda22 folded before Flop (didn't bet)



PokerStars Game #20096136574:  Hold'em No Limit ($0.10/$0.25) - 2008/09/02 15:44:15 ET
Table 'Rauma' 9-max Seat #7 is the button
Seat 1: ciDoR ($5 in chips) 
Seat 2: Sortime ($39.95 in chips) 
Seat 3: murphy-mcben ($7.45 in chips) 
Seat 4: takikardiko ($32.75 in chips) 
Seat 5: dukitup ($7.70 in chips) 
Seat 6: jst_the_nuts ($7.75 in chips) 
Seat 7: Crazy685 ($24.40 in chips) 
Seat 8: oberst_dicht ($15.70 in chips) 
Seat 9: Alameda22 ($23.45 in chips) 
oberst_dicht: posts small blind $0.10
Alameda22: posts big blind $0.25
*** HOLE CARDS ***
Dealt to Alameda22 [Kh Jd]
ciDoR: folds 
Sortime: folds 
murphy-mcben: folds 
takikardiko: folds 
dukitup: folds 
jst_the_nuts: folds 
Crazy685: raises $0.75 to $1
oberst_dicht: folds 
Alameda22: folds 
Uncalled bet ($0.75) returned to Crazy685
Crazy685 collected $0.60 from pot
Crazy685: doesn't show hand 
*** SUMMARY ***
Total pot $0.60 | Rake $0 
Seat 1: ciDoR folded before Flop (didn't bet)
Seat 2: Sortime folded before Flop (didn't bet)
Seat 3: murphy-mcben folded before Flop (didn't bet)
Seat 4: takikardiko folded before Flop (didn't bet)
Seat 5: dukitup folded before Flop (didn't bet)
Seat 6: jst_the_nuts folded before Flop (didn't bet)
Seat 7: Crazy685 (button) collected ($0.60)
Seat 8: oberst_dicht (small blind) folded before Flop
Seat 9: Alameda22 (big blind) folded before Flop



PokerStars Game #20096159191:  Hold'em No Limit ($0.10/$0.25) - 2008/09/02 15:45:10 ET
Table 'Rauma' 9-max Seat #8 is the button
Seat 1: ciDoR ($5 in chips) 
Seat 2: Sortime ($39.95 in chips) 
Seat 3: murphy-mcben ($7.45 in chips) 
Seat 4: takikardiko ($32.75 in chips) 
Seat 5: dukitup ($7.70 in chips) 
Seat 6: jst_the_nuts ($7.75 in chips) 
Seat 7: Crazy685 ($24.75 in chips) 
Seat 8: oberst_dicht ($15.60 in chips) 
Seat 9: Alameda22 ($23.20 in chips) 
Alameda22: posts small blind $0.10
ciDoR: posts big blind $0.25
*** HOLE CARDS ***
Dealt to Alameda22 [9s 5d]
Sortime: folds 
murphy-mcben: folds 
takikardiko: folds 
dukitup: calls $0.25
jst_the_nuts: calls $0.25
Crazy685: folds 
oberst_dicht: folds 
Alameda22: folds 
ciDoR: checks 
*** FLOP *** [6h 5s 8d]
ciDoR: checks 
dukitup: checks 
jst_the_nuts: bets $0.25
ciDoR: folds 
dukitup: raises $1.25 to $1.50
jst_the_nuts: calls $1.25
*** TURN *** [6h 5s 8d] [Jd]
dukitup: bets $3.75
jst_the_nuts: folds 
Uncalled bet ($3.75) returned to dukitup
dukitup collected $3.70 from pot
dukitup: doesn't show hand 
*** SUMMARY ***
Total pot $3.85 | Rake $0.15 
Board [6h 5s 8d Jd]
Seat 1: ciDoR (big blind) folded on the Flop
Seat 2: Sortime folded before Flop (didn't bet)
Seat 3: murphy-mcben folded before Flop (didn't bet)
Seat 4: takikardiko folded before Flop (didn't bet)
Seat 5: dukitup collected ($3.70)
Seat 6: jst_the_nuts folded on the Turn
Seat 7: Crazy685 folded before Flop (didn't bet)
Seat 8: oberst_dicht (button) folded before Flop (didn't bet)
Seat 9: Alameda22 (small blind) folded before Flop



PokerStars Game #20096198296:  Hold'em No Limit ($0.10/$0.25) - 2008/09/02 15:46:46 ET
Table 'Rauma' 9-max Seat #9 is the button
Seat 1: ciDoR ($4.75 in chips) 
Seat 2: Sortime ($39.95 in chips) 
Seat 3: murphy-mcben ($7.45 in chips) 
Seat 4: takikardiko ($32.75 in chips) 
Seat 5: dukitup ($9.65 in chips) 
Seat 6: jst_the_nuts ($6 in chips) 
Seat 7: Crazy685 ($24.75 in chips) 
Seat 8: oberst_dicht ($15.60 in chips) 
Seat 9: Alameda22 ($23.10 in chips) 
ciDoR: posts small blind $0.10
Sortime: posts big blind $0.25
*** HOLE CARDS ***
Dealt to Alameda22 [Ac Ah]
murphy-mcben: folds 
takikardiko: folds 
dukitup: folds 
jst_the_nuts: folds 
Crazy685: folds 
oberst_dicht: folds 
Alameda22: raises $0.75 to $1
ciDoR: folds 
Sortime: folds 
Uncalled bet ($0.75) returned to Alameda22
Alameda22 collected $0.60 from pot
Alameda22: doesn't show hand 
*** SUMMARY ***
Total pot $0.60 | Rake $0 
Seat 1: ciDoR (small blind) folded before Flop
Seat 2: Sortime (big blind) folded before Flop
Seat 3: murphy-mcben folded before Flop (didn't bet)
Seat 4: takikardiko folded before Flop (didn't bet)
Seat 5: dukitup folded before Flop (didn't bet)
Seat 6: jst_the_nuts folded before Flop (didn't bet)
Seat 7: Crazy685 folded before Flop (didn't bet)
Seat 8: oberst_dicht folded before Flop (didn't bet)
Seat 9: Alameda22 (button) collected ($0.60)



PokerStars Game #20096214412:  Hold'em No Limit ($0.10/$0.25) - 2008/09/02 15:47:25 ET
Table 'Rauma' 9-max Seat #1 is the button
Seat 1: ciDoR ($4.65 in chips) 
Seat 2: Sortime ($39.70 in chips) 
Seat 3: murphy-mcben ($7.45 in chips) 
Seat 4: takikardiko ($32.75 in chips) 
Seat 5: dukitup ($9.65 in chips) 
Seat 6: jst_the_nuts ($6 in chips) 
Seat 7: Crazy685 ($24.75 in chips) 
Seat 8: oberst_dicht ($15.60 in chips) 
Seat 9: Alameda22 ($23.45 in chips) 
Sortime: posts small blind $0.10
murphy-mcben: posts big blind $0.25
*** HOLE CARDS ***
Dealt to Alameda22 [8d 2s]
takikardiko: folds 
dukitup: folds 
jst_the_nuts: calls $0.25
Crazy685: calls $0.25
oberst_dicht: folds 
Alameda22: folds 
ciDoR: folds 
Sortime: folds 
murphy-mcben: checks 
*** FLOP *** [Ks 7s 2c]
murphy-mcben: checks 
jst_the_nuts: checks 
Crazy685: bets $1.25
murphy-mcben: folds 
jst_the_nuts: folds 
Uncalled bet ($1.25) returned to Crazy685
Crazy685 collected $0.85 from pot
Crazy685: doesn't show hand 
*** SUMMARY ***
Total pot $0.85 | Rake $0 
Board [Ks 7s 2c]
Seat 1: ciDoR (button) folded before Flop (didn't bet)
Seat 2: Sortime (small blind) folded before Flop
Seat 3: murphy-mcben (big blind) folded on the Flop
Seat 4: takikardiko folded before Flop (didn't bet)
Seat 5: dukitup folded before Flop (didn't bet)
Seat 6: jst_the_nuts folded on the Flop
Seat 7: Crazy685 collected ($0.85)
Seat 8: oberst_dicht folded before Flop (didn't bet)
Seat 9: Alameda22 folded before Flop (didn't bet)



PokerStars Game #20096234461:  Hold'em No Limit ($0.10/$0.25) - 2008/09/02 15:48:14 ET
Table 'Rauma' 9-max Seat #2 is the button
Seat 1: ciDoR ($4.65 in chips) 
Seat 2: Sortime ($39.60 in chips) 
Seat 3: murphy-mcben ($7.20 in chips) 
Seat 5: dukitup ($9.65 in chips) 
Seat 6: jst_the_nuts ($5.75 in chips) 
Seat 7: Crazy685 ($25.35 in chips) 
Seat 8: oberst_dicht ($15.60 in chips) 
Seat 9: Alameda22 ($23.45 in chips) 
murphy-mcben: posts small blind $0.10
takikardiko: is sitting out 
dukitup: posts big blind $0.25
*** HOLE CARDS ***
Dealt to Alameda22 [9h 2d]
takikardiko leaves the table
jst_the_nuts: folds 
Crazy685: folds 
oberst_dicht: folds 
Alameda22: folds 
ciDoR: folds 
Sortime: folds 
murphy-mcben: folds 
Uncalled bet ($0.15) returned to dukitup
dukitup collected $0.20 from pot
*** SUMMARY ***
Total pot $0.20 | Rake $0 
Seat 1: ciDoR folded before Flop (didn't bet)
Seat 2: Sortime (button) folded before Flop (didn't bet)
Seat 3: murphy-mcben (small blind) folded before Flop
Seat 5: dukitup (big blind) collected ($0.20)
Seat 6: jst_the_nuts folded before Flop (didn't bet)
Seat 7: Crazy685 folded before Flop (didn't bet)
Seat 8: oberst_dicht folded before Flop (didn't bet)
Seat 9: Alameda22 folded before Flop (didn't bet)



PokerStars Game #20096243577:  Hold'em No Limit ($0.10/$0.25) - 2008/09/02 15:48:37 ET
Table 'Rauma' 9-max Seat #3 is the button
Seat 1: ciDoR ($4.65 in chips) 
Seat 2: Sortime ($39.60 in chips) 
Seat 3: murphy-mcben ($7.10 in chips) 
Seat 5: dukitup ($9.75 in chips) 
Seat 6: jst_the_nuts ($5.75 in chips) 
Seat 7: Crazy685 ($25.35 in chips) 
Seat 8: oberst_dicht ($15.60 in chips) 
Seat 9: Alameda22 ($23.45 in chips) 
dukitup: posts small blind $0.10
jst_the_nuts: posts big blind $0.25
*** HOLE CARDS ***
Dealt to Alameda22 [4h 4c]
Crazy685: folds 
oberst_dicht: calls $0.25
Alameda22: folds 
ciDoR: folds 
Sortime: folds 
murphy-mcben: folds 
dukitup: calls $0.15
jst_the_nuts: checks 
*** FLOP *** [9h Ts Qd]
dukitup: checks 
jst_the_nuts: checks 
oberst_dicht: bets $1
dukitup: folds 
jst_the_nuts: folds 
Uncalled bet ($1) returned to oberst_dicht
hakunamtata joins the table at seat #4 
oberst_dicht collected $0.75 from pot
*** SUMMARY ***
Total pot $0.75 | Rake $0 
Board [9h Ts Qd]
Seat 1: ciDoR folded before Flop (didn't bet)
Seat 2: Sortime folded before Flop (didn't bet)
Seat 3: murphy-mcben (button) folded before Flop (didn't bet)
Seat 5: dukitup (small blind) folded on the Flop
Seat 6: jst_the_nuts (big blind) folded on the Flop
Seat 7: Crazy685 folded before Flop (didn't bet)
Seat 8: oberst_dicht collected ($0.75)
Seat 9: Alameda22 folded before Flop (didn't bet)



PokerStars Game #20096263993:  Hold'em No Limit ($0.10/$0.25) - 2008/09/02 15:49:27 ET
Table 'Rauma' 9-max Seat #5 is the button
Seat 1: ciDoR ($4.65 in chips) 
Seat 2: Sortime ($39.60 in chips) 
Seat 3: murphy-mcben ($7.10 in chips) 
Seat 4: hakunamtata ($10 in chips) 
Seat 5: dukitup ($9.50 in chips) 
Seat 6: jst_the_nuts ($5.50 in chips) 
Seat 7: Crazy685 ($25.35 in chips) 
Seat 8: oberst_dicht ($16.10 in chips) 
Seat 9: Alameda22 ($23.45 in chips) 
jst_the_nuts: posts small blind $0.10
Crazy685: posts big blind $0.25
hakunamtata: posts big blind $0.25
*** HOLE CARDS ***
Dealt to Alameda22 [Tc 5c]
oberst_dicht: folds 
Alameda22: folds 
ciDoR: folds 
Sortime: raises $1 to $1.25
murphy-mcben: folds 
hakunamtata: folds 
dukitup: folds 
jst_the_nuts: folds 
Crazy685: raises $1.50 to $2.75
Sortime: calls $1.50
*** FLOP *** [2c 7s 7d]
Crazy685: bets $2.50
Sortime: calls $2.50
*** TURN *** [2c 7s 7d] [Jc]
Crazy685: bets $3.75
Sortime: calls $3.75
*** RIVER *** [2c 7s 7d Jc] [Jd]
Crazy685: bets $4
Sortime: calls $4
*** SHOW DOWN ***
Crazy685: shows [9d 9h] (two pair, Jacks and Nines)
Sortime: shows [Kd Kh] (two pair, Kings and Jacks)
Sortime collected $25.10 from pot
Crazy685 said, "what the"
Crazy685 said, "what took so long"
*** SUMMARY ***
Total pot $26.35 | Rake $1.25 
Board [2c 7s 7d Jc Jd]
Seat 1: ciDoR folded before Flop (didn't bet)
Seat 2: Sortime showed [Kd Kh] and won ($25.10) with two pair, Kings and Jacks
Seat 3: murphy-mcben folded before Flop (didn't bet)
Seat 4: hakunamtata folded before Flop
Seat 5: dukitup (button) folded before Flop (didn't bet)
Seat 6: jst_the_nuts (small blind) folded before Flop
Seat 7: Crazy685 (big blind) showed [9d 9h] and lost with two pair, Jacks and Nines
Seat 8: oberst_dicht folded before Flop (didn't bet)
Seat 9: Alameda22 folded before Flop (didn't bet)



PokerStars Game #20096307060:  Hold'em No Limit ($0.10/$0.25) - 2008/09/02 15:51:16 ET
Table 'Rauma' 9-max Seat #6 is the button
Seat 1: ciDoR ($4.65 in chips) 
Seat 2: Sortime ($51.70 in chips) 
Seat 3: murphy-mcben ($7.10 in chips) 
Seat 4: hakunamtata ($19.75 in chips) 
Seat 5: dukitup ($9.50 in chips) 
Seat 6: jst_the_nuts ($5.40 in chips) 
Seat 7: Crazy685 ($12.35 in chips) 
Seat 8: oberst_dicht ($16.10 in chips) 
Seat 9: Alameda22 ($23.45 in chips) 
Crazy685: posts small blind $0.10
oberst_dicht: posts big blind $0.25
*** HOLE CARDS ***
Dealt to Alameda22 [7s Qs]
Alameda22: folds 
ciDoR: folds 
Sortime: folds 
murphy-mcben: folds 
hakunamtata: calls $0.25
dukitup: folds 
jst_the_nuts: folds 
Crazy685: folds 
oberst_dicht: checks 
*** FLOP *** [2h 4h 8h]
oberst_dicht: bets $1
hakunamtata: folds 
Uncalled bet ($1) returned to oberst_dicht
oberst_dicht collected $0.60 from pot
*** SUMMARY ***
Total pot $0.60 | Rake $0 
Board [2h 4h 8h]
Seat 1: ciDoR folded before Flop (didn't bet)
Seat 2: Sortime folded before Flop (didn't bet)
Seat 3: murphy-mcben folded before Flop (didn't bet)
Seat 4: hakunamtata folded on the Flop
Seat 5: dukitup folded before Flop (didn't bet)
Seat 6: jst_the_nuts (button) folded before Flop (didn't bet)
Seat 7: Crazy685 (small blind) folded before Flop
Seat 8: oberst_dicht (big blind) collected ($0.60)
Seat 9: Alameda22 folded before Flop (didn't bet)



PokerStars Game #20096324801:  Hold'em No Limit ($0.10/$0.25) - 2008/09/02 15:51:59 ET
Table 'Rauma' 9-max Seat #7 is the button
Seat 1: ciDoR ($4.65 in chips) 
Seat 2: Sortime ($51.70 in chips) 
Seat 3: murphy-mcben ($7.10 in chips) 
Seat 4: hakunamtata ($19.50 in chips) 
Seat 5: dukitup ($9.50 in chips) 
Seat 6: jst_the_nuts ($5.40 in chips) 
Seat 7: Crazy685 ($12.25 in chips) 
Seat 8: oberst_dicht ($16.45 in chips) 
Seat 9: Alameda22 ($23.45 in chips) 
oberst_dicht: posts small blind $0.10
Alameda22: posts big blind $0.25
*** HOLE CARDS ***
Dealt to Alameda22 [Qc 4c]
ciDoR: folds 
Sortime: folds 
murphy-mcben: folds 
hakunamtata: raises $0.50 to $0.75
dukitup: folds 
jst_the_nuts: folds 
Crazy685: folds 
oberst_dicht: folds 
Alameda22: folds 
Uncalled bet ($0.50) returned to hakunamtata
hakunamtata collected $0.60 from pot
hakunamtata: doesn't show hand 
*** SUMMARY ***
Total pot $0.60 | Rake $0 
Seat 1: ciDoR folded before Flop (didn't bet)
Seat 2: Sortime folded before Flop (didn't bet)
Seat 3: murphy-mcben folded before Flop (didn't bet)
Seat 4: hakunamtata collected ($0.60)
Seat 5: dukitup folded before Flop (didn't bet)
Seat 6: jst_the_nuts folded before Flop (didn't bet)
Seat 7: Crazy685 (button) folded before Flop (didn't bet)
Seat 8: oberst_dicht (small blind) folded before Flop
Seat 9: Alameda22 (big blind) folded before Flop



PokerStars Game #20096345279:  Hold'em No Limit ($0.10/$0.25) - 2008/09/02 15:52:50 ET
Table 'Rauma' 9-max Seat #8 is the button
Seat 1: ciDoR ($4.65 in chips) 
Seat 2: Sortime ($51.70 in chips) 
Seat 3: murphy-mcben ($7.10 in chips) 
Seat 4: hakunamtata ($19.85 in chips) 
Seat 5: dukitup ($9.50 in chips) 
Seat 6: jst_the_nuts ($5.40 in chips) 
Seat 7: Crazy685 ($12.25 in chips) 
Seat 8: oberst_dicht ($16.35 in chips) 
Seat 9: Alameda22 ($23.20 in chips) 
Alameda22: posts small blind $0.10
ciDoR: posts big blind $0.25
*** HOLE CARDS ***
Dealt to Alameda22 [2h 9c]
Sortime: folds 
murphy-mcben: folds 
hakunamtata: calls $0.25
dukitup: calls $0.25
jst_the_nuts: folds 
Crazy685: calls $0.25
oberst_dicht: folds 
Alameda22: folds 
ciDoR: checks 
*** FLOP *** [8c 7h Ah]
ciDoR: checks 
hakunamtata: bets $0.75
dukitup: folds 
Crazy685: calls $0.75
ciDoR: folds 
*** TURN *** [8c 7h Ah] [Tc]
hakunamtata: bets $0.75
Crazy685: calls $0.75
*** RIVER *** [8c 7h Ah Tc] [Kh]
hakunamtata: bets $1.50
Crazy685: folds 
Uncalled bet ($1.50) returned to hakunamtata
hakunamtata collected $3.90 from pot
hakunamtata: shows [7d 7c] (three of a kind, Sevens)
*** SUMMARY ***
Total pot $4.10 | Rake $0.20 
Board [8c 7h Ah Tc Kh]
Seat 1: ciDoR (big blind) folded on the Flop
Seat 2: Sortime folded before Flop (didn't bet)
Seat 3: murphy-mcben folded before Flop (didn't bet)
Seat 4: hakunamtata collected ($3.90)
Seat 5: dukitup folded on the Flop
Seat 6: jst_the_nuts folded before Flop (didn't bet)
Seat 7: Crazy685 folded on the River
Seat 8: oberst_dicht (button) folded before Flop (didn't bet)
Seat 9: Alameda22 (small blind) folded before Flop



PokerStars Game #20096371135:  Hold'em No Limit ($0.10/$0.25) - 2008/09/02 15:53:53 ET
Table 'Rauma' 9-max Seat #9 is the button
Seat 1: ciDoR ($4.40 in chips) 
Seat 2: Sortime ($51.70 in chips) 
Seat 3: murphy-mcben ($7.10 in chips) 
Seat 4: hakunamtata ($22 in chips) 
Seat 5: dukitup ($9.25 in chips) 
Seat 6: jst_the_nuts ($5.40 in chips) 
Seat 7: Crazy685 ($10.50 in chips) 
Seat 8: oberst_dicht ($16.35 in chips) 
Seat 9: Alameda22 ($23.10 in chips) 
ciDoR: posts small blind $0.10
Sortime: posts big blind $0.25
*** HOLE CARDS ***
Dealt to Alameda22 [Jd Qh]
murphy-mcben: folds 
hakunamtata: calls $0.25
dukitup: folds 
jst_the_nuts: calls $0.25
Crazy685: raises $1 to $1.25
oberst_dicht: folds 
Alameda22: folds 
ciDoR: folds 
Sortime: folds 
hakunamtata: folds 
jst_the_nuts: calls $1
*** FLOP *** [5d Ac 6h]
jst_the_nuts: checks 
Crazy685: checks 
*** TURN *** [5d Ac 6h] [Qc]
jst_the_nuts: checks 
Crazy685: checks 
*** RIVER *** [5d Ac 6h Qc] [Tc]
jst_the_nuts: bets $4.15 and is all-in
Crazy685: calls $4.15
*** SHOW DOWN ***
jst_the_nuts: shows [Jc 9c] (a flush, Ace high)
Crazy685: mucks hand 
Crazy685 said, "sigh"
jst_the_nuts collected $10.85 from pot
Crazy685 said, "What a shock."
Crazy685 said, "J9 lol"
*** SUMMARY ***
Total pot $11.40 | Rake $0.55 
Board [5d Ac 6h Qc Tc]
Seat 1: ciDoR (small blind) folded before Flop
Seat 2: Sortime (big blind) folded before Flop
Seat 3: murphy-mcben folded before Flop (didn't bet)
Seat 4: hakunamtata folded before Flop
Seat 5: dukitup folded before Flop (didn't bet)
Seat 6: jst_the_nuts showed [Jc 9c] and won ($10.85) with a flush, Ace high
Seat 7: Crazy685 mucked [Th Td]
Seat 8: oberst_dicht folded before Flop (didn't bet)
Seat 9: Alameda22 (button) folded before Flop (didn't bet)



PokerStars Game #20096393149:  Hold'em No Limit ($0.10/$0.25) - 2008/09/02 15:54:48 ET
Table 'Rauma' 9-max Seat #1 is the button
Seat 1: ciDoR ($4.30 in chips) 
Seat 2: Sortime ($51.45 in chips) 
Seat 3: murphy-mcben ($7.10 in chips) 
Seat 4: hakunamtata ($21.75 in chips) 
Seat 5: dukitup ($9.25 in chips) 
Seat 6: jst_the_nuts ($10.85 in chips) 
Seat 7: Crazy685 ($5.10 in chips) 
Seat 8: oberst_dicht ($16.35 in chips) 
Seat 9: Alameda22 ($23.10 in chips) 
Sortime: posts small blind $0.10
murphy-mcben: posts big blind $0.25
*** HOLE CARDS ***
Dealt to Alameda22 [5h Kd]
Crazy685 said, "sickening"
hakunamtata: folds 
dukitup: calls $0.25
jst_the_nuts: folds 
Crazy685: folds 
oberst_dicht: raises $0.50 to $0.75
Alameda22: folds 
ciDoR: folds 
Sortime: folds 
murphy-mcben: folds 
jst_the_nuts said, "sry man but thats the best im getten"
dukitup: calls $0.50
*** FLOP *** [Ts 2c 7s]
dukitup: checks 
oberst_dicht: bets $1
dukitup: folds 
Uncalled bet ($1) returned to oberst_dicht
oberst_dicht collected $1.80 from pot
*** SUMMARY ***
Total pot $1.85 | Rake $0.05 
Board [Ts 2c 7s]
Seat 1: ciDoR (button) folded before Flop (didn't bet)
Seat 2: Sortime (small blind) folded before Flop
Seat 3: murphy-mcben (big blind) folded before Flop
Seat 4: hakunamtata folded before Flop (didn't bet)
Seat 5: dukitup folded on the Flop
Seat 6: jst_the_nuts folded before Flop (didn't bet)
Seat 7: Crazy685 folded before Flop (didn't bet)
Seat 8: oberst_dicht collected ($1.80)
Seat 9: Alameda22 folded before Flop (didn't bet)



PokerStars Game #20096407395:  Hold'em No Limit ($0.10/$0.25) - 2008/09/02 15:55:23 ET
Table 'Rauma' 9-max Seat #2 is the button
Seat 1: ciDoR ($4.30 in chips) 
Seat 2: Sortime ($51.35 in chips) 
Seat 3: murphy-mcben ($6.85 in chips) 
Seat 4: hakunamtata ($21.75 in chips) 
Seat 5: dukitup ($8.50 in chips) 
Seat 6: jst_the_nuts ($10.85 in chips) 
Seat 7: Crazy685 ($5.10 in chips) 
Seat 8: oberst_dicht ($17.40 in chips) 
Seat 9: Alameda22 ($23.10 in chips) 
murphy-mcben: posts small blind $0.10
hakunamtata: posts big blind $0.25
*** HOLE CARDS ***
Dealt to Alameda22 [Kh 4h]
dukitup: folds 
jst_the_nuts: raises $0.25 to $0.50
Crazy685: folds 
oberst_dicht: folds 
Alameda22: folds 
ciDoR: folds 
Sortime: calls $0.50
murphy-mcben: folds 
hakunamtata: raises $1.50 to $2
jst_the_nuts: calls $1.50
Sortime: folds 
*** FLOP *** [9c 7s 2s]
hakunamtata: bets $2.25
Sortime leaves the table
jst_the_nuts: folds 
Uncalled bet ($2.25) returned to hakunamtata
hakunamtata collected $4.40 from pot
hakunamtata: doesn't show hand 
*** SUMMARY ***
Total pot $4.60 | Rake $0.20 
Board [9c 7s 2s]
Seat 1: ciDoR folded before Flop (didn't bet)
Seat 2: Sortime (button) folded before Flop
Seat 3: murphy-mcben (small blind) folded before Flop
Seat 4: hakunamtata (big blind) collected ($4.40)
Seat 5: dukitup folded before Flop (didn't bet)
Seat 6: jst_the_nuts folded on the Flop
Seat 7: Crazy685 folded before Flop (didn't bet)
Seat 8: oberst_dicht folded before Flop (didn't bet)
Seat 9: Alameda22 folded before Flop (didn't bet)



PokerStars Game #20096437481:  Hold'em No Limit ($0.10/$0.25) - 2008/09/02 15:56:38 ET
Table 'Rauma' 9-max Seat #3 is the button
Seat 1: ciDoR ($4.30 in chips) 
Seat 3: murphy-mcben ($6.75 in chips) 
Seat 4: hakunamtata ($24.15 in chips) 
Seat 5: dukitup ($8.50 in chips) 
Seat 6: jst_the_nuts ($8.85 in chips) 
Seat 7: Crazy685 ($5.10 in chips) 
Seat 8: oberst_dicht ($17.40 in chips) 
Seat 9: Alameda22 ($23.10 in chips) 
hakunamtata: posts small blind $0.10
dukitup: posts big blind $0.25
*** HOLE CARDS ***
Dealt to Alameda22 [Ac Jc]
jst_the_nuts: folds 
Crazy685: folds 
oberst_dicht: folds 
chessmanA1 joins the table at seat #2 
Alameda22: folds 
ciDoR: folds 
murphy-mcben: raises $0.50 to $0.75
hakunamtata: calls $0.65
dukitup: folds 
*** FLOP *** [8c 5s 6s]
hakunamtata: checks 
murphy-mcben: bets $0.75
hakunamtata: folds 
Uncalled bet ($0.75) returned to murphy-mcben
murphy-mcben collected $1.70 from pot
murphy-mcben: doesn't show hand 
*** SUMMARY ***
Total pot $1.75 | Rake $0.05 
Board [8c 5s 6s]
Seat 1: ciDoR folded before Flop (didn't bet)
Seat 3: murphy-mcben (button) collected ($1.70)
Seat 4: hakunamtata (small blind) folded on the Flop
Seat 5: dukitup (big blind) folded before Flop
Seat 6: jst_the_nuts folded before Flop (didn't bet)
Seat 7: Crazy685 folded before Flop (didn't bet)
Seat 8: oberst_dicht folded before Flop (didn't bet)
Seat 9: Alameda22 folded before Flop (didn't bet)



PokerStars Game #20096456457:  Hold'em No Limit ($0.10/$0.25) - 2008/09/02 15:57:24 ET
Table 'Rauma' 9-max Seat #4 is the button
Seat 1: ciDoR ($4.30 in chips) 
Seat 3: murphy-mcben ($7.70 in chips) 
Seat 4: hakunamtata ($23.40 in chips) 
Seat 5: dukitup ($8.25 in chips) 
Seat 6: jst_the_nuts ($8.85 in chips) 
Seat 7: Crazy685 ($5.10 in chips) 
Seat 8: oberst_dicht ($17.40 in chips) 
Seat 9: Alameda22 ($23.10 in chips) 
dukitup: posts small blind $0.10
jst_the_nuts: posts big blind $0.25
chessmanA1: sits out 
*** HOLE CARDS ***
Dealt to Alameda22 [3c As]
Crazy685: folds 
oberst_dicht: folds 
Alameda22: folds 
ciDoR: folds 
murphy-mcben: folds 
hakunamtata: calls $0.25
dukitup: raises $1.25 to $1.50
jst_the_nuts: calls $1.25
hakunamtata: folds 
*** FLOP *** [6s 5d Ad]
dukitup: bets $2
jst_the_nuts: raises $5.35 to $7.35 and is all-in
dukitup: folds 
Uncalled bet ($5.35) returned to jst_the_nuts
jst_the_nuts collected $6.90 from pot
jst_the_nuts: shows [Ac Ah] (three of a kind, Aces)
*** SUMMARY ***
Total pot $7.25 | Rake $0.35 
Board [6s 5d Ad]
Seat 1: ciDoR folded before Flop (didn't bet)
Seat 3: murphy-mcben folded before Flop (didn't bet)
Seat 4: hakunamtata (button) folded before Flop
Seat 5: dukitup (small blind) folded on the Flop
Seat 6: jst_the_nuts (big blind) collected ($6.90)
Seat 7: Crazy685 folded before Flop (didn't bet)
Seat 8: oberst_dicht folded before Flop (didn't bet)
Seat 9: Alameda22 folded before Flop (didn't bet)



PokerStars Game #20096482881:  Hold'em No Limit ($0.10/$0.25) - 2008/09/02 15:58:30 ET
Table 'Rauma' 9-max Seat #5 is the button
Seat 1: ciDoR ($4.30 in chips) 
Seat 3: murphy-mcben ($7.70 in chips) 
Seat 4: hakunamtata ($23.15 in chips) 
Seat 5: dukitup ($4.75 in chips) 
Seat 6: jst_the_nuts ($12.25 in chips) 
Seat 7: Crazy685 ($5.10 in chips) 
Seat 8: oberst_dicht ($17.40 in chips) 
Seat 9: Alameda22 ($23.10 in chips) 
dukitup said, "nh"
jst_the_nuts: posts small blind $0.10
Crazy685: posts big blind $0.25
chessmanA1: sits out 
*** HOLE CARDS ***
Dealt to Alameda22 [Jh Ks]
oberst_dicht: folds 
jst_the_nuts said, "ty"
Alameda22: folds 
ciDoR: folds 
murphy-mcben: raises $0.25 to $0.50
hakunamtata: folds 
dukitup: calls $0.50
jst_the_nuts: folds 
Crazy685: calls $0.25
*** FLOP *** [8h Qd Ac]
Crazy685: checks 
murphy-mcben: checks 
dukitup: checks 
*** TURN *** [8h Qd Ac] [Th]
Crazy685: checks 
murphy-mcben: bets $0.50
dukitup: folds 
Crazy685: folds 
Uncalled bet ($0.50) returned to murphy-mcben
murphy-mcben collected $1.55 from pot
murphy-mcben: doesn't show hand 
*** SUMMARY ***
Total pot $1.60 | Rake $0.05 
Board [8h Qd Ac Th]
Seat 1: ciDoR folded before Flop (didn't bet)
Seat 3: murphy-mcben collected ($1.55)
Seat 4: hakunamtata folded before Flop (didn't bet)
Seat 5: dukitup (button) folded on the Turn
Seat 6: jst_the_nuts (small blind) folded before Flop
Seat 7: Crazy685 (big blind) folded on the Turn
Seat 8: oberst_dicht folded before Flop (didn't bet)
Seat 9: Alameda22 folded before Flop (didn't bet)



PokerStars Game #20096501039:  Hold'em No Limit ($0.10/$0.25) - 2008/09/02 15:59:15 ET
Table 'Rauma' 9-max Seat #6 is the button
Seat 1: ciDoR ($4.30 in chips) 
Seat 3: murphy-mcben ($8.75 in chips) 
Seat 4: hakunamtata ($23.15 in chips) 
Seat 5: dukitup ($4.25 in chips) 
Seat 6: jst_the_nuts ($12.15 in chips) 
Seat 7: Crazy685 ($4.60 in chips) 
Seat 8: oberst_dicht ($17.40 in chips) 
Seat 9: Alameda22 ($23.10 in chips) 
Crazy685: posts small blind $0.10
oberst_dicht: posts big blind $0.25
chessmanA1: sits out 
*** HOLE CARDS ***
Dealt to Alameda22 [6h 2s]
Alameda22: folds 
ciDoR: folds 
murphy-mcben: folds 
hakunamtata: folds 
dukitup: folds 
jst_the_nuts: folds 
Crazy685: folds 
Uncalled bet ($0.15) returned to oberst_dicht
oberst_dicht collected $0.20 from pot
*** SUMMARY ***
Total pot $0.20 | Rake $0 
Seat 1: ciDoR folded before Flop (didn't bet)
Seat 3: murphy-mcben folded before Flop (didn't bet)
Seat 4: hakunamtata folded before Flop (didn't bet)
Seat 5: dukitup folded before Flop (didn't bet)
Seat 6: jst_the_nuts (button) folded before Flop (didn't bet)
Seat 7: Crazy685 (small blind) folded before Flop
Seat 8: oberst_dicht (big blind) collected ($0.20)
Seat 9: Alameda22 folded before Flop (didn't bet)



PokerStars Game #20096516656:  Hold'em No Limit ($0.10/$0.25) - 2008/09/02 15:59:54 ET
Table 'Rauma' 9-max Seat #7 is the button
Seat 1: ciDoR ($4.30 in chips) 
Seat 3: murphy-mcben ($8.75 in chips) 
Seat 4: hakunamtata ($23.15 in chips) 
Seat 5: dukitup ($4.25 in chips) 
Seat 6: jst_the_nuts ($12.15 in chips) 
Seat 7: Crazy685 ($4.50 in chips) 
Seat 8: oberst_dicht ($17.50 in chips) 
Seat 9: Alameda22 ($23.10 in chips) 
oberst_dicht: posts small blind $0.10
Alameda22: posts big blind $0.25
chessmanA1: sits out 
*** HOLE CARDS ***
Dealt to Alameda22 [9s Js]
ciDoR: folds 
murphy-mcben: folds 
hakunamtata: folds 
dukitup: folds 
jst_the_nuts: folds 
Crazy685: folds 
oberst_dicht: calls $0.15
Alameda22: checks 
*** FLOP *** [Ks Ah 7s]
oberst_dicht: checks 
Alameda22: bets $0.50
oberst_dicht: folds 
Uncalled bet ($0.50) returned to Alameda22
Alameda22 collected $0.50 from pot
Alameda22: doesn't show hand 
*** SUMMARY ***
Total pot $0.50 | Rake $0 
Board [Ks Ah 7s]
Seat 1: ciDoR folded before Flop (didn't bet)
Seat 3: murphy-mcben folded before Flop (didn't bet)
Seat 4: hakunamtata folded before Flop (didn't bet)
Seat 5: dukitup folded before Flop (didn't bet)
Seat 6: jst_the_nuts folded before Flop (didn't bet)
Seat 7: Crazy685 (button) folded before Flop (didn't bet)
Seat 8: oberst_dicht (small blind) folded on the Flop
Seat 9: Alameda22 (big blind) collected ($0.50)



PokerStars Game #20096533859:  Hold'em No Limit ($0.10/$0.25) - 2008/09/02 16:00:35 ET
Table 'Rauma' 9-max Seat #8 is the button
Seat 1: ciDoR ($4.30 in chips) 
Seat 3: murphy-mcben ($8.75 in chips) 
Seat 4: hakunamtata ($23.15 in chips) 
Seat 5: dukitup ($4.25 in chips) 
Seat 6: jst_the_nuts ($12.15 in chips) 
Seat 7: Crazy685 ($25 in chips) 
Seat 8: oberst_dicht ($17.25 in chips) 
Seat 9: Alameda22 ($23.35 in chips) 
Alameda22: posts small blind $0.10
ciDoR: posts big blind $0.25
chessmanA1: sits out 
*** HOLE CARDS ***
Dealt to Alameda22 [Th 7s]
murphy-mcben: folds 
hakunamtata: folds 
dukitup: raises $0.75 to $1
jst_the_nuts: folds 
Crazy685: folds 
oberst_dicht: folds 
Alameda22: folds 
ciDoR: folds 
Uncalled bet ($0.75) returned to dukitup
dukitup collected $0.60 from pot
dukitup: doesn't show hand 
*** SUMMARY ***
Total pot $0.60 | Rake $0 
Seat 1: ciDoR (big blind) folded before Flop
Seat 3: murphy-mcben folded before Flop (didn't bet)
Seat 4: hakunamtata folded before Flop (didn't bet)
Seat 5: dukitup collected ($0.60)
Seat 6: jst_the_nuts folded before Flop (didn't bet)
Seat 7: Crazy685 folded before Flop (didn't bet)
Seat 8: oberst_dicht (button) folded before Flop (didn't bet)
Seat 9: Alameda22 (small blind) folded before Flop



PokerStars Game #20096546408:  Hold'em No Limit ($0.10/$0.25) - 2008/09/02 16:01:05 ET
Table 'Rauma' 9-max Seat #9 is the button
Seat 1: ciDoR ($4.05 in chips) 
Seat 2: chessmanA1 ($15 in chips) 
Seat 3: murphy-mcben ($8.75 in chips) 
Seat 4: hakunamtata ($23.15 in chips) 
Seat 5: dukitup ($4.60 in chips) 
Seat 6: jst_the_nuts ($12.15 in chips) 
Seat 7: Crazy685 ($25 in chips) 
Seat 8: oberst_dicht ($17.25 in chips) 
Seat 9: Alameda22 ($23.25 in chips) 
ciDoR: posts small blind $0.10
chessmanA1: posts big blind $0.25
*** HOLE CARDS ***
Dealt to Alameda22 [5c 8s]
murphy-mcben: folds 
hakunamtata: folds 
dukitup: calls $0.25
jst_the_nuts: raises $0.55 to $0.80
Crazy685: folds 
oberst_dicht: folds 
Alameda22: folds 
ciDoR: folds 
chessmanA1: folds 
dukitup: calls $0.55
*** FLOP *** [Qs Qh Js]
dukitup: checks 
jst_the_nuts: checks 
*** TURN *** [Qs Qh Js] [As]
dukitup: checks 
jst_the_nuts: checks 
*** RIVER *** [Qs Qh Js As] [2c]
dukitup: bets $2
jst_the_nuts: raises $2 to $4
dukitup: calls $1.80 and is all-in
Uncalled bet ($0.20) returned to jst_the_nuts
*** SHOW DOWN ***
jst_the_nuts: shows [Kd Ac] (two pair, Aces and Queens)
dukitup: shows [4d Qd] (three of a kind, Queens)
dukitup collected $9.10 from pot
jst_the_nuts said, "lol n1"
*** SUMMARY ***
Total pot $9.55 | Rake $0.45 
Board [Qs Qh Js As 2c]
Seat 1: ciDoR (small blind) folded before Flop
Seat 2: chessmanA1 (big blind) folded before Flop
Seat 3: murphy-mcben folded before Flop (didn't bet)
Seat 4: hakunamtata folded before Flop (didn't bet)
Seat 5: dukitup showed [4d Qd] and won ($9.10) with three of a kind, Queens
Seat 6: jst_the_nuts showed [Kd Ac] and lost with two pair, Aces and Queens
Seat 7: Crazy685 folded before Flop (didn't bet)
Seat 8: oberst_dicht folded before Flop (didn't bet)
Seat 9: Alameda22 (button) folded before Flop (didn't bet)



PokerStars Game #20096568848:  Hold'em No Limit ($0.10/$0.25) - 2008/09/02 16:02:00 ET
Table 'Rauma' 9-max Seat #1 is the button
Seat 1: ciDoR ($3.95 in chips) 
Seat 2: chessmanA1 ($14.75 in chips) 
Seat 3: murphy-mcben ($8.75 in chips) 
Seat 4: hakunamtata ($23.15 in chips) 
Seat 5: dukitup ($9.10 in chips) 
Seat 6: jst_the_nuts ($7.55 in chips) 
Seat 7: Crazy685 ($25 in chips) 
Seat 8: oberst_dicht ($17.25 in chips) 
Seat 9: Alameda22 ($23.25 in chips) 
dukitup said, "ty"
Crazy685 said, "way too many $5 stacks at this table"
chessmanA1: posts small blind $0.10
murphy-mcben: posts big blind $0.25
*** HOLE CARDS ***
Dealt to Alameda22 [9d 9c]
hakunamtata: raises $0.50 to $0.75
dukitup: folds 
jst_the_nuts: folds 
Crazy685: folds 
Crazy685 said, "why not just play at the lower limits with $5"
oberst_dicht: folds 
Alameda22: calls $0.75
ciDoR: folds 
chessmanA1: folds 
dukitup said, "your right"
murphy-mcben: folds 
*** FLOP *** [3c 3h 9h]
hakunamtata said, "waiting for all in chances"
hakunamtata: bets $0.75
Alameda22: raises $1.50 to $2.25
jst_the_nuts said, "i am as low as i will go i dnt normally play at these levels but due to bad bets"
hakunamtata: folds 
Uncalled bet ($1.50) returned to Alameda22
Alameda22 collected $3.20 from pot
Alameda22: doesn't show hand 
*** SUMMARY ***
Total pot $3.35 | Rake $0.15 
Board [3c 3h 9h]
Seat 1: ciDoR (button) folded before Flop (didn't bet)
Seat 2: chessmanA1 (small blind) folded before Flop
Seat 3: murphy-mcben (big blind) folded before Flop
Seat 4: hakunamtata folded on the Flop
Seat 5: dukitup folded before Flop (didn't bet)
Seat 6: jst_the_nuts folded before Flop (didn't bet)
Seat 7: Crazy685 folded before Flop (didn't bet)
Seat 8: oberst_dicht folded before Flop (didn't bet)
Seat 9: Alameda22 collected ($3.20)



PokerStars Game #20096601483:  Hold'em No Limit ($0.10/$0.25) - 2008/09/02 16:03:20 ET
Table 'Rauma' 9-max Seat #2 is the button
Seat 1: ciDoR ($5 in chips) 
Seat 2: chessmanA1 ($14.65 in chips) 
Seat 3: murphy-mcben ($8.50 in chips) 
Seat 5: dukitup ($9.10 in chips) 
Seat 6: jst_the_nuts ($7.55 in chips) 
Seat 7: Crazy685 ($25 in chips) 
Seat 8: oberst_dicht ($17.25 in chips) 
Seat 9: Alameda22 ($24.95 in chips) 
murphy-mcben: posts small blind $0.10
hakunamtata: is sitting out 
dukitup: posts big blind $0.25
*** HOLE CARDS ***
Dealt to Alameda22 [Jc 9d]
hakunamtata leaves the table
jst_the_nuts: calls $0.25
Crazy685: folds 
oberst_dicht: folds 
Crazy685 said, "just curious."
FlopkillaNo1 joins the table at seat #4 
Alameda22: folds 
ciDoR: folds 
chessmanA1: folds 
murphy-mcben: raises $1 to $1.25
dukitup: folds 
jst_the_nuts: folds 
Uncalled bet ($1) returned to murphy-mcben
murphy-mcben collected $0.75 from pot
murphy-mcben: doesn't show hand 
*** SUMMARY ***
Total pot $0.75 | Rake $0 
Seat 1: ciDoR folded before Flop (didn't bet)
Seat 2: chessmanA1 (button) folded before Flop (didn't bet)
Seat 3: murphy-mcben (small blind) collected ($0.75)
Seat 5: dukitup (big blind) folded before Flop
Seat 6: jst_the_nuts folded before Flop
Seat 7: Crazy685 folded before Flop (didn't bet)
Seat 8: oberst_dicht folded before Flop (didn't bet)
Seat 9: Alameda22 folded before Flop (didn't bet)



PokerStars Game #20096614836:  Hold'em No Limit ($0.10/$0.25) - 2008/09/02 16:03:53 ET
Table 'Rauma' 9-max Seat #3 is the button
Seat 1: ciDoR ($5 in chips) 
Seat 2: chessmanA1 ($14.65 in chips) 
Seat 3: murphy-mcben ($9 in chips) 
Seat 5: dukitup ($8.85 in chips) 
Seat 6: jst_the_nuts ($7.30 in chips) 
Seat 7: Crazy685 ($25 in chips) 
Seat 8: oberst_dicht ($17.25 in chips) 
Seat 9: Alameda22 ($24.95 in chips) 
FlopkillaNo1 will be allowed to play after the button
dukitup: posts small blind $0.10
jst_the_nuts: posts big blind $0.25
*** HOLE CARDS ***
Dealt to Alameda22 [2s 3h]
Crazy685: folds 
oberst_dicht: folds 
Alameda22: folds 
ciDoR: folds 
chessmanA1: folds 
murphy-mcben: folds 
dukitup: calls $0.15
jst_the_nuts: checks 
*** FLOP *** [4h Jh 2c]
dukitup: checks 
jst_the_nuts: checks 
*** TURN *** [4h Jh 2c] [4d]
dukitup: bets $0.50
jst_the_nuts: folds 
Uncalled bet ($0.50) returned to dukitup
dukitup collected $0.50 from pot
dukitup: doesn't show hand 
*** SUMMARY ***
Total pot $0.50 | Rake $0 
Board [4h Jh 2c 4d]
Seat 1: ciDoR folded before Flop (didn't bet)
Seat 2: chessmanA1 folded before Flop (didn't bet)
Seat 3: murphy-mcben (button) folded before Flop (didn't bet)
Seat 5: dukitup (small blind) collected ($0.50)
Seat 6: jst_the_nuts (big blind) folded on the Turn
Seat 7: Crazy685 folded before Flop (didn't bet)
Seat 8: oberst_dicht folded before Flop (didn't bet)
Seat 9: Alameda22 folded before Flop (didn't bet)



PokerStars Game #20096630905:  Hold'em No Limit ($0.10/$0.25) - 2008/09/02 16:04:31 ET
Table 'Rauma' 9-max Seat #5 is the button
Seat 1: ciDoR ($5 in chips) 
Seat 2: chessmanA1 ($14.65 in chips) 
Seat 3: murphy-mcben ($9 in chips) 
Seat 4: FlopkillaNo1 ($10.15 in chips) 
Seat 5: dukitup ($9.10 in chips) 
Seat 6: jst_the_nuts ($7.05 in chips) 
Seat 7: Crazy685 ($25 in chips) 
Seat 8: oberst_dicht ($17.25 in chips) 
Seat 9: Alameda22 ($24.95 in chips) 
jst_the_nuts: posts small blind $0.10
Crazy685: posts big blind $0.25
FlopkillaNo1: posts big blind $0.25
*** HOLE CARDS ***
Dealt to Alameda22 [4h Ad]
oberst_dicht: calls $0.25
Alameda22: folds 
ciDoR: folds 
chessmanA1: folds 
murphy-mcben: folds 
FlopkillaNo1: checks 
dukitup: raises $0.50 to $0.75
jst_the_nuts: folds 
Crazy685: calls $0.50
oberst_dicht: calls $0.50
FlopkillaNo1: calls $0.50
*** FLOP *** [Jc Qh Js]
Crazy685: checks 
oberst_dicht: checks 
FlopkillaNo1: checks 
dukitup: bets $0.25
Crazy685: folds 
oberst_dicht: folds 
FlopkillaNo1: folds 
Uncalled bet ($0.25) returned to dukitup
dukitup collected $2.95 from pot
dukitup: doesn't show hand 
*** SUMMARY ***
Total pot $3.10 | Rake $0.15 
Board [Jc Qh Js]
Seat 1: ciDoR folded before Flop (didn't bet)
Seat 2: chessmanA1 folded before Flop (didn't bet)
Seat 3: murphy-mcben folded before Flop (didn't bet)
Seat 4: FlopkillaNo1 folded on the Flop
Seat 5: dukitup (button) collected ($2.95)
Seat 6: jst_the_nuts (small blind) folded before Flop
Seat 7: Crazy685 (big blind) folded on the Flop
Seat 8: oberst_dicht folded on the Flop
Seat 9: Alameda22 folded before Flop (didn't bet)



PokerStars Game #20096666669:  Hold'em No Limit ($0.10/$0.25) - 2008/09/02 16:05:58 ET
Table 'Rauma' 9-max Seat #6 is the button
Seat 1: ciDoR ($5 in chips) 
Seat 2: chessmanA1 ($14.65 in chips) 
Seat 3: murphy-mcben ($9 in chips) 
Seat 4: FlopkillaNo1 ($9.40 in chips) 
Seat 5: dukitup ($11.30 in chips) 
Seat 6: jst_the_nuts ($6.95 in chips) 
Seat 7: Crazy685 ($24.25 in chips) 
Seat 8: oberst_dicht ($16.50 in chips) 
Seat 9: Alameda22 ($24.95 in chips) 
Crazy685: posts small blind $0.10
oberst_dicht: posts big blind $0.25
*** HOLE CARDS ***
Dealt to Alameda22 [8s 8h]
Alameda22: folds 
ciDoR: folds 
chessmanA1: folds 
murphy-mcben: folds 
FlopkillaNo1: folds 
dukitup: folds 
jst_the_nuts: folds 
Crazy685: folds 
Uncalled bet ($0.15) returned to oberst_dicht
oberst_dicht collected $0.20 from pot
*** SUMMARY ***
Total pot $0.20 | Rake $0 
Seat 1: ciDoR folded before Flop (didn't bet)
Seat 2: chessmanA1 folded before Flop (didn't bet)
Seat 3: murphy-mcben folded before Flop (didn't bet)
Seat 4: FlopkillaNo1 folded before Flop (didn't bet)
Seat 5: dukitup folded before Flop (didn't bet)
Seat 6: jst_the_nuts (button) folded before Flop (didn't bet)
Seat 7: Crazy685 (small blind) folded before Flop
Seat 8: oberst_dicht (big blind) collected ($0.20)
Seat 9: Alameda22 folded before Flop (didn't bet)



PokerStars Game #20096676969:  Hold'em No Limit ($0.10/$0.25) - 2008/09/02 16:06:23 ET
Table 'Rauma' 9-max Seat #7 is the button
Seat 1: ciDoR ($5 in chips) 
Seat 2: chessmanA1 ($14.65 in chips) 
Seat 3: murphy-mcben ($9 in chips) 
Seat 4: FlopkillaNo1 ($9.40 in chips) 
Seat 5: dukitup ($11.30 in chips) 
Seat 6: jst_the_nuts ($6.95 in chips) 
Seat 7: Crazy685 ($24.15 in chips) 
Seat 8: oberst_dicht ($16.60 in chips) 
Seat 9: Alameda22 ($24.95 in chips) 
oberst_dicht: posts small blind $0.10
Alameda22: posts big blind $0.25
*** HOLE CARDS ***
Dealt to Alameda22 [Ac Qs]
ciDoR: raises $0.75 to $1
chessmanA1: folds 
murphy-mcben: folds 
FlopkillaNo1: folds 
dukitup: folds 
jst_the_nuts: folds 
Crazy685: folds 
oberst_dicht: folds 
Alameda22: folds 
Uncalled bet ($0.75) returned to ciDoR
ciDoR collected $0.60 from pot
*** SUMMARY ***
Total pot $0.60 | Rake $0 
Seat 1: ciDoR collected ($0.60)
Seat 2: chessmanA1 folded before Flop (didn't bet)
Seat 3: murphy-mcben folded before Flop (didn't bet)
Seat 4: FlopkillaNo1 folded before Flop (didn't bet)
Seat 5: dukitup folded before Flop (didn't bet)
Seat 6: jst_the_nuts folded before Flop (didn't bet)
Seat 7: Crazy685 (button) folded before Flop (didn't bet)
Seat 8: oberst_dicht (small blind) folded before Flop
Seat 9: Alameda22 (big blind) folded before Flop



PokerStars Game #20096707925:  Hold'em No Limit ($0.10/$0.25) - 2008/09/02 16:07:37 ET
Table 'Rauma' 9-max Seat #8 is the button
Seat 1: ciDoR ($5.35 in chips) 
Seat 2: chessmanA1 ($14.65 in chips) 
Seat 3: murphy-mcben ($9 in chips) 
Seat 4: FlopkillaNo1 ($9.40 in chips) 
Seat 5: dukitup ($11.30 in chips) 
Seat 6: jst_the_nuts ($6.95 in chips) 
Seat 7: Crazy685 ($24.15 in chips) 
Seat 8: oberst_dicht ($16.50 in chips) 
Seat 9: Alameda22 ($24.70 in chips) 
Alameda22: posts small blind $0.10
ciDoR: posts big blind $0.25
*** HOLE CARDS ***
Dealt to Alameda22 [6h 5d]
chessmanA1: calls $0.25
murphy-mcben: folds 
FlopkillaNo1: calls $0.25
dukitup: calls $0.25
jst_the_nuts: calls $0.25
Crazy685: folds 
oberst_dicht: folds 
Alameda22: folds 
ciDoR: checks 
*** FLOP *** [7c 4h Qd]
ciDoR: checks 
chessmanA1: checks 
FlopkillaNo1: bets $0.50
dukitup: folds 
jst_the_nuts: folds 
ciDoR: folds 
chessmanA1: folds 
Uncalled bet ($0.50) returned to FlopkillaNo1
FlopkillaNo1 collected $1.30 from pot
FlopkillaNo1: doesn't show hand 
*** SUMMARY ***
Total pot $1.35 | Rake $0.05 
Board [7c 4h Qd]
Seat 1: ciDoR (big blind) folded on the Flop
Seat 2: chessmanA1 folded on the Flop
Seat 3: murphy-mcben folded before Flop (didn't bet)
Seat 4: FlopkillaNo1 collected ($1.30)
Seat 5: dukitup folded on the Flop
Seat 6: jst_the_nuts folded on the Flop
Seat 7: Crazy685 folded before Flop (didn't bet)
Seat 8: oberst_dicht (button) folded before Flop (didn't bet)
Seat 9: Alameda22 (small blind) folded before Flop



PokerStars Game #20096740903:  Hold'em No Limit ($0.10/$0.25) - 2008/09/02 16:08:56 ET
Table 'Rauma' 9-max Seat #9 is the button
Seat 1: ciDoR ($5.10 in chips) 
Seat 2: chessmanA1 ($14.40 in chips) 
Seat 3: murphy-mcben ($9 in chips) 
Seat 4: FlopkillaNo1 ($10.45 in chips) 
Seat 5: dukitup ($11.05 in chips) 
Seat 6: jst_the_nuts ($6.70 in chips) 
Seat 7: Crazy685 ($24.15 in chips) 
Seat 8: oberst_dicht ($16.50 in chips) 
Seat 9: Alameda22 ($24.60 in chips) 
ciDoR: posts small blind $0.10
chessmanA1: posts big blind $0.25
*** HOLE CARDS ***
Dealt to Alameda22 [Ts Jc]
murphy-mcben: folds 
jst_the_nuts said, "cmon"
FlopkillaNo1: calls $0.25
dukitup: calls $0.25
jst_the_nuts: calls $0.25
Crazy685: folds 
oberst_dicht: folds 
Alameda22: folds 
ciDoR: folds 
chessmanA1: checks 
*** FLOP *** [7c 6h Ah]
chessmanA1: checks 
FlopkillaNo1: checks 
dukitup: checks 
jst_the_nuts: bets $0.75
chessmanA1: folds 
FlopkillaNo1: folds 
dukitup: folds 
Uncalled bet ($0.75) returned to jst_the_nuts
jst_the_nuts collected $1.05 from pot
jst_the_nuts: doesn't show hand 
*** SUMMARY ***
Total pot $1.10 | Rake $0.05 
Board [7c 6h Ah]
Seat 1: ciDoR (small blind) folded before Flop
Seat 2: chessmanA1 (big blind) folded on the Flop
Seat 3: murphy-mcben folded before Flop (didn't bet)
Seat 4: FlopkillaNo1 folded on the Flop
Seat 5: dukitup folded on the Flop
Seat 6: jst_the_nuts collected ($1.05)
Seat 7: Crazy685 folded before Flop (didn't bet)
Seat 8: oberst_dicht folded before Flop (didn't bet)
Seat 9: Alameda22 (button) folded before Flop (didn't bet)



PokerStars Game #20096780356:  Hold'em No Limit ($0.10/$0.25) - 2008/09/02 16:10:30 ET
Table 'Rauma' 9-max Seat #1 is the button
Seat 1: ciDoR ($5 in chips) 
Seat 2: chessmanA1 ($14.15 in chips) 
Seat 3: murphy-mcben ($9 in chips) 
Seat 4: FlopkillaNo1 ($10.20 in chips) 
Seat 5: dukitup ($10.80 in chips) 
Seat 6: jst_the_nuts ($7.50 in chips) 
Seat 7: Crazy685 ($24.15 in chips) 
Seat 8: oberst_dicht ($16.50 in chips) 
Seat 9: Alameda22 ($24.60 in chips) 
chessmanA1: posts small blind $0.10
murphy-mcben: posts big blind $0.25
*** HOLE CARDS ***
Dealt to Alameda22 [Jh 6s]
FlopkillaNo1: calls $0.25
dukitup: folds 
jst_the_nuts: folds 
Crazy685: folds 
oberst_dicht: raises $0.50 to $0.75
Alameda22: folds 
ciDoR: folds 
chessmanA1: folds 
murphy-mcben: folds 
FlopkillaNo1: calls $0.50
*** FLOP *** [Qh 7s Js]
FlopkillaNo1: checks 
oberst_dicht: bets $1
FlopkillaNo1: folds 
Uncalled bet ($1) returned to oberst_dicht
oberst_dicht collected $1.80 from pot
oberst_dicht: doesn't show hand 
*** SUMMARY ***
Total pot $1.85 | Rake $0.05 
Board [Qh 7s Js]
Seat 1: ciDoR (button) folded before Flop (didn't bet)
Seat 2: chessmanA1 (small blind) folded before Flop
Seat 3: murphy-mcben (big blind) folded before Flop
Seat 4: FlopkillaNo1 folded on the Flop
Seat 5: dukitup folded before Flop (didn't bet)
Seat 6: jst_the_nuts folded before Flop (didn't bet)
Seat 7: Crazy685 folded before Flop (didn't bet)
Seat 8: oberst_dicht collected ($1.80)
Seat 9: Alameda22 folded before Flop (didn't bet)



PokerStars Game #20096808583:  Hold'em No Limit ($0.10/$0.25) - 2008/09/02 16:11:37 ET
Table 'Rauma' 9-max Seat #2 is the button
Seat 1: ciDoR ($5 in chips) 
Seat 2: chessmanA1 ($14.05 in chips) 
Seat 3: murphy-mcben ($8.75 in chips) 
Seat 4: FlopkillaNo1 ($9.45 in chips) 
Seat 5: dukitup ($10.80 in chips) 
Seat 6: jst_the_nuts ($7.50 in chips) 
Seat 7: Crazy685 ($24.15 in chips) 
Seat 8: oberst_dicht ($17.55 in chips) 
Seat 9: Alameda22 ($24.60 in chips) 
murphy-mcben: posts small blind $0.10
FlopkillaNo1: posts big blind $0.25
*** HOLE CARDS ***
Dealt to Alameda22 [6h 8s]
dukitup: folds 
jst_the_nuts: folds 
Crazy685: folds 
oberst_dicht: folds 
Alameda22: folds 
ciDoR: folds 
chessmanA1: folds 
murphy-mcben: calls $0.15
FlopkillaNo1: checks 
*** FLOP *** [Kd Ah 4s]
murphy-mcben: bets $0.50
FlopkillaNo1: calls $0.50
*** TURN *** [Kd Ah 4s] [5s]
murphy-mcben: bets $1.75
FlopkillaNo1: calls $1.75
*** RIVER *** [Kd Ah 4s 5s] [Th]
murphy-mcben: bets $2
FlopkillaNo1: calls $2
*** SHOW DOWN ***
murphy-mcben: shows [5d 6d] (a pair of Fives)
FlopkillaNo1: shows [Kc 8d] (a pair of Kings)
FlopkillaNo1 collected $8.60 from pot
*** SUMMARY ***
Total pot $9 | Rake $0.40 
Board [Kd Ah 4s 5s Th]
Seat 1: ciDoR folded before Flop (didn't bet)
Seat 2: chessmanA1 (button) folded before Flop (didn't bet)
Seat 3: murphy-mcben (small blind) showed [5d 6d] and lost with a pair of Fives
Seat 4: FlopkillaNo1 (big blind) showed [Kc 8d] and won ($8.60) with a pair of Kings
Seat 5: dukitup folded before Flop (didn't bet)
Seat 6: jst_the_nuts folded before Flop (didn't bet)
Seat 7: Crazy685 folded before Flop (didn't bet)
Seat 8: oberst_dicht folded before Flop (didn't bet)
Seat 9: Alameda22 folded before Flop (didn't bet)



PokerStars Game #20096835655:  Hold'em No Limit ($0.10/$0.25) - 2008/09/02 16:12:42 ET
Table 'Rauma' 9-max Seat #3 is the button
Seat 1: ciDoR ($5 in chips) 
Seat 2: chessmanA1 ($14.05 in chips) 
Seat 3: murphy-mcben ($4.25 in chips) 
Seat 4: FlopkillaNo1 ($13.55 in chips) 
Seat 5: dukitup ($10.80 in chips) 
Seat 6: jst_the_nuts ($7.50 in chips) 
Seat 7: Crazy685 ($24.15 in chips) 
Seat 8: oberst_dicht ($17.55 in chips) 
Seat 9: Alameda22 ($24.60 in chips) 
FlopkillaNo1: posts small blind $0.10
dukitup: posts big blind $0.25
*** HOLE CARDS ***
Dealt to Alameda22 [9d 7d]
jst_the_nuts: raises $0.25 to $0.50
Crazy685: folds 
oberst_dicht: folds 
Alameda22: folds 
ciDoR: folds 
chessmanA1: folds 
murphy-mcben: folds 
FlopkillaNo1: folds 
dukitup: calls $0.25
*** FLOP *** [Tc 4d 9h]
dukitup: checks 
jst_the_nuts: checks 
*** TURN *** [Tc 4d 9h] [8s]
dukitup: checks 
jst_the_nuts: checks 
*** RIVER *** [Tc 4d 9h 8s] [2c]
dukitup: checks 
jst_the_nuts: checks 
*** SHOW DOWN ***
dukitup: shows [5h Jh] (high card Jack)
jst_the_nuts: shows [Qd Kh] (high card King)
jst_the_nuts collected $1.05 from pot
*** SUMMARY ***
Total pot $1.10 | Rake $0.05 
Board [Tc 4d 9h 8s 2c]
Seat 1: ciDoR folded before Flop (didn't bet)
Seat 2: chessmanA1 folded before Flop (didn't bet)
Seat 3: murphy-mcben (button) folded before Flop (didn't bet)
Seat 4: FlopkillaNo1 (small blind) folded before Flop
Seat 5: dukitup (big blind) showed [5h Jh] and lost with high card Jack
Seat 6: jst_the_nuts showed [Qd Kh] and won ($1.05) with high card King
Seat 7: Crazy685 folded before Flop (didn't bet)
Seat 8: oberst_dicht folded before Flop (didn't bet)
Seat 9: Alameda22 folded before Flop (didn't bet)



PokerStars Game #20096859938:  Hold'em No Limit ($0.10/$0.25) - 2008/09/02 16:13:41 ET
Table 'Rauma' 9-max Seat #4 is the button
Seat 1: ciDoR ($5 in chips) 
Seat 2: chessmanA1 ($14.05 in chips) 
Seat 3: murphy-mcben ($4.25 in chips) 
Seat 4: FlopkillaNo1 ($13.45 in chips) 
Seat 5: dukitup ($10.30 in chips) 
Seat 6: jst_the_nuts ($8.05 in chips) 
Seat 7: Crazy685 ($24.15 in chips) 
Seat 8: oberst_dicht ($17.55 in chips) 
Seat 9: Alameda22 ($24.60 in chips) 
dukitup: posts small blind $0.10
jst_the_nuts: posts big blind $0.25
*** HOLE CARDS ***
Dealt to Alameda22 [Qs 5d]
Crazy685 has timed out
Crazy685: folds 
Crazy685 is sitting out
Crazy685 has returned
oberst_dicht: folds 
Alameda22: folds 
ciDoR: folds 
chessmanA1: folds 
murphy-mcben: folds 
FlopkillaNo1: raises $0.50 to $0.75
dukitup: folds 
jst_the_nuts: calls $0.50
*** FLOP *** [4c 6s 8d]
jst_the_nuts: checks 
FlopkillaNo1: bets $1
jst_the_nuts: folds 
Uncalled bet ($1) returned to FlopkillaNo1
FlopkillaNo1 collected $1.55 from pot
FlopkillaNo1: doesn't show hand 
*** SUMMARY ***
Total pot $1.60 | Rake $0.05 
Board [4c 6s 8d]
Seat 1: ciDoR folded before Flop (didn't bet)
Seat 2: chessmanA1 folded before Flop (didn't bet)
Seat 3: murphy-mcben folded before Flop (didn't bet)
Seat 4: FlopkillaNo1 (button) collected ($1.55)
Seat 5: dukitup (small blind) folded before Flop
Seat 6: jst_the_nuts (big blind) folded on the Flop
Seat 7: Crazy685 folded before Flop (didn't bet)
Seat 8: oberst_dicht folded before Flop (didn't bet)
Seat 9: Alameda22 folded before Flop (didn't bet)



PokerStars Game #20096891076:  Hold'em No Limit ($0.10/$0.25) - 2008/09/02 16:14:54 ET
Table 'Rauma' 9-max Seat #5 is the button
Seat 1: ciDoR ($5 in chips) 
Seat 2: chessmanA1 ($14.05 in chips) 
Seat 3: murphy-mcben ($4.25 in chips) 
Seat 4: FlopkillaNo1 ($14.25 in chips) 
Seat 5: dukitup ($10.20 in chips) 
Seat 6: jst_the_nuts ($7.30 in chips) 
Seat 7: Crazy685 ($24.15 in chips) 
Seat 8: oberst_dicht ($17.55 in chips) 
Seat 9: Alameda22 ($24.60 in chips) 
jst_the_nuts: posts small blind $0.10
Crazy685: posts big blind $0.25
*** HOLE CARDS ***
Dealt to Alameda22 [3s Ks]
oberst_dicht: folds 
Alameda22: folds 
ciDoR: folds 
chessmanA1: folds 
murphy-mcben: raises $0.50 to $0.75
FlopkillaNo1: folds 
dukitup: folds 
jst_the_nuts: folds 
Crazy685: folds 
Uncalled bet ($0.50) returned to murphy-mcben
murphy-mcben collected $0.60 from pot
murphy-mcben: doesn't show hand 
*** SUMMARY ***
Total pot $0.60 | Rake $0 
Seat 1: ciDoR folded before Flop (didn't bet)
Seat 2: chessmanA1 folded before Flop (didn't bet)
Seat 3: murphy-mcben collected ($0.60)
Seat 4: FlopkillaNo1 folded before Flop (didn't bet)
Seat 5: dukitup (button) folded before Flop (didn't bet)
Seat 6: jst_the_nuts (small blind) folded before Flop
Seat 7: Crazy685 (big blind) folded before Flop
Seat 8: oberst_dicht folded before Flop (didn't bet)
Seat 9: Alameda22 folded before Flop (didn't bet)



PokerStars Game #20096911636:  Hold'em No Limit ($0.10/$0.25) - 2008/09/02 16:15:43 ET
Table 'Rauma' 9-max Seat #6 is the button
Seat 1: ciDoR ($5 in chips) 
Seat 2: chessmanA1 ($14.05 in chips) 
Seat 3: murphy-mcben ($4.60 in chips) 
Seat 4: FlopkillaNo1 ($14.25 in chips) 
Seat 5: dukitup ($10.20 in chips) 
Seat 6: jst_the_nuts ($7.20 in chips) 
Seat 7: Crazy685 ($23.90 in chips) 
Seat 8: oberst_dicht ($17.55 in chips) 
Seat 9: Alameda22 ($24.60 in chips) 
Crazy685: posts small blind $0.10
oberst_dicht: posts big blind $0.25
*** HOLE CARDS ***
Dealt to Alameda22 [3c 5s]
Alameda22: folds 
ciDoR: folds 
chessmanA1: folds 
murphy-mcben: folds 
FlopkillaNo1: calls $0.25
dukitup: folds 
jst_the_nuts: folds 
Crazy685: folds 
oberst_dicht: checks 
*** FLOP *** [7s 7d Kh]
oberst_dicht: checks 
FlopkillaNo1: checks 
*** TURN *** [7s 7d Kh] [Tc]
oberst_dicht: bets $0.75
FlopkillaNo1: calls $0.75
*** RIVER *** [7s 7d Kh Tc] [6s]
oberst_dicht: bets $2.50
FlopkillaNo1: raises $2.50 to $5
oberst_dicht: folds 
Uncalled bet ($2.50) returned to FlopkillaNo1
oberst_dicht is sitting out
FlopkillaNo1 collected $6.75 from pot
FlopkillaNo1: doesn't show hand 
*** SUMMARY ***
Total pot $7.10 | Rake $0.35 
Board [7s 7d Kh Tc 6s]
Seat 1: ciDoR folded before Flop (didn't bet)
Seat 2: chessmanA1 folded before Flop (didn't bet)
Seat 3: murphy-mcben folded before Flop (didn't bet)
Seat 4: FlopkillaNo1 collected ($6.75)
Seat 5: dukitup folded before Flop (didn't bet)
Seat 6: jst_the_nuts (button) folded before Flop (didn't bet)
Seat 7: Crazy685 (small blind) folded before Flop
Seat 8: oberst_dicht (big blind) folded on the River
Seat 9: Alameda22 folded before Flop (didn't bet)



PokerStars Game #20096944890:  Hold'em No Limit ($0.10/$0.25) - 2008/09/02 16:17:02 ET
Table 'Rauma' 9-max Seat #7 is the button
Seat 1: ciDoR ($5 in chips) 
Seat 2: chessmanA1 ($14.05 in chips) 
Seat 3: murphy-mcben ($4.60 in chips) 
Seat 4: FlopkillaNo1 ($17.50 in chips) 
Seat 5: dukitup ($10.20 in chips) 
Seat 6: jst_the_nuts ($7.20 in chips) 
Seat 7: Crazy685 ($23.80 in chips) 
Seat 9: Alameda22 ($24.60 in chips) 
Alameda22: posts small blind $0.10
ciDoR: posts big blind $0.25
*** HOLE CARDS ***
Dealt to Alameda22 [8d 5c]
chessmanA1: folds 
murphy-mcben: folds 
FlopkillaNo1: folds 
dukitup: folds 
jst_the_nuts: folds 
oberst_dicht leaves the table
Crazy685: raises $1 to $1.25
Alameda22: folds 
ciDoR: folds 
Uncalled bet ($1) returned to Crazy685
Crazy685 collected $0.60 from pot
*** SUMMARY ***
Total pot $0.60 | Rake $0 
Seat 1: ciDoR (big blind) folded before Flop
Seat 2: chessmanA1 folded before Flop (didn't bet)
Seat 3: murphy-mcben folded before Flop (didn't bet)
Seat 4: FlopkillaNo1 folded before Flop (didn't bet)
Seat 5: dukitup folded before Flop (didn't bet)
Seat 6: jst_the_nuts folded before Flop (didn't bet)
Seat 7: Crazy685 (button) collected ($0.60)
Seat 9: Alameda22 (small blind) folded before Flop



PokerStars Game #20096964128:  Hold'em No Limit ($0.10/$0.25) - 2008/09/02 16:17:48 ET
Table 'Rauma' 9-max Seat #9 is the button
Seat 1: ciDoR ($4.75 in chips) 
Seat 2: chessmanA1 ($14.05 in chips) 
Seat 3: murphy-mcben ($4.60 in chips) 
Seat 4: FlopkillaNo1 ($17.50 in chips) 
Seat 5: dukitup ($10.20 in chips) 
Seat 6: jst_the_nuts ($7.20 in chips) 
Seat 7: Crazy685 ($24.15 in chips) 
Seat 9: Alameda22 ($24.50 in chips) 
ciDoR: posts small blind $0.10
chessmanA1: posts big blind $0.25
*** HOLE CARDS ***
Dealt to Alameda22 [Qh Tc]
murphy-mcben: folds 
FlopkillaNo1: folds 
dukitup: calls $0.25
jst_the_nuts: raises $0.25 to $0.50
Crazy685: calls $0.50
Alameda22: folds 
ciDoR: folds 
chessmanA1: folds 
dukitup: calls $0.25
*** FLOP *** [Qc Kc 6h]
dukitup: checks 
jst_the_nuts: bets $0.25
AsReyJota joins the table at seat #8 
Crazy685: folds 
dukitup: calls $0.25
*** TURN *** [Qc Kc 6h] [4d]
dukitup: checks 
jst_the_nuts: bets $0.25
dukitup: calls $0.25
*** RIVER *** [Qc Kc 6h 4d] [Ac]
dukitup: bets $1.25
jst_the_nuts: folds 
Uncalled bet ($1.25) returned to dukitup
dukitup collected $2.75 from pot
*** SUMMARY ***
Total pot $2.85 | Rake $0.10 
Board [Qc Kc 6h 4d Ac]
Seat 1: ciDoR (small blind) folded before Flop
Seat 2: chessmanA1 (big blind) folded before Flop
Seat 3: murphy-mcben folded before Flop (didn't bet)
Seat 4: FlopkillaNo1 folded before Flop (didn't bet)
Seat 5: dukitup collected ($2.75)
Seat 6: jst_the_nuts folded on the River
Seat 7: Crazy685 folded on the Flop
Seat 9: Alameda22 (button) folded before Flop (didn't bet)



PokerStars Game #20096999536:  Hold'em No Limit ($0.10/$0.25) - 2008/09/02 16:19:12 ET
Table 'Rauma' 9-max Seat #1 is the button
Seat 1: ciDoR ($4.65 in chips) 
Seat 2: chessmanA1 ($13.80 in chips) 
Seat 3: murphy-mcben ($4.60 in chips) 
Seat 4: FlopkillaNo1 ($17.50 in chips) 
Seat 5: dukitup ($11.95 in chips) 
Seat 6: jst_the_nuts ($6.20 in chips) 
Seat 7: Crazy685 ($23.65 in chips) 
Seat 8: AsReyJota ($15 in chips) 
Seat 9: Alameda22 ($24.50 in chips) 
chessmanA1: posts small blind $0.10
murphy-mcben: posts big blind $0.25
AsReyJota: posts big blind $0.25
*** HOLE CARDS ***
Dealt to Alameda22 [4d As]
FlopkillaNo1: raises $0.50 to $0.75
dukitup: folds 
jst_the_nuts said, "nice catch"
jst_the_nuts: folds 
Crazy685: folds 
AsReyJota: folds 
Alameda22: folds 
ciDoR: folds 
chessmanA1: folds 
murphy-mcben: folds 
Uncalled bet ($0.50) returned to FlopkillaNo1
FlopkillaNo1 collected $0.85 from pot
*** SUMMARY ***
Total pot $0.85 | Rake $0 
Seat 1: ciDoR (button) folded before Flop (didn't bet)
Seat 2: chessmanA1 (small blind) folded before Flop
Seat 3: murphy-mcben (big blind) folded before Flop
Seat 4: FlopkillaNo1 collected ($0.85)
Seat 5: dukitup folded before Flop (didn't bet)
Seat 6: jst_the_nuts folded before Flop (didn't bet)
Seat 7: Crazy685 folded before Flop (didn't bet)
Seat 8: AsReyJota folded before Flop
Seat 9: Alameda22 folded before Flop (didn't bet)



PokerStars Game #20097022939:  Hold'em No Limit ($0.10/$0.25) - 2008/09/02 16:20:09 ET
Table 'Rauma' 9-max Seat #2 is the button
Seat 1: ciDoR ($4.65 in chips) 
Seat 2: chessmanA1 ($13.70 in chips) 
Seat 3: murphy-mcben ($4.35 in chips) 
Seat 4: FlopkillaNo1 ($18.10 in chips) 
Seat 5: dukitup ($11.95 in chips) 
Seat 6: jst_the_nuts ($6.20 in chips) 
Seat 7: Crazy685 ($23.65 in chips) 
Seat 8: AsReyJota ($14.75 in chips) 
Seat 9: Alameda22 ($24.50 in chips) 
murphy-mcben: posts small blind $0.10
FlopkillaNo1: posts big blind $0.25
*** HOLE CARDS ***
Dealt to Alameda22 [4h As]
dukitup: calls $0.25
jst_the_nuts: folds 
Crazy685: folds 
AsReyJota: folds 
Alameda22: folds 
ciDoR: folds 
chessmanA1: folds 
murphy-mcben: calls $0.15
FlopkillaNo1: checks 
*** FLOP *** [3s Ac 5h]
murphy-mcben: checks 
FlopkillaNo1: checks 
dukitup: checks 
*** TURN *** [3s Ac 5h] [2c]
murphy-mcben: checks 
FlopkillaNo1: checks 
dukitup: checks 
*** RIVER *** [3s Ac 5h 2c] [Ts]
murphy-mcben: bets $0.75
FlopkillaNo1: folds 
dukitup: folds 
Uncalled bet ($0.75) returned to murphy-mcben
murphy-mcben collected $0.75 from pot
murphy-mcben: doesn't show hand 
*** SUMMARY ***
Total pot $0.75 | Rake $0 
Board [3s Ac 5h 2c Ts]
Seat 1: ciDoR folded before Flop (didn't bet)
Seat 2: chessmanA1 (button) folded before Flop (didn't bet)
Seat 3: murphy-mcben (small blind) collected ($0.75)
Seat 4: FlopkillaNo1 (big blind) folded on the River
Seat 5: dukitup folded on the River
Seat 6: jst_the_nuts folded before Flop (didn't bet)
Seat 7: Crazy685 folded before Flop (didn't bet)
Seat 8: AsReyJota folded before Flop (didn't bet)
Seat 9: Alameda22 folded before Flop (didn't bet)



PokerStars Game #20097066795:  Hold'em No Limit ($0.10/$0.25) - 2008/09/02 16:21:54 ET
Table 'Rauma' 9-max Seat #3 is the button
Seat 1: ciDoR ($4.65 in chips) 
Seat 2: chessmanA1 ($13.70 in chips) 
Seat 3: murphy-mcben ($4.85 in chips) 
Seat 4: FlopkillaNo1 ($17.85 in chips) 
Seat 5: dukitup ($11.70 in chips) 
Seat 6: jst_the_nuts ($6.20 in chips) 
Seat 7: Crazy685 ($23.65 in chips) 
Seat 8: AsReyJota ($14.75 in chips) 
Seat 9: Alameda22 ($24.50 in chips) 
FlopkillaNo1: posts small blind $0.10
dukitup: posts big blind $0.25
*** HOLE CARDS ***
Dealt to Alameda22 [Td Kc]
jst_the_nuts: folds 
Crazy685: folds 
AsReyJota: folds 
jst_the_nuts leaves the table
Alameda22: folds 
ciDoR: folds 
chessmanA1: folds 
murphy-mcben: folds 
FlopkillaNo1: calls $0.15
dukitup: checks 
*** FLOP *** [8c 9s 2h]
FlopkillaNo1: checks 
dukitup: bets $0.25
FlopkillaNo1: folds 
Uncalled bet ($0.25) returned to dukitup
dukitup collected $0.50 from pot
dukitup: doesn't show hand 
*** SUMMARY ***
Total pot $0.50 | Rake $0 
Board [8c 9s 2h]
Seat 1: ciDoR folded before Flop (didn't bet)
Seat 2: chessmanA1 folded before Flop (didn't bet)
Seat 3: murphy-mcben (button) folded before Flop (didn't bet)
Seat 4: FlopkillaNo1 (small blind) folded on the Flop
Seat 5: dukitup (big blind) collected ($0.50)
Seat 6: jst_the_nuts folded before Flop (didn't bet)
Seat 7: Crazy685 folded before Flop (didn't bet)
Seat 8: AsReyJota folded before Flop (didn't bet)
Seat 9: Alameda22 folded before Flop (didn't bet)



PokerStars Game #20097091599:  Hold'em No Limit ($0.10/$0.25) - 2008/09/02 16:22:54 ET
Table 'Rauma' 9-max Seat #4 is the button
Seat 1: ciDoR ($4.65 in chips) 
Seat 2: chessmanA1 ($13.70 in chips) 
Seat 3: murphy-mcben ($4.85 in chips) 
Seat 4: FlopkillaNo1 ($17.60 in chips) 
Seat 5: dukitup ($11.95 in chips) 
Seat 7: Crazy685 ($23.65 in chips) 
Seat 8: AsReyJota ($14.75 in chips) 
Seat 9: Alameda22 ($24.50 in chips) 
dukitup: posts small blind $0.10
Crazy685: posts big blind $0.25
*** HOLE CARDS ***
Dealt to Alameda22 [7d 4h]
AsReyJota: folds 
azmorice joins the table at seat #6 
Alameda22: folds 
ciDoR: folds 
chessmanA1: folds 
murphy-mcben: folds 
FlopkillaNo1: folds 
dukitup: calls $0.15
Crazy685: checks 
*** FLOP *** [4d Kd Tc]
dukitup: checks 
Crazy685: bets $0.50
dukitup: folds 
Uncalled bet ($0.50) returned to Crazy685
Crazy685 collected $0.50 from pot
Crazy685: doesn't show hand 
*** SUMMARY ***
Total pot $0.50 | Rake $0 
Board [4d Kd Tc]
Seat 1: ciDoR folded before Flop (didn't bet)
Seat 2: chessmanA1 folded before Flop (didn't bet)
Seat 3: murphy-mcben folded before Flop (didn't bet)
Seat 4: FlopkillaNo1 (button) folded before Flop (didn't bet)
Seat 5: dukitup (small blind) folded on the Flop
Seat 7: Crazy685 (big blind) collected ($0.50)
Seat 8: AsReyJota folded before Flop (didn't bet)
Seat 9: Alameda22 folded before Flop (didn't bet)



PokerStars Game #20097105294:  Hold'em No Limit ($0.10/$0.25) - 2008/09/02 16:23:27 ET
Table 'Rauma' 9-max Seat #5 is the button
Seat 1: ciDoR ($4.65 in chips) 
Seat 2: chessmanA1 ($13.70 in chips) 
Seat 3: murphy-mcben ($4.85 in chips) 
Seat 4: FlopkillaNo1 ($17.60 in chips) 
Seat 5: dukitup ($11.70 in chips) 
Seat 7: Crazy685 ($23.90 in chips) 
Seat 8: AsReyJota ($14.75 in chips) 
Seat 9: Alameda22 ($24.50 in chips) 
azmorice will be allowed to play after the button
Crazy685: posts small blind $0.10
AsReyJota: posts big blind $0.25
*** HOLE CARDS ***
Dealt to Alameda22 [Ts 5d]
Alameda22: folds 
ciDoR: folds 
chessmanA1: folds 
murphy-mcben: folds 
FlopkillaNo1: raises $0.50 to $0.75
dukitup: folds 
Crazy685: folds 
AsReyJota: folds 
Uncalled bet ($0.50) returned to FlopkillaNo1
FlopkillaNo1 collected $0.60 from pot
FlopkillaNo1: doesn't show hand 
*** SUMMARY ***
Total pot $0.60 | Rake $0 
Seat 1: ciDoR folded before Flop (didn't bet)
Seat 2: chessmanA1 folded before Flop (didn't bet)
Seat 3: murphy-mcben folded before Flop (didn't bet)
Seat 4: FlopkillaNo1 collected ($0.60)
Seat 5: dukitup (button) folded before Flop (didn't bet)
Seat 7: Crazy685 (small blind) folded before Flop
Seat 8: AsReyJota (big blind) folded before Flop
Seat 9: Alameda22 folded before Flop (didn't bet)



PokerStars Game #20097116990:  Hold'em No Limit ($0.10/$0.25) - 2008/09/02 16:23:56 ET
Table 'Rauma' 9-max Seat #7 is the button
Seat 1: ciDoR ($4.65 in chips) 
Seat 2: chessmanA1 ($13.70 in chips) 
Seat 3: murphy-mcben ($4.85 in chips) 
Seat 4: FlopkillaNo1 ($17.95 in chips) 
Seat 5: dukitup ($11.70 in chips) 
Seat 7: Crazy685 ($23.80 in chips) 
Seat 8: AsReyJota ($14.50 in chips) 
Seat 9: Alameda22 ($24.50 in chips) 
AsReyJota: posts small blind $0.10
Alameda22: posts big blind $0.25
azmorice: sits out 
*** HOLE CARDS ***
Dealt to Alameda22 [2s Ah]
ciDoR: folds 
chessmanA1: folds 
murphy-mcben: folds 
FlopkillaNo1: folds 
dukitup: folds 
Crazy685: raises $0.50 to $0.75
AsReyJota: calls $0.65
Alameda22: folds 
*** FLOP *** [Kc Qh Ad]
AsReyJota: checks 
Crazy685: bets $1
AsReyJota: folds 
Uncalled bet ($1) returned to Crazy685
Crazy685 collected $1.70 from pot
Crazy685: doesn't show hand 
*** SUMMARY ***
Total pot $1.75 | Rake $0.05 
Board [Kc Qh Ad]
Seat 1: ciDoR folded before Flop (didn't bet)
Seat 2: chessmanA1 folded before Flop (didn't bet)
Seat 3: murphy-mcben folded before Flop (didn't bet)
Seat 4: FlopkillaNo1 folded before Flop (didn't bet)
Seat 5: dukitup folded before Flop (didn't bet)
Seat 7: Crazy685 (button) collected ($1.70)
Seat 8: AsReyJota (small blind) folded on the Flop
Seat 9: Alameda22 (big blind) folded before Flop



PokerStars Game #20097145937:  Hold'em No Limit ($0.10/$0.25) - 2008/09/02 16:25:06 ET
Table 'Rauma' 9-max Seat #8 is the button
Seat 1: ciDoR ($4.65 in chips) 
Seat 2: chessmanA1 ($13.70 in chips) 
Seat 3: murphy-mcben ($4.85 in chips) 
Seat 4: FlopkillaNo1 ($17.95 in chips) 
Seat 5: dukitup ($11.70 in chips) 
Seat 7: Crazy685 ($24.75 in chips) 
Seat 8: AsReyJota ($13.75 in chips) 
Seat 9: Alameda22 ($24.25 in chips) 
Alameda22: posts small blind $0.10
ciDoR: posts big blind $0.25
azmorice: sits out 
*** HOLE CARDS ***
Dealt to Alameda22 [Qc Kh]
chessmanA1: folds 
murphy-mcben: folds 
FlopkillaNo1: folds 
dukitup: folds 
Crazy685: raises $0.75 to $1
AsReyJota: folds 
Alameda22: folds 
ciDoR: folds 
Uncalled bet ($0.75) returned to Crazy685
Crazy685 collected $0.60 from pot
Crazy685: doesn't show hand 
*** SUMMARY ***
Total pot $0.60 | Rake $0 
Seat 1: ciDoR (big blind) folded before Flop
Seat 2: chessmanA1 folded before Flop (didn't bet)
Seat 3: murphy-mcben folded before Flop (didn't bet)
Seat 4: FlopkillaNo1 folded before Flop (didn't bet)
Seat 5: dukitup folded before Flop (didn't bet)
Seat 7: Crazy685 collected ($0.60)
Seat 8: AsReyJota (button) folded before Flop (didn't bet)
Seat 9: Alameda22 (small blind) folded before Flop



PokerStars Game #20097160759:  Hold'em No Limit ($0.10/$0.25) - 2008/09/02 16:25:42 ET
Table 'Rauma' 9-max Seat #9 is the button
Seat 1: ciDoR ($4.40 in chips) 
Seat 2: chessmanA1 ($13.70 in chips) 
Seat 3: murphy-mcben ($4.85 in chips) 
Seat 4: FlopkillaNo1 ($17.95 in chips) 
Seat 5: dukitup ($11.70 in chips) 
Seat 7: Crazy685 ($25.10 in chips) 
Seat 8: AsReyJota ($13.75 in chips) 
Seat 9: Alameda22 ($24.15 in chips) 
ciDoR: posts small blind $0.10
chessmanA1: posts big blind $0.25
azmorice: sits out 
*** HOLE CARDS ***
Dealt to Alameda22 [2d Tc]
murphy-mcben: folds 
FlopkillaNo1: folds 
dukitup: folds 
Crazy685: folds 
AsReyJota: folds 
Alameda22: folds 
ciDoR: raises $0.75 to $1
chessmanA1: folds 
Uncalled bet ($0.75) returned to ciDoR
ciDoR collected $0.50 from pot
*** SUMMARY ***
Total pot $0.50 | Rake $0 
Seat 1: ciDoR (small blind) collected ($0.50)
Seat 2: chessmanA1 (big blind) folded before Flop
Seat 3: murphy-mcben folded before Flop (didn't bet)
Seat 4: FlopkillaNo1 folded before Flop (didn't bet)
Seat 5: dukitup folded before Flop (didn't bet)
Seat 7: Crazy685 folded before Flop (didn't bet)
Seat 8: AsReyJota folded before Flop (didn't bet)
Seat 9: Alameda22 (button) folded before Flop (didn't bet)



PokerStars Game #20097176922:  Hold'em No Limit ($0.10/$0.25) - 2008/09/02 16:26:21 ET
Table 'Rauma' 9-max Seat #1 is the button
Seat 1: ciDoR ($4.65 in chips) 
Seat 2: chessmanA1 ($13.45 in chips) 
Seat 3: murphy-mcben ($4.85 in chips) 
Seat 4: FlopkillaNo1 ($17.95 in chips) 
Seat 5: dukitup ($11.70 in chips) 
Seat 7: Crazy685 ($25.10 in chips) 
Seat 8: AsReyJota ($13.75 in chips) 
Seat 9: Alameda22 ($24.15 in chips) 
chessmanA1: posts small blind $0.10
murphy-mcben: posts big blind $0.25
azmorice: sits out 
*** HOLE CARDS ***
Dealt to Alameda22 [2c 9d]
FlopkillaNo1: calls $0.25
dukitup: folds 
Crazy685: folds 
AsReyJota: folds 
Alameda22: folds 
ciDoR: folds 
chessmanA1: folds 
murphy-mcben: checks 
*** FLOP *** [2s Ac Qh]
murphy-mcben: bets $0.50
FlopkillaNo1: folds 
Uncalled bet ($0.50) returned to murphy-mcben
murphy-mcben collected $0.60 from pot
murphy-mcben: doesn't show hand 
*** SUMMARY ***
Total pot $0.60 | Rake $0 
Board [2s Ac Qh]
Seat 1: ciDoR (button) folded before Flop (didn't bet)
Seat 2: chessmanA1 (small blind) folded before Flop
Seat 3: murphy-mcben (big blind) collected ($0.60)
Seat 4: FlopkillaNo1 folded on the Flop
Seat 5: dukitup folded before Flop (didn't bet)
Seat 7: Crazy685 folded before Flop (didn't bet)
Seat 8: AsReyJota folded before Flop (didn't bet)
Seat 9: Alameda22 folded before Flop (didn't bet)



PokerStars Game #20097210403:  Hold'em No Limit ($0.10/$0.25) - 2008/09/02 16:27:42 ET
Table 'Rauma' 9-max Seat #2 is the button
Seat 1: ciDoR ($4.65 in chips) 
Seat 2: chessmanA1 ($13.35 in chips) 
Seat 3: murphy-mcben ($5.20 in chips) 
Seat 4: FlopkillaNo1 ($17.70 in chips) 
Seat 5: dukitup ($11.70 in chips) 
Seat 7: Crazy685 ($25.10 in chips) 
Seat 8: AsReyJota ($13.75 in chips) 
Seat 9: Alameda22 ($24.15 in chips) 
murphy-mcben: posts small blind $0.10
FlopkillaNo1: posts big blind $0.25
azmorice: sits out 
*** HOLE CARDS ***
Dealt to Alameda22 [Ah 9d]
dukitup: folds 
Crazy685: folds 
AsReyJota: folds 
Alameda22: folds 
ciDoR: raises $0.75 to $1
chessmanA1: folds 
murphy-mcben: folds 
FlopkillaNo1: calls $0.75
*** FLOP *** [Kh Ad 2s]
FlopkillaNo1: checks 
ciDoR: bets $1.25
FlopkillaNo1: raises $3 to $4.25
ciDoR: folds 
Uncalled bet ($3) returned to FlopkillaNo1
FlopkillaNo1 collected $4.40 from pot
FlopkillaNo1: doesn't show hand 
*** SUMMARY ***
Total pot $4.60 | Rake $0.20 
Board [Kh Ad 2s]
Seat 1: ciDoR folded on the Flop
Seat 2: chessmanA1 (button) folded before Flop (didn't bet)
Seat 3: murphy-mcben (small blind) folded before Flop
Seat 4: FlopkillaNo1 (big blind) collected ($4.40)
Seat 5: dukitup folded before Flop (didn't bet)
Seat 7: Crazy685 folded before Flop (didn't bet)
Seat 8: AsReyJota folded before Flop (didn't bet)
Seat 9: Alameda22 folded before Flop (didn't bet)



PokerStars Game #20097242389:  Hold'em No Limit ($0.10/$0.25) - 2008/09/02 16:29:00 ET
Table 'Rauma' 9-max Seat #3 is the button
Seat 1: ciDoR ($2.40 in chips) 
Seat 2: chessmanA1 ($13.35 in chips) 
Seat 3: murphy-mcben ($5.10 in chips) 
Seat 4: FlopkillaNo1 ($19.85 in chips) 
Seat 5: dukitup ($11.70 in chips) 
Seat 7: Crazy685 ($25.10 in chips) 
Seat 8: AsReyJota ($13.75 in chips) 
Seat 9: Alameda22 ($24.15 in chips) 
FlopkillaNo1: posts small blind $0.10
dukitup: posts big blind $0.25
azmorice: sits out 
*** HOLE CARDS ***
Dealt to Alameda22 [2c 7c]
Crazy685: folds 
AsReyJota: folds 
Alameda22: folds 
ciDoR: folds 
ciDoR leaves the table
chessmanA1: folds 
murphy-mcben has timed out
murphy-mcben: folds 
murphy-mcben is sitting out
murphy-mcben has returned
FlopkillaNo1: raises $0.75 to $1
dukitup: folds 
Uncalled bet ($0.75) returned to FlopkillaNo1
FlopkillaNo1 collected $0.50 from pot
*** SUMMARY ***
Total pot $0.50 | Rake $0 
Seat 1: ciDoR folded before Flop (didn't bet)
Seat 2: chessmanA1 folded before Flop (didn't bet)
Seat 3: murphy-mcben (button) folded before Flop (didn't bet)
Seat 4: FlopkillaNo1 (small blind) collected ($0.50)
Seat 5: dukitup (big blind) folded before Flop
Seat 7: Crazy685 folded before Flop (didn't bet)
Seat 8: AsReyJota folded before Flop (didn't bet)
Seat 9: Alameda22 folded before Flop (didn't bet)



PokerStars Game #20097283798:  Hold'em No Limit ($0.10/$0.25) - 2008/09/02 16:30:39 ET
Table 'Rauma' 9-max Seat #4 is the button
Seat 2: chessmanA1 ($13.35 in chips) 
Seat 3: murphy-mcben ($5.10 in chips) 
Seat 4: FlopkillaNo1 ($20.10 in chips) 
Seat 5: dukitup ($11.45 in chips) 
Seat 6: azmorice ($15 in chips) 
Seat 7: Crazy685 ($25.10 in chips) 
Seat 8: AsReyJota ($13.75 in chips) 
Seat 9: Alameda22 ($24.15 in chips) 
dukitup: posts small blind $0.10
azmorice: posts big blind $0.25
*** HOLE CARDS ***
Dealt to Alameda22 [Ad Qh]
Crazy685 said, "?"
Crazy685: folds 
AsReyJota: folds 
Crazy685 leaves the table
Alameda22: raises $0.75 to $1
chessmanA1: folds 
murphy-mcben: folds 
FlopkillaNo1: folds 
dukitup: folds 
azmorice: folds 
Uncalled bet ($0.75) returned to Alameda22
Alameda22 collected $0.60 from pot
Alameda22: doesn't show hand 
*** SUMMARY ***
Total pot $0.60 | Rake $0 
Seat 2: chessmanA1 folded before Flop (didn't bet)
Seat 3: murphy-mcben folded before Flop (didn't bet)
Seat 4: FlopkillaNo1 (button) folded before Flop (didn't bet)
Seat 5: dukitup (small blind) folded before Flop
Seat 6: azmorice (big blind) folded before Flop
Seat 7: Crazy685 folded before Flop (didn't bet)
Seat 8: AsReyJota folded before Flop (didn't bet)
Seat 9: Alameda22 collected ($0.60)



PokerStars Game #20097317873:  Hold'em No Limit ($0.10/$0.25) - 2008/09/02 16:32:03 ET
Table 'Rauma' 9-max Seat #5 is the button
Seat 2: chessmanA1 ($13.35 in chips) 
Seat 3: murphy-mcben ($5.10 in chips) 
Seat 4: FlopkillaNo1 ($20.10 in chips) 
Seat 5: dukitup ($11.35 in chips) 
Seat 6: azmorice ($14.75 in chips) 
Seat 8: AsReyJota ($13.75 in chips) 
Seat 9: Alameda22 ($24.50 in chips) 
azmorice: posts small blind $0.10
AsReyJota: posts big blind $0.25
*** HOLE CARDS ***
Dealt to Alameda22 [Qs Ks]
Alameda22: folds 
chessmanA1: folds 
murphy-mcben: raises $0.50 to $0.75
FlopkillaNo1: folds 
dukitup: folds 
azmorice: folds 
AsReyJota: raises $1 to $1.75
murphy-mcben: calls $1
*** FLOP *** [Js 7h Qd]
AsReyJota: bets $3.50
murphy-mcben: calls $3.35 and is all-in
Uncalled bet ($0.15) returned to AsReyJota
*** TURN *** [Js 7h Qd] [Ah]
*** RIVER *** [Js 7h Qd Ah] [Kh]
*** SHOW DOWN ***
AsReyJota: shows [As Ts] (a straight, Ten to Ace)
murphy-mcben: shows [Th Jh] (a flush, Ace high)
murphy-mcben collected $9.80 from pot
*** SUMMARY ***
Total pot $10.30 | Rake $0.50 
Board [Js 7h Qd Ah Kh]
Seat 2: chessmanA1 folded before Flop (didn't bet)
Seat 3: murphy-mcben showed [Th Jh] and won ($9.80) with a flush, Ace high
Seat 4: FlopkillaNo1 folded before Flop (didn't bet)
Seat 5: dukitup (button) folded before Flop (didn't bet)
Seat 6: azmorice (small blind) folded before Flop
Seat 8: AsReyJota (big blind) showed [As Ts] and lost with a straight, Ten to Ace
Seat 9: Alameda22 folded before Flop (didn't bet)



PokerStars Game #20097336799:  Hold'em No Limit ($0.10/$0.25) - 2008/09/02 16:32:48 ET
Table 'Rauma' 9-max Seat #6 is the button
Seat 2: chessmanA1 ($13.35 in chips) 
Seat 3: murphy-mcben ($9.80 in chips) 
Seat 4: FlopkillaNo1 ($20.10 in chips) 
Seat 5: dukitup ($11.35 in chips) 
Seat 6: azmorice ($14.65 in chips) 
Seat 8: AsReyJota ($8.65 in chips) 
Seat 9: Alameda22 ($24.50 in chips) 
AsReyJota: posts small blind $0.10
Alameda22: posts big blind $0.25
*** HOLE CARDS ***
Dealt to Alameda22 [6c 8h]
chessmanA1: folds 
murphy-mcben: folds 
FlopkillaNo1: calls $0.25
dukitup: raises $0.75 to $1
azmorice: folds 
AsReyJota: folds 
Alameda22: folds 
FlopkillaNo1: calls $0.75
*** FLOP *** [Jc 9s 2s]
FlopkillaNo1: checks 
dukitup: bets $2
FlopkillaNo1: folds 
Uncalled bet ($2) returned to dukitup
dukitup collected $2.25 from pot
dukitup: doesn't show hand 
*** SUMMARY ***
Total pot $2.35 | Rake $0.10 
Board [Jc 9s 2s]
Seat 2: chessmanA1 folded before Flop (didn't bet)
Seat 3: murphy-mcben folded before Flop (didn't bet)
Seat 4: FlopkillaNo1 folded on the Flop
Seat 5: dukitup collected ($2.25)
Seat 6: azmorice (button) folded before Flop (didn't bet)
Seat 8: AsReyJota (small blind) folded before Flop
Seat 9: Alameda22 (big blind) folded before Flop



PokerStars Game #20097359977:  Hold'em No Limit ($0.10/$0.25) - 2008/09/02 16:33:44 ET
Table 'Rauma' 9-max Seat #8 is the button
Seat 3: murphy-mcben ($9.80 in chips) 
Seat 4: FlopkillaNo1 ($19.10 in chips) 
Seat 5: dukitup ($12.60 in chips) 
Seat 6: azmorice ($14.65 in chips) 
Seat 8: AsReyJota ($8.55 in chips) 
Seat 9: Alameda22 ($24.25 in chips) 
Alameda22: posts small blind $0.10
chessmanA1: is sitting out 
murphy-mcben: posts big blind $0.25
*** HOLE CARDS ***
Dealt to Alameda22 [As 3c]
chessmanA1 leaves the table
FlopkillaNo1: folds 
dukitup: folds 
azmorice: folds 
AsReyJota: raises $0.75 to $1
Alameda22: folds 
murphy-mcben: folds 
Uncalled bet ($0.75) returned to AsReyJota
AsReyJota collected $0.60 from pot
AsReyJota: doesn't show hand 
*** SUMMARY ***
Total pot $0.60 | Rake $0 
Seat 3: murphy-mcben (big blind) folded before Flop
Seat 4: FlopkillaNo1 folded before Flop (didn't bet)
Seat 5: dukitup folded before Flop (didn't bet)
Seat 6: azmorice folded before Flop (didn't bet)
Seat 8: AsReyJota (button) collected ($0.60)
Seat 9: Alameda22 (small blind) folded before Flop



PokerStars Game #20097380479:  Hold'em No Limit ($0.10/$0.25) - 2008/09/02 16:34:35 ET
Table 'Rauma' 9-max Seat #9 is the button
Seat 3: murphy-mcben ($9.55 in chips) 
Seat 6: azmorice ($14.65 in chips) 
Seat 8: AsReyJota ($8.90 in chips) 
Seat 9: Alameda22 ($24.15 in chips) 
murphy-mcben: posts small blind $0.10
FlopkillaNo1: is sitting out 
FlopkillaNo1 leaves the table
dukitup: is sitting out 
azmorice: posts big blind $0.25
*** HOLE CARDS ***
Dealt to Alameda22 [8s Tc]
dukitup leaves the table
AsReyJota: folds 
AsReyJota leaves the table
Alameda22: folds 
murphy-mcben: folds 
Uncalled bet ($0.15) returned to azmorice
azmorice collected $0.20 from pot
azmorice: doesn't show hand 
*** SUMMARY ***
Total pot $0.20 | Rake $0 
Seat 3: murphy-mcben (small blind) folded before Flop
Seat 6: azmorice (big blind) collected ($0.20)
Seat 8: AsReyJota folded before Flop (didn't bet)
Seat 9: Alameda22 (button) folded before Flop (didn't bet)



PokerStars Game #20097393321:  Hold'em No Limit ($0.10/$0.25) - 2008/09/02 16:35:06 ET
Table 'Rauma' 9-max Seat #3 is the button
Seat 3: murphy-mcben ($9.45 in chips) 
Seat 6: azmorice ($14.75 in chips) 
Seat 9: Alameda22 ($24.15 in chips) 
azmorice: posts small blind $0.10
Alameda22: posts big blind $0.25
*** HOLE CARDS ***
Dealt to Alameda22 [Js Qs]
murphy-mcben: folds 
azmorice: folds 
Uncalled bet ($0.15) returned to Alameda22
murphy-mcben leaves the table
Alameda22 collected $0.20 from pot
Alameda22: doesn't show hand 
*** SUMMARY ***
Total pot $0.20 | Rake $0 
Seat 3: murphy-mcben (button) folded before Flop (didn't bet)
Seat 6: azmorice (small blind) folded before Flop
Seat 9: Alameda22 (big blind) collected ($0.20)



