PokerStars Game #19897698384:  Hold'em No Limit ($0.10/$0.25) - 2008/08/25 - 19:30:05 (ET)
Table 'Pompeja II' 9-max Seat #8 is the button
Seat 1: Watchmaker42 ($20.25 in chips) 
Seat 2: Alameda22 ($25 in chips) 
Seat 3: pickpocketb ($52.35 in chips) 
Seat 4: Kranhelf ($9.20 in chips) 
Seat 5: Sep79 ($25.20 in chips) 
Seat 6: Ross823 ($11.65 in chips) 
Seat 8: chch10 ($24.65 in chips) 
147Gorilla will be allowed to play after the button
Watchmaker42: posts small blind $0.10
Alameda22: posts big blind $0.25
*** HOLE CARDS ***
Dealt to Alameda22 [6h Ts]
Dennisuitehv joins the table at seat #7 
pickpocketb: folds 
Kranhelf: folds 
Sep79: folds 
Ross823: folds 
chch10: raises $0.75 to $1
Watchmaker42: folds 
Alameda22: folds 
Uncalled bet ($0.75) returned to chch10
chch10 collected $0.60 from pot
chch10: doesn't show hand 
*** SUMMARY ***
Total pot $0.60 | Rake $0 
Seat 1: Watchmaker42 (small blind) folded before Flop
Seat 2: Alameda22 (big blind) folded before Flop
Seat 3: pickpocketb folded before Flop (didn't bet)
Seat 4: Kranhelf folded before Flop (didn't bet)
Seat 5: Sep79 folded before Flop (didn't bet)
Seat 6: Ross823 folded before Flop (didn't bet)
Seat 8: chch10 (button) collected ($0.60)



PokerStars Game #19897722333:  Hold'em No Limit ($0.10/$0.25) - 2008/08/25 - 19:31:09 (ET)
Table 'Pompeja II' 9-max Seat #1 is the button
Seat 1: Watchmaker42 ($20.15 in chips) 
Seat 2: Alameda22 ($24.75 in chips) 
Seat 3: pickpocketb ($52.35 in chips) 
Seat 4: Kranhelf ($9.20 in chips) 
Seat 5: Sep79 ($25.20 in chips) 
Seat 6: Ross823 ($11.65 in chips) 
Seat 7: Dennisuitehv ($25 in chips) 
Seat 8: chch10 ($25 in chips) 
Alameda22: posts small blind $0.10
pickpocketb: posts big blind $0.25
Dennisuitehv: posts big blind $0.25
147Gorilla: sits out 
*** HOLE CARDS ***
Dealt to Alameda22 [5h As]
Kranhelf: folds 
Sep79: folds 
Ross823: calls $0.25
Kranhelf leaves the table
Dennisuitehv: checks 
chch10: folds 
Tigak joins the table at seat #4 
Watchmaker42: raises $1 to $1.25
Alameda22: folds 
pickpocketb: folds 
Ross823: folds 
Dennisuitehv: folds 
Uncalled bet ($1) returned to Watchmaker42
Watchmaker42 collected $1.10 from pot
Watchmaker42: doesn't show hand 
*** SUMMARY ***
Total pot $1.10 | Rake $0 
Seat 1: Watchmaker42 (button) collected ($1.10)
Seat 2: Alameda22 (small blind) folded before Flop
Seat 3: pickpocketb (big blind) folded before Flop
Seat 4: Kranhelf folded before Flop (didn't bet)
Seat 5: Sep79 folded before Flop (didn't bet)
Seat 6: Ross823 folded before Flop
Seat 7: Dennisuitehv folded before Flop
Seat 8: chch10 folded before Flop (didn't bet)



PokerStars Game #19897736192:  Hold'em No Limit ($0.10/$0.25) - 2008/08/25 - 19:31:43 (ET)
Table 'Pompeja II' 9-max Seat #2 is the button
Seat 1: Watchmaker42 ($25 in chips) 
Seat 2: Alameda22 ($24.65 in chips) 
Seat 3: pickpocketb ($52.10 in chips) 
Seat 4: Tigak ($25 in chips) 
Seat 5: Sep79 ($25.20 in chips) 
Seat 6: Ross823 ($11.40 in chips) 
Seat 7: Dennisuitehv ($24.75 in chips) 
Seat 8: chch10 ($25 in chips) 
pickpocketb: posts small blind $0.10
Tigak: posts big blind $0.25
147Gorilla: sits out 
*** HOLE CARDS ***
Dealt to Alameda22 [9c Ad]
Sep79: folds 
Ross823: calls $0.25
Dennisuitehv: folds 
chch10: folds 
Watchmaker42: folds 
Alameda22: folds 
pickpocketb: calls $0.15
Tigak: checks 
*** FLOP *** [3c Qh Td]
pickpocketb: checks 
Tigak: checks 
Ross823: checks 
*** TURN *** [3c Qh Td] [As]
pickpocketb: checks 
Tigak: checks 
Ross823: checks 
*** RIVER *** [3c Qh Td As] [3d]
pickpocketb: checks 
Tigak: checks 
Ross823: bets $1
pickpocketb: folds 
Tigak: folds 
Uncalled bet ($1) returned to Ross823
Ross823 collected $0.75 from pot
Ross823: doesn't show hand 
*** SUMMARY ***
Total pot $0.75 | Rake $0 
Board [3c Qh Td As 3d]
Seat 1: Watchmaker42 folded before Flop (didn't bet)
Seat 2: Alameda22 (button) folded before Flop (didn't bet)
Seat 3: pickpocketb (small blind) folded on the River
Seat 4: Tigak (big blind) folded on the River
Seat 5: Sep79 folded before Flop (didn't bet)
Seat 6: Ross823 collected ($0.75)
Seat 7: Dennisuitehv folded before Flop (didn't bet)
Seat 8: chch10 folded before Flop (didn't bet)



PokerStars Game #19897760342:  Hold'em No Limit ($0.10/$0.25) - 2008/08/25 - 19:32:47 (ET)
Table 'Pompeja II' 9-max Seat #3 is the button
Seat 1: Watchmaker42 ($25 in chips) 
Seat 2: Alameda22 ($24.65 in chips) 
Seat 3: pickpocketb ($51.85 in chips) 
Seat 4: Tigak ($24.75 in chips) 
Seat 5: Sep79 ($25.20 in chips) 
Seat 6: Ross823 ($11.90 in chips) 
Seat 7: Dennisuitehv ($24.75 in chips) 
Seat 8: chch10 ($25 in chips) 
Tigak: posts small blind $0.10
Sep79: posts big blind $0.25
147Gorilla: sits out 
*** HOLE CARDS ***
Dealt to Alameda22 [5c Td]
Ross823: calls $0.25
Dennisuitehv: calls $0.25
chch10: folds 
Watchmaker42: folds 
Alameda22: folds 
pickpocketb: folds 
Tigak: folds 
Sep79: checks 
*** FLOP *** [Jc Qh 4s]
Sep79: checks 
Ross823: checks 
Dennisuitehv: checks 
*** TURN *** [Jc Qh 4s] [Tc]
Sep79: checks 
Ross823: checks 
Dennisuitehv: checks 
*** RIVER *** [Jc Qh 4s Tc] [3c]
Sep79: checks 
Ross823: checks 
Dennisuitehv: checks 
*** SHOW DOWN ***
Sep79: shows [3s Ts] (two pair, Tens and Threes)
Ross823: mucks hand 
Dennisuitehv: mucks hand 
Sep79 collected $0.85 from pot
*** SUMMARY ***
Total pot $0.85 | Rake $0 
Board [Jc Qh 4s Tc 3c]
Seat 1: Watchmaker42 folded before Flop (didn't bet)
Seat 2: Alameda22 folded before Flop (didn't bet)
Seat 3: pickpocketb (button) folded before Flop (didn't bet)
Seat 4: Tigak (small blind) folded before Flop
Seat 5: Sep79 (big blind) showed [3s Ts] and won ($0.85) with two pair, Tens and Threes
Seat 6: Ross823 mucked [4d 6d]
Seat 7: Dennisuitehv mucked [2h 2s]
Seat 8: chch10 folded before Flop (didn't bet)



PokerStars Game #19897788540:  Hold'em No Limit ($0.10/$0.25) - 2008/08/25 - 19:34:00 (ET)
Table 'Pompeja II' 9-max Seat #4 is the button
Seat 1: Watchmaker42 ($25 in chips) 
Seat 2: Alameda22 ($24.65 in chips) 
Seat 3: pickpocketb ($51.85 in chips) 
Seat 4: Tigak ($24.65 in chips) 
Seat 5: Sep79 ($25.80 in chips) 
Seat 6: Ross823 ($11.65 in chips) 
Seat 7: Dennisuitehv ($24.50 in chips) 
Seat 8: chch10 ($25 in chips) 
Sep79: posts small blind $0.10
Ross823: posts big blind $0.25
147Gorilla: sits out 
*** HOLE CARDS ***
Dealt to Alameda22 [Ac Qd]
Dennisuitehv: folds 
chch10: raises $0.75 to $1
Watchmaker42: folds 
Alameda22: calls $1
pickpocketb: folds 
Tigak: folds 
Sep79: folds 
Ross823: calls $0.75
*** FLOP *** [Jc Js 5c]
Ross823: checks 
chch10: bets $2
Alameda22: folds 
Ross823: calls $2
*** TURN *** [Jc Js 5c] [Tc]
Ross823: checks 
chch10: bets $3.75
Ross823: calls $3.75
*** RIVER *** [Jc Js 5c Tc] [6d]
Ross823: bets $4.90 and is all-in
chch10: calls $4.90
*** SHOW DOWN ***
Ross823: shows [Jh 5s] (a full house, Jacks full of Fives)
chch10: mucks hand 
Ross823 collected $23.25 from pot
*** SUMMARY ***
Total pot $24.40 | Rake $1.15 
Board [Jc Js 5c Tc 6d]
Seat 1: Watchmaker42 folded before Flop (didn't bet)
Seat 2: Alameda22 folded on the Flop
Seat 3: pickpocketb folded before Flop (didn't bet)
Seat 4: Tigak (button) folded before Flop (didn't bet)
Seat 5: Sep79 (small blind) folded before Flop
Seat 6: Ross823 (big blind) showed [Jh 5s] and won ($23.25) with a full house, Jacks full of Fives
Seat 7: Dennisuitehv folded before Flop (didn't bet)
Seat 8: chch10 mucked [Td Ts]



PokerStars Game #19897820241:  Hold'em No Limit ($0.10/$0.25) - 2008/08/25 - 19:35:21 (ET)
Table 'Pompeja II' 9-max Seat #5 is the button
Seat 1: Watchmaker42 ($25 in chips) 
Seat 2: Alameda22 ($23.65 in chips) 
Seat 3: pickpocketb ($51.85 in chips) 
Seat 4: Tigak ($24.65 in chips) 
Seat 5: Sep79 ($25.70 in chips) 
Seat 6: Ross823 ($23.25 in chips) 
Seat 7: Dennisuitehv ($24.50 in chips) 
Seat 8: chch10 ($13.35 in chips) 
Ross823: posts small blind $0.10
Dennisuitehv: posts big blind $0.25
147Gorilla: sits out 
*** HOLE CARDS ***
Dealt to Alameda22 [4d Ks]
chch10: folds 
Watchmaker42: raises $0.50 to $0.75
Alameda22: folds 
pickpocketb: folds 
Tigak: calls $0.75
Sep79: folds 
Ross823: folds 
Ross823 is sitting out
Dennisuitehv is disconnected 
Ross823 has returned
Dennisuitehv is connected 
Dennisuitehv: folds 
*** FLOP *** [Tc 3h 6h]
Watchmaker42: bets $1.25
Tigak: calls $1.25
*** TURN *** [Tc 3h 6h] [Th]
Watchmaker42: bets $3.50
Tigak: calls $3.50
*** RIVER *** [Tc 3h 6h Th] [Ad]
Dennisuitehv is disconnected 
Watchmaker42: bets $7
Tigak: calls $7
Dennisuitehv is connected 
*** SHOW DOWN ***
Watchmaker42: shows [9h Qh] (a flush, Queen high)
Tigak: mucks hand 
Watchmaker42 collected $24.15 from pot
*** SUMMARY ***
Total pot $25.35 | Rake $1.20 
Board [Tc 3h 6h Th Ad]
Seat 1: Watchmaker42 showed [9h Qh] and won ($24.15) with a flush, Queen high
Seat 2: Alameda22 folded before Flop (didn't bet)
Seat 3: pickpocketb folded before Flop (didn't bet)
Seat 4: Tigak mucked [Qs Ah]
Seat 5: Sep79 (button) folded before Flop (didn't bet)
Seat 6: Ross823 (small blind) folded before Flop
Seat 7: Dennisuitehv (big blind) folded before Flop
Seat 8: chch10 folded before Flop (didn't bet)



PokerStars Game #19897872998:  Hold'em No Limit ($0.10/$0.25) - 2008/08/25 - 19:37:38 (ET)
Table 'Pompeja II' 9-max Seat #6 is the button
Seat 1: Watchmaker42 ($36.65 in chips) 
Seat 2: Alameda22 ($23.65 in chips) 
Seat 3: pickpocketb ($51.85 in chips) 
Seat 4: Tigak ($12.15 in chips) 
Seat 5: Sep79 ($25.70 in chips) 
Seat 6: Ross823 ($23.15 in chips) 
Seat 7: Dennisuitehv ($24.25 in chips) 
Seat 8: chch10 ($23.35 in chips) 
Dennisuitehv: posts small blind $0.10
chch10: posts big blind $0.25
147Gorilla: sits out 
*** HOLE CARDS ***
Dealt to Alameda22 [7h Js]
Watchmaker42: folds 
Alameda22: folds 
pickpocketb: raises $0.50 to $0.75
Tigak: folds 
Sep79: folds 
Ross823: calls $0.75
Dennisuitehv: folds 
chch10: calls $0.50
*** FLOP *** [4d 8d 2h]
chch10: checks 
pickpocketb: checks 
Ross823: checks 
*** TURN *** [4d 8d 2h] [5s]
chch10: checks 
pickpocketb: bets $1.25
Ross823: calls $1.25
chch10: folds 
*** RIVER *** [4d 8d 2h 5s] [7s]
pickpocketb: bets $3
Ross823: calls $3
*** SHOW DOWN ***
pickpocketb: shows [6s 6d] (a straight, Four to Eight)
Ross823: shows [Ah 6c] (a straight, Four to Eight)
pickpocketb collected $5.20 from pot
Ross823 collected $5.15 from pot
*** SUMMARY ***
Total pot $10.85 | Rake $0.50 
Board [4d 8d 2h 5s 7s]
Seat 1: Watchmaker42 folded before Flop (didn't bet)
Seat 2: Alameda22 folded before Flop (didn't bet)
Seat 3: pickpocketb showed [6s 6d] and won ($5.20) with a straight, Four to Eight
Seat 4: Tigak folded before Flop (didn't bet)
Seat 5: Sep79 folded before Flop (didn't bet)
Seat 6: Ross823 (button) showed [Ah 6c] and won ($5.15) with a straight, Four to Eight
Seat 7: Dennisuitehv (small blind) folded before Flop
Seat 8: chch10 (big blind) folded on the Turn



PokerStars Game #19897911068:  Hold'em No Limit ($0.10/$0.25) - 2008/08/25 - 19:39:17 (ET)
Table 'Pompeja II' 9-max Seat #7 is the button
Seat 1: Watchmaker42 ($36.65 in chips) 
Seat 2: Alameda22 ($23.65 in chips) 
Seat 3: pickpocketb ($52.05 in chips) 
Seat 4: Tigak ($12.15 in chips) 
Seat 5: Sep79 ($25.70 in chips) 
Seat 6: Ross823 ($23.30 in chips) 
Seat 7: Dennisuitehv ($24.15 in chips) 
Seat 8: chch10 ($22.60 in chips) 
Seat 9: 147Gorilla ($25 in chips) 
chch10: posts small blind $0.10
147Gorilla: posts big blind $0.25
*** HOLE CARDS ***
Dealt to Alameda22 [6h 8h]
Watchmaker42: folds 
Alameda22: folds 
pickpocketb: folds 
Tigak: folds 
Sep79: folds 
Ross823: calls $0.25
Dennisuitehv: folds 
chch10: folds 
147Gorilla: checks 
*** FLOP *** [Ac 2s 9c]
147Gorilla: checks 
Ross823: checks 
*** TURN *** [Ac 2s 9c] [2c]
147Gorilla: checks 
Ross823: checks 
*** RIVER *** [Ac 2s 9c 2c] [Jh]
147Gorilla: checks 
Ross823: checks 
*** SHOW DOWN ***
147Gorilla: shows [4h 5c] (a pair of Deuces)
Ross823: shows [Qc 8d] (a pair of Deuces - Ace+Queen kicker)
Ross823 collected $0.60 from pot
*** SUMMARY ***
Total pot $0.60 | Rake $0 
Board [Ac 2s 9c 2c Jh]
Seat 1: Watchmaker42 folded before Flop (didn't bet)
Seat 2: Alameda22 folded before Flop (didn't bet)
Seat 3: pickpocketb folded before Flop (didn't bet)
Seat 4: Tigak folded before Flop (didn't bet)
Seat 5: Sep79 folded before Flop (didn't bet)
Seat 6: Ross823 showed [Qc 8d] and won ($0.60) with a pair of Deuces
Seat 7: Dennisuitehv (button) folded before Flop (didn't bet)
Seat 8: chch10 (small blind) folded before Flop
Seat 9: 147Gorilla (big blind) showed [4h 5c] and lost with a pair of Deuces



PokerStars Game #19897931643:  Hold'em No Limit ($0.10/$0.25) - 2008/08/25 - 19:40:10 (ET)
Table 'Pompeja II' 9-max Seat #8 is the button
Seat 1: Watchmaker42 ($36.65 in chips) 
Seat 2: Alameda22 ($23.65 in chips) 
Seat 3: pickpocketb ($52.05 in chips) 
Seat 4: Tigak ($12.15 in chips) 
Seat 5: Sep79 ($25.70 in chips) 
Seat 6: Ross823 ($23.65 in chips) 
Seat 7: Dennisuitehv ($24.15 in chips) 
Seat 8: chch10 ($22.50 in chips) 
Seat 9: 147Gorilla ($25 in chips) 
147Gorilla: posts small blind $0.10
Watchmaker42: posts big blind $0.25
*** HOLE CARDS ***
Dealt to Alameda22 [4d 8c]
Alameda22: folds 
pickpocketb: folds 
Tigak: folds 
Sep79: folds 
Ross823: calls $0.25
Dennisuitehv: folds 
chch10: calls $0.25
147Gorilla: folds 
Watchmaker42: checks 
*** FLOP *** [9h 4s Kc]
Watchmaker42: checks 
Ross823: checks 
chch10: checks 
*** TURN *** [9h 4s Kc] [9s]
Watchmaker42: checks 
Ross823: checks 
chch10: checks 
*** RIVER *** [9h 4s Kc 9s] [6h]
Watchmaker42: checks 
Ross823: bets $0.50
chch10: folds 
Watchmaker42: folds 
Uncalled bet ($0.50) returned to Ross823
Ross823 collected $0.85 from pot
Ross823: doesn't show hand 
*** SUMMARY ***
Total pot $0.85 | Rake $0 
Board [9h 4s Kc 9s 6h]
Seat 1: Watchmaker42 (big blind) folded on the River
Seat 2: Alameda22 folded before Flop (didn't bet)
Seat 3: pickpocketb folded before Flop (didn't bet)
Seat 4: Tigak folded before Flop (didn't bet)
Seat 5: Sep79 folded before Flop (didn't bet)
Seat 6: Ross823 collected ($0.85)
Seat 7: Dennisuitehv folded before Flop (didn't bet)
Seat 8: chch10 (button) folded on the River
Seat 9: 147Gorilla (small blind) folded before Flop



PokerStars Game #19897968530:  Hold'em No Limit ($0.10/$0.25) - 2008/08/25 - 19:41:46 (ET)
Table 'Pompeja II' 9-max Seat #9 is the button
Seat 1: Watchmaker42 ($36.40 in chips) 
Seat 2: Alameda22 ($23.65 in chips) 
Seat 3: pickpocketb ($52.05 in chips) 
Seat 4: Tigak ($12.15 in chips) 
Seat 5: Sep79 ($25.70 in chips) 
Seat 6: Ross823 ($24.25 in chips) 
Seat 7: Dennisuitehv ($24.15 in chips) 
Seat 8: chch10 ($25 in chips) 
Seat 9: 147Gorilla ($25 in chips) 
Watchmaker42: posts small blind $0.10
Alameda22: posts big blind $0.25
*** HOLE CARDS ***
Dealt to Alameda22 [Jc 8d]
pickpocketb: folds 
Tigak: raises $0.75 to $1
Sep79: folds 
Ross823: folds 
Dennisuitehv: folds 
chch10: folds 
147Gorilla: raises $2.50 to $3.50
Watchmaker42: folds 
Alameda22: folds 
Tigak: raises $8.65 to $12.15 and is all-in
147Gorilla: calls $8.65
*** FLOP *** [Ah 5s Th]
*** TURN *** [Ah 5s Th] [Td]
*** RIVER *** [Ah 5s Th Td] [4d]
*** SHOW DOWN ***
Tigak: shows [Ad Kh] (two pair, Aces and Tens)
147Gorilla: mucks hand 
Tigak collected $23.45 from pot
*** SUMMARY ***
Total pot $24.65 | Rake $1.20 
Board [Ah 5s Th Td 4d]
Seat 1: Watchmaker42 (small blind) folded before Flop
Seat 2: Alameda22 (big blind) folded before Flop
Seat 3: pickpocketb folded before Flop (didn't bet)
Seat 4: Tigak showed [Ad Kh] and won ($23.45) with two pair, Aces and Tens
Seat 5: Sep79 folded before Flop (didn't bet)
Seat 6: Ross823 folded before Flop (didn't bet)
Seat 7: Dennisuitehv folded before Flop (didn't bet)
Seat 8: chch10 folded before Flop (didn't bet)
Seat 9: 147Gorilla (button) mucked [Qh Qs]



PokerStars Game #19897994156:  Hold'em No Limit ($0.10/$0.25) - 2008/08/25 - 19:42:52 (ET)
Table 'Pompeja II' 9-max Seat #1 is the button
Seat 1: Watchmaker42 ($36.30 in chips) 
Seat 2: Alameda22 ($23.40 in chips) 
Seat 3: pickpocketb ($52.05 in chips) 
Seat 4: Tigak ($23.45 in chips) 
Seat 5: Sep79 ($25.70 in chips) 
Seat 6: Ross823 ($24.25 in chips) 
Seat 7: Dennisuitehv ($24.15 in chips) 
Seat 8: chch10 ($25 in chips) 
Seat 9: 147Gorilla ($25 in chips) 
Alameda22: posts small blind $0.10
pickpocketb: posts big blind $0.25
*** HOLE CARDS ***
Dealt to Alameda22 [Th 2c]
Tigak: folds 
Sep79: folds 
Ross823: folds 
Dennisuitehv: raises $0.25 to $0.50
chch10: folds 
147Gorilla: folds 
Watchmaker42: raises $0.75 to $1.25
Alameda22: folds 
pickpocketb: folds 
Dennisuitehv: folds 
Uncalled bet ($0.75) returned to Watchmaker42
Watchmaker42 collected $1.35 from pot
Watchmaker42: doesn't show hand 
*** SUMMARY ***
Total pot $1.35 | Rake $0 
Seat 1: Watchmaker42 (button) collected ($1.35)
Seat 2: Alameda22 (small blind) folded before Flop
Seat 3: pickpocketb (big blind) folded before Flop
Seat 4: Tigak folded before Flop (didn't bet)
Seat 5: Sep79 folded before Flop (didn't bet)
Seat 6: Ross823 folded before Flop (didn't bet)
Seat 7: Dennisuitehv folded before Flop
Seat 8: chch10 folded before Flop (didn't bet)
Seat 9: 147Gorilla folded before Flop (didn't bet)



PokerStars Game #19898026842:  Hold'em No Limit ($0.10/$0.25) - 2008/08/25 - 19:44:18 (ET)
Table 'Pompeja II' 9-max Seat #2 is the button
Seat 1: Watchmaker42 ($37.15 in chips) 
Seat 2: Alameda22 ($23.30 in chips) 
Seat 3: pickpocketb ($51.80 in chips) 
Seat 4: Tigak ($23.45 in chips) 
Seat 5: Sep79 ($25.70 in chips) 
Seat 6: Ross823 ($24.25 in chips) 
Seat 7: Dennisuitehv ($23.65 in chips) 
Seat 8: chch10 ($25 in chips) 
Seat 9: 147Gorilla ($25 in chips) 
pickpocketb: posts small blind $0.10
Tigak: posts big blind $0.25
*** HOLE CARDS ***
Dealt to Alameda22 [8s 7c]
Sep79: folds 
Ross823: folds 
Dennisuitehv: folds 
chch10: folds 
147Gorilla: folds 
Watchmaker42: folds 
Watchmaker42 leaves the table
Alameda22: folds 
pickpocketb: calls $0.15
Tigak: checks 
*** FLOP *** [6c Kh 6h]
pickpocketb: checks 
Tigak: checks 
*** TURN *** [6c Kh 6h] [Jd]
nadadogg joins the table at seat #1 
pickpocketb: bets $0.50
Tigak: calls $0.50
*** RIVER *** [6c Kh 6h Jd] [As]
pickpocketb: bets $1
Tigak: folds 
Uncalled bet ($1) returned to pickpocketb
pickpocketb collected $1.45 from pot
pickpocketb: doesn't show hand 
*** SUMMARY ***
Total pot $1.50 | Rake $0.05 
Board [6c Kh 6h Jd As]
Seat 1: Watchmaker42 folded before Flop (didn't bet)
Seat 2: Alameda22 (button) folded before Flop (didn't bet)
Seat 3: pickpocketb (small blind) collected ($1.45)
Seat 4: Tigak (big blind) folded on the River
Seat 5: Sep79 folded before Flop (didn't bet)
Seat 6: Ross823 folded before Flop (didn't bet)
Seat 7: Dennisuitehv folded before Flop (didn't bet)
Seat 8: chch10 folded before Flop (didn't bet)
Seat 9: 147Gorilla folded before Flop (didn't bet)



PokerStars Game #19898050241:  Hold'em No Limit ($0.10/$0.25) - 2008/08/25 - 19:45:19 (ET)
Table 'Pompeja II' 9-max Seat #3 is the button
Seat 2: Alameda22 ($23.30 in chips) 
Seat 3: pickpocketb ($52.50 in chips) 
Seat 4: Tigak ($22.70 in chips) 
Seat 5: Sep79 ($25.70 in chips) 
Seat 6: Ross823 ($24.25 in chips) 
Seat 7: Dennisuitehv ($23.65 in chips) 
Seat 8: chch10 ($25 in chips) 
Seat 9: 147Gorilla ($25 in chips) 
Tigak: posts small blind $0.10
Sep79: posts big blind $0.25
nadadogg: sits out 
*** HOLE CARDS ***
Dealt to Alameda22 [3h 3d]
Ross823: calls $0.25
Dennisuitehv: raises $0.75 to $1
chch10: folds 
147Gorilla: folds 
Alameda22: folds 
pickpocketb: folds 
Tigak: folds 
Sep79: folds 
Ross823: calls $0.75
*** FLOP *** [8s 3s Kh]
Ross823: checks 
Dennisuitehv: bets $1.50
Ross823: folds 
Uncalled bet ($1.50) returned to Dennisuitehv
Dennisuitehv collected $2.25 from pot
Dennisuitehv: doesn't show hand 
*** SUMMARY ***
Total pot $2.35 | Rake $0.10 
Board [8s 3s Kh]
Seat 2: Alameda22 folded before Flop (didn't bet)
Seat 3: pickpocketb (button) folded before Flop (didn't bet)
Seat 4: Tigak (small blind) folded before Flop
Seat 5: Sep79 (big blind) folded before Flop
Seat 6: Ross823 folded on the Flop
Seat 7: Dennisuitehv collected ($2.25)
Seat 8: chch10 folded before Flop (didn't bet)
Seat 9: 147Gorilla folded before Flop (didn't bet)



PokerStars Game #19898074539:  Hold'em No Limit ($0.10/$0.25) - 2008/08/25 - 19:46:22 (ET)
Table 'Pompeja II' 9-max Seat #4 is the button
Seat 1: nadadogg ($25 in chips) 
Seat 2: Alameda22 ($23.30 in chips) 
Seat 3: pickpocketb ($52.50 in chips) 
Seat 4: Tigak ($22.60 in chips) 
Seat 5: Sep79 ($25.45 in chips) 
Seat 6: Ross823 ($23.25 in chips) 
Seat 7: Dennisuitehv ($24.90 in chips) 
Seat 8: chch10 ($25 in chips) 
Seat 9: 147Gorilla ($25 in chips) 
Sep79: posts small blind $0.10
Ross823: posts big blind $0.25
nadadogg: posts big blind $0.25
*** HOLE CARDS ***
Dealt to Alameda22 [6d 5s]
Dennisuitehv: folds 
chch10: folds 
147Gorilla: folds 
nadadogg: checks 
Alameda22: folds 
pickpocketb: folds 
Tigak: folds 
Sep79: folds 
Ross823: checks 
*** FLOP *** [3s 9h Ts]
Ross823: checks 
nadadogg: checks 
*** TURN *** [3s 9h Ts] [8h]
Ross823: bets $0.50
nadadogg: folds 
Uncalled bet ($0.50) returned to Ross823
Ross823 collected $0.60 from pot
Ross823: doesn't show hand 
*** SUMMARY ***
Total pot $0.60 | Rake $0 
Board [3s 9h Ts 8h]
Seat 1: nadadogg folded on the Turn
Seat 2: Alameda22 folded before Flop (didn't bet)
Seat 3: pickpocketb folded before Flop (didn't bet)
Seat 4: Tigak (button) folded before Flop (didn't bet)
Seat 5: Sep79 (small blind) folded before Flop
Seat 6: Ross823 (big blind) collected ($0.60)
Seat 7: Dennisuitehv folded before Flop (didn't bet)
Seat 8: chch10 folded before Flop (didn't bet)
Seat 9: 147Gorilla folded before Flop (didn't bet)



PokerStars Game #19898093920:  Hold'em No Limit ($0.10/$0.25) - 2008/08/25 - 19:47:13 (ET)
Table 'Pompeja II' 9-max Seat #5 is the button
Seat 1: nadadogg ($24.75 in chips) 
Seat 2: Alameda22 ($23.30 in chips) 
Seat 3: pickpocketb ($52.50 in chips) 
Seat 4: Tigak ($22.60 in chips) 
Seat 5: Sep79 ($25.35 in chips) 
Seat 6: Ross823 ($23.60 in chips) 
Seat 7: Dennisuitehv ($24.90 in chips) 
Seat 8: chch10 ($25 in chips) 
Seat 9: 147Gorilla ($25 in chips) 
Ross823: posts small blind $0.10
Dennisuitehv: posts big blind $0.25
*** HOLE CARDS ***
Dealt to Alameda22 [Kh 2h]
chch10: folds 
147Gorilla: folds 
nadadogg: folds 
Alameda22: folds 
pickpocketb: folds 
Tigak: folds 
Sep79: folds 
Ross823: calls $0.15
Dennisuitehv: checks 
*** FLOP *** [Qc Kd Tc]
Ross823: bets $0.25
Dennisuitehv: folds 
Uncalled bet ($0.25) returned to Ross823
Ross823 collected $0.50 from pot
Ross823: doesn't show hand 
*** SUMMARY ***
Total pot $0.50 | Rake $0 
Board [Qc Kd Tc]
Seat 1: nadadogg folded before Flop (didn't bet)
Seat 2: Alameda22 folded before Flop (didn't bet)
Seat 3: pickpocketb folded before Flop (didn't bet)
Seat 4: Tigak folded before Flop (didn't bet)
Seat 5: Sep79 (button) folded before Flop (didn't bet)
Seat 6: Ross823 (small blind) collected ($0.50)
Seat 7: Dennisuitehv (big blind) folded on the Flop
Seat 8: chch10 folded before Flop (didn't bet)
Seat 9: 147Gorilla folded before Flop (didn't bet)



PokerStars Game #19898112790:  Hold'em No Limit ($0.10/$0.25) - 2008/08/25 - 19:48:02 (ET)
Table 'Pompeja II' 9-max Seat #6 is the button
Seat 1: nadadogg ($24.75 in chips) 
Seat 2: Alameda22 ($23.30 in chips) 
Seat 3: pickpocketb ($52.50 in chips) 
Seat 4: Tigak ($22.60 in chips) 
Seat 5: Sep79 ($25.35 in chips) 
Seat 6: Ross823 ($23.85 in chips) 
Seat 7: Dennisuitehv ($24.65 in chips) 
Seat 8: chch10 ($25 in chips) 
Seat 9: 147Gorilla ($25 in chips) 
Dennisuitehv: posts small blind $0.10
chch10: posts big blind $0.25
*** HOLE CARDS ***
Dealt to Alameda22 [3d 5d]
147Gorilla: folds 
nadadogg: folds 
Alameda22: folds 
pickpocketb: folds 
Tigak: folds 
Sep79: raises $0.75 to $1
Ross823: calls $1
Dennisuitehv: folds 
chch10: folds 
*** FLOP *** [Qh 7s Ts]
Sep79: bets $1
Ross823: calls $1
*** TURN *** [Qh 7s Ts] [Ah]
Sep79: bets $2
Ross823: calls $2
*** RIVER *** [Qh 7s Ts Ah] [Qc]
Sep79: checks 
Ross823: bets $2
Sep79: folds 
Uncalled bet ($2) returned to Ross823
Ross823 collected $7.95 from pot
Ross823: doesn't show hand 
*** SUMMARY ***
Total pot $8.35 | Rake $0.40 
Board [Qh 7s Ts Ah Qc]
Seat 1: nadadogg folded before Flop (didn't bet)
Seat 2: Alameda22 folded before Flop (didn't bet)
Seat 3: pickpocketb folded before Flop (didn't bet)
Seat 4: Tigak folded before Flop (didn't bet)
Seat 5: Sep79 folded on the River
Seat 6: Ross823 (button) collected ($7.95)
Seat 7: Dennisuitehv (small blind) folded before Flop
Seat 8: chch10 (big blind) folded before Flop
Seat 9: 147Gorilla folded before Flop (didn't bet)



PokerStars Game #19898145163:  Hold'em No Limit ($0.10/$0.25) - 2008/08/25 - 19:49:27 (ET)
Table 'Pompeja II' 9-max Seat #7 is the button
Seat 1: nadadogg ($24.75 in chips) 
Seat 2: Alameda22 ($23.30 in chips) 
Seat 3: pickpocketb ($52.50 in chips) 
Seat 4: Tigak ($22.60 in chips) 
Seat 5: Sep79 ($25 in chips) 
Seat 6: Ross823 ($27.80 in chips) 
Seat 7: Dennisuitehv ($24.55 in chips) 
Seat 8: chch10 ($24.75 in chips) 
Seat 9: 147Gorilla ($25 in chips) 
chch10: posts small blind $0.10
147Gorilla: posts big blind $0.25
*** HOLE CARDS ***
Dealt to Alameda22 [Jc Ah]
nadadogg: folds 
Alameda22: folds 
pickpocketb: folds 
Tigak: folds 
Sep79: folds 
Ross823: calls $0.25
Dennisuitehv: raises $1 to $1.25
chch10: folds 
147Gorilla: folds 
Ross823: calls $1
*** FLOP *** [4h 7h 6s]
Ross823: checks 
Dennisuitehv: bets $1.50
Ross823: calls $1.50
*** TURN *** [4h 7h 6s] [5h]
Ross823: bets $3
Dennisuitehv: folds 
Uncalled bet ($3) returned to Ross823
Ross823 collected $5.60 from pot
Ross823: doesn't show hand 
*** SUMMARY ***
Total pot $5.85 | Rake $0.25 
Board [4h 7h 6s 5h]
Seat 1: nadadogg folded before Flop (didn't bet)
Seat 2: Alameda22 folded before Flop (didn't bet)
Seat 3: pickpocketb folded before Flop (didn't bet)
Seat 4: Tigak folded before Flop (didn't bet)
Seat 5: Sep79 folded before Flop (didn't bet)
Seat 6: Ross823 collected ($5.60)
Seat 7: Dennisuitehv (button) folded on the Turn
Seat 8: chch10 (small blind) folded before Flop
Seat 9: 147Gorilla (big blind) folded before Flop



PokerStars Game #19898177962:  Hold'em No Limit ($0.10/$0.25) - 2008/08/25 - 19:50:53 (ET)
Table 'Pompeja II' 9-max Seat #8 is the button
Seat 1: nadadogg ($24.75 in chips) 
Seat 2: Alameda22 ($23.30 in chips) 
Seat 3: pickpocketb ($52.50 in chips) 
Seat 4: Tigak ($22.60 in chips) 
Seat 5: Sep79 ($25 in chips) 
Seat 6: Ross823 ($30.65 in chips) 
Seat 7: Dennisuitehv ($21.80 in chips) 
Seat 8: chch10 ($24.65 in chips) 
Seat 9: 147Gorilla ($24.75 in chips) 
147Gorilla: posts small blind $0.10
nadadogg: posts big blind $0.25
*** HOLE CARDS ***
Dealt to Alameda22 [4d 6h]
Alameda22: folds 
pickpocketb: folds 
Tigak: folds 
Sep79: folds 
Ross823: calls $0.25
Dennisuitehv: folds 
chch10: folds 
147Gorilla: folds 
nadadogg: checks 
*** FLOP *** [Ks Td Th]
nadadogg: checks 
Ross823: checks 
*** TURN *** [Ks Td Th] [Qh]
nadadogg: checks 
Ross823: bets $0.25
nadadogg: folds 
Uncalled bet ($0.25) returned to Ross823
Ross823 collected $0.60 from pot
Ross823: doesn't show hand 
*** SUMMARY ***
Total pot $0.60 | Rake $0 
Board [Ks Td Th Qh]
Seat 1: nadadogg (big blind) folded on the Turn
Seat 2: Alameda22 folded before Flop (didn't bet)
Seat 3: pickpocketb folded before Flop (didn't bet)
Seat 4: Tigak folded before Flop (didn't bet)
Seat 5: Sep79 folded before Flop (didn't bet)
Seat 6: Ross823 collected ($0.60)
Seat 7: Dennisuitehv folded before Flop (didn't bet)
Seat 8: chch10 (button) folded before Flop (didn't bet)
Seat 9: 147Gorilla (small blind) folded before Flop



PokerStars Game #19898196407:  Hold'em No Limit ($0.10/$0.25) - 2008/08/25 - 19:51:41 (ET)
Table 'Pompeja II' 9-max Seat #9 is the button
Seat 1: nadadogg ($24.50 in chips) 
Seat 2: Alameda22 ($23.30 in chips) 
Seat 3: pickpocketb ($52.50 in chips) 
Seat 4: Tigak ($22.60 in chips) 
Seat 5: Sep79 ($25 in chips) 
Seat 6: Ross823 ($31 in chips) 
Seat 7: Dennisuitehv ($21.80 in chips) 
Seat 8: chch10 ($24.65 in chips) 
Seat 9: 147Gorilla ($25 in chips) 
nadadogg: posts small blind $0.10
Alameda22: posts big blind $0.25
*** HOLE CARDS ***
Dealt to Alameda22 [Qh 4s]
pickpocketb: folds 
Tigak: folds 
Sep79: folds 
Ross823: calls $0.25
Dennisuitehv: folds 
chch10: calls $0.25
147Gorilla: folds 
nadadogg: folds 
Alameda22: checks 
*** FLOP *** [Js Ac Tc]
Alameda22: checks 
Ross823: checks 
chch10: bets $0.75
Alameda22: folds 
Ross823: calls $0.75
*** TURN *** [Js Ac Tc] [5c]
Ross823: checks 
chch10: bets $2
Ross823: folds 
Uncalled bet ($2) returned to chch10
chch10 collected $2.25 from pot
chch10: doesn't show hand 
*** SUMMARY ***
Total pot $2.35 | Rake $0.10 
Board [Js Ac Tc 5c]
Seat 1: nadadogg (small blind) folded before Flop
Seat 2: Alameda22 (big blind) folded on the Flop
Seat 3: pickpocketb folded before Flop (didn't bet)
Seat 4: Tigak folded before Flop (didn't bet)
Seat 5: Sep79 folded before Flop (didn't bet)
Seat 6: Ross823 folded on the Turn
Seat 7: Dennisuitehv folded before Flop (didn't bet)
Seat 8: chch10 collected ($2.25)
Seat 9: 147Gorilla (button) folded before Flop (didn't bet)



PokerStars Game #19898219877:  Hold'em No Limit ($0.10/$0.25) - 2008/08/25 - 19:52:43 (ET)
Table 'Pompeja II' 9-max Seat #1 is the button
Seat 1: nadadogg ($24.40 in chips) 
Seat 2: Alameda22 ($23.05 in chips) 
Seat 3: pickpocketb ($52.50 in chips) 
Seat 4: Tigak ($22.60 in chips) 
Seat 5: Sep79 ($25 in chips) 
Seat 6: Ross823 ($30 in chips) 
Seat 7: Dennisuitehv ($25 in chips) 
Seat 8: chch10 ($25.90 in chips) 
Seat 9: 147Gorilla ($25 in chips) 
Alameda22: posts small blind $0.10
pickpocketb: posts big blind $0.25
*** HOLE CARDS ***
Dealt to Alameda22 [Qc 3c]
Tigak: folds 
Sep79: folds 
Ross823: calls $0.25
Dennisuitehv: folds 
chch10: folds 
147Gorilla: folds 
nadadogg: folds 
Alameda22: folds 
pickpocketb: checks 
*** FLOP *** [4c 4s 4d]
pickpocketb: checks 
Ross823: checks 
*** TURN *** [4c 4s 4d] [Jc]
pickpocketb: checks 
Ross823: checks 
*** RIVER *** [4c 4s 4d Jc] [9s]
pickpocketb: checks 
Ross823: bets $1
pickpocketb: folds 
Uncalled bet ($1) returned to Ross823
Ross823 collected $0.60 from pot
Ross823: shows [Ks Kh] (a full house, Fours full of Kings)
*** SUMMARY ***
Total pot $0.60 | Rake $0 
Board [4c 4s 4d Jc 9s]
Seat 1: nadadogg (button) folded before Flop (didn't bet)
Seat 2: Alameda22 (small blind) folded before Flop
Seat 3: pickpocketb (big blind) folded on the River
Seat 4: Tigak folded before Flop (didn't bet)
Seat 5: Sep79 folded before Flop (didn't bet)
Seat 6: Ross823 collected ($0.60)
Seat 7: Dennisuitehv folded before Flop (didn't bet)
Seat 8: chch10 folded before Flop (didn't bet)
Seat 9: 147Gorilla folded before Flop (didn't bet)



PokerStars Game #19898239159:  Hold'em No Limit ($0.10/$0.25) - 2008/08/25 - 19:53:34 (ET)
Table 'Pompeja II' 9-max Seat #2 is the button
Seat 1: nadadogg ($24.40 in chips) 
Seat 2: Alameda22 ($22.95 in chips) 
Seat 3: pickpocketb ($52.25 in chips) 
Seat 4: Tigak ($22.60 in chips) 
Seat 5: Sep79 ($25 in chips) 
Seat 6: Ross823 ($30.35 in chips) 
Seat 7: Dennisuitehv ($25 in chips) 
Seat 8: chch10 ($25.90 in chips) 
Seat 9: 147Gorilla ($25 in chips) 
pickpocketb: posts small blind $0.10
Tigak: posts big blind $0.25
*** HOLE CARDS ***
Dealt to Alameda22 [Td 6h]
Sep79: folds 
Ross823: calls $0.25
Dennisuitehv: folds 
chch10: folds 
147Gorilla: calls $0.25
nadadogg: folds 
Alameda22: folds 
pickpocketb: calls $0.15
Tigak: checks 
*** FLOP *** [7s Qc 9h]
pickpocketb: checks 
Tigak: checks 
Ross823: checks 
147Gorilla: checks 
*** TURN *** [7s Qc 9h] [6s]
pickpocketb: checks 
Tigak: checks 
Ross823: checks 
147Gorilla: checks 
*** RIVER *** [7s Qc 9h 6s] [Jd]
pickpocketb: checks 
Tigak: checks 
Ross823: checks 
147Gorilla: checks 
*** SHOW DOWN ***
pickpocketb: shows [Ad 4s] (high card Ace)
Tigak: mucks hand 
Ross823: shows [As Ts] (high card Ace - Queen+Jack+Ten kicker)
147Gorilla: shows [3h 3c] (a pair of Threes)
147Gorilla collected $0.95 from pot
*** SUMMARY ***
Total pot $1 | Rake $0.05 
Board [7s Qc 9h 6s Jd]
Seat 1: nadadogg folded before Flop (didn't bet)
Seat 2: Alameda22 (button) folded before Flop (didn't bet)
Seat 3: pickpocketb (small blind) showed [Ad 4s] and lost with high card Ace
Seat 4: Tigak (big blind) mucked [Th 2d]
Seat 5: Sep79 folded before Flop (didn't bet)
Seat 6: Ross823 showed [As Ts] and lost with high card Ace
Seat 7: Dennisuitehv folded before Flop (didn't bet)
Seat 8: chch10 folded before Flop (didn't bet)
Seat 9: 147Gorilla showed [3h 3c] and won ($0.95) with a pair of Threes



PokerStars Game #19898271197:  Hold'em No Limit ($0.10/$0.25) - 2008/08/25 - 19:54:59 (ET)
Table 'Pompeja II' 9-max Seat #3 is the button
Seat 1: nadadogg ($24.40 in chips) 
Seat 2: Alameda22 ($22.95 in chips) 
Seat 3: pickpocketb ($52 in chips) 
Seat 4: Tigak ($22.35 in chips) 
Seat 5: Sep79 ($25 in chips) 
Seat 6: Ross823 ($30.10 in chips) 
Seat 7: Dennisuitehv ($25 in chips) 
Seat 8: chch10 ($25.90 in chips) 
Seat 9: 147Gorilla ($25.70 in chips) 
Tigak: posts small blind $0.10
Sep79: posts big blind $0.25
*** HOLE CARDS ***
Dealt to Alameda22 [3s 6c]
Ross823 said, "lol"
Ross823: calls $0.25
Dennisuitehv: folds 
chch10: raises $1 to $1.25
147Gorilla: folds 
nadadogg: folds 
Alameda22: folds 
pickpocketb: folds 
Tigak: folds 
Sep79: folds 
Ross823: folds 
Uncalled bet ($1) returned to chch10
chch10 collected $0.85 from pot
chch10: doesn't show hand 
*** SUMMARY ***
Total pot $0.85 | Rake $0 
Seat 1: nadadogg folded before Flop (didn't bet)
Seat 2: Alameda22 folded before Flop (didn't bet)
Seat 3: pickpocketb (button) folded before Flop (didn't bet)
Seat 4: Tigak (small blind) folded before Flop
Seat 5: Sep79 (big blind) folded before Flop
Seat 6: Ross823 folded before Flop
Seat 7: Dennisuitehv folded before Flop (didn't bet)
Seat 8: chch10 collected ($0.85)
Seat 9: 147Gorilla folded before Flop (didn't bet)



PokerStars Game #19898286498:  Hold'em No Limit ($0.10/$0.25) - 2008/08/25 - 19:55:40 (ET)
Table 'Pompeja II' 9-max Seat #4 is the button
Seat 1: nadadogg ($24.40 in chips) 
Seat 2: Alameda22 ($22.95 in chips) 
Seat 3: pickpocketb ($52 in chips) 
Seat 4: Tigak ($22.25 in chips) 
Seat 5: Sep79 ($24.75 in chips) 
Seat 6: Ross823 ($29.85 in chips) 
Seat 7: Dennisuitehv ($25 in chips) 
Seat 8: chch10 ($26.50 in chips) 
Seat 9: 147Gorilla ($25.70 in chips) 
Sep79: posts small blind $0.10
Ross823: posts big blind $0.25
*** HOLE CARDS ***
Dealt to Alameda22 [8d 2c]
Dennisuitehv: folds 
chch10: folds 
147Gorilla: folds 
nadadogg: folds 
Alameda22: folds 
pickpocketb: folds 
Tigak: folds 
Sep79: folds 
Uncalled bet ($0.15) returned to Ross823
Ross823 collected $0.20 from pot
Ross823: doesn't show hand 
*** SUMMARY ***
Total pot $0.20 | Rake $0 
Seat 1: nadadogg folded before Flop (didn't bet)
Seat 2: Alameda22 folded before Flop (didn't bet)
Seat 3: pickpocketb folded before Flop (didn't bet)
Seat 4: Tigak (button) folded before Flop (didn't bet)
Seat 5: Sep79 (small blind) folded before Flop
Seat 6: Ross823 (big blind) collected ($0.20)
Seat 7: Dennisuitehv folded before Flop (didn't bet)
Seat 8: chch10 folded before Flop (didn't bet)
Seat 9: 147Gorilla folded before Flop (didn't bet)



PokerStars Game #19898297901:  Hold'em No Limit ($0.10/$0.25) - 2008/08/25 - 19:56:10 (ET)
Table 'Pompeja II' 9-max Seat #5 is the button
Seat 1: nadadogg ($24.40 in chips) 
Seat 2: Alameda22 ($22.95 in chips) 
Seat 3: pickpocketb ($52 in chips) 
Seat 4: Tigak ($22.25 in chips) 
Seat 5: Sep79 ($24.65 in chips) 
Seat 6: Ross823 ($29.95 in chips) 
Seat 7: Dennisuitehv ($25 in chips) 
Seat 8: chch10 ($26.50 in chips) 
Seat 9: 147Gorilla ($25.70 in chips) 
Ross823: posts small blind $0.10
Dennisuitehv: posts big blind $0.25
*** HOLE CARDS ***
Dealt to Alameda22 [Th Ad]
chch10: folds 
147Gorilla: folds 
nadadogg: folds 
Alameda22: folds 
pickpocketb: folds 
Tigak: folds 
Sep79: folds 
Ross823: calls $0.15
Dennisuitehv: checks 
*** FLOP *** [6s Qh 9d]
Ross823: checks 
Dennisuitehv: checks 
*** TURN *** [6s Qh 9d] [4c]
Ross823: bets $0.75
Dennisuitehv: folds 
Uncalled bet ($0.75) returned to Ross823
Ross823 collected $0.50 from pot
Ross823: doesn't show hand 
*** SUMMARY ***
Total pot $0.50 | Rake $0 
Board [6s Qh 9d 4c]
Seat 1: nadadogg folded before Flop (didn't bet)
Seat 2: Alameda22 folded before Flop (didn't bet)
Seat 3: pickpocketb folded before Flop (didn't bet)
Seat 4: Tigak folded before Flop (didn't bet)
Seat 5: Sep79 (button) folded before Flop (didn't bet)
Seat 6: Ross823 (small blind) collected ($0.50)
Seat 7: Dennisuitehv (big blind) folded on the Turn
Seat 8: chch10 folded before Flop (didn't bet)
Seat 9: 147Gorilla folded before Flop (didn't bet)



PokerStars Game #19898314948:  Hold'em No Limit ($0.10/$0.25) - 2008/08/25 - 19:56:56 (ET)
Table 'Pompeja II' 9-max Seat #6 is the button
Seat 1: nadadogg ($24.40 in chips) 
Seat 2: Alameda22 ($22.95 in chips) 
Seat 3: pickpocketb ($52 in chips) 
Seat 4: Tigak ($22.25 in chips) 
Seat 5: Sep79 ($24.65 in chips) 
Seat 6: Ross823 ($30.20 in chips) 
Seat 7: Dennisuitehv ($24.75 in chips) 
Seat 8: chch10 ($26.50 in chips) 
Seat 9: 147Gorilla ($25.70 in chips) 
Dennisuitehv: posts small blind $0.10
chch10: posts big blind $0.25
*** HOLE CARDS ***
Dealt to Alameda22 [2c Th]
147Gorilla: folds 
nadadogg: folds 
Alameda22: folds 
pickpocketb: folds 
Tigak: raises $0.75 to $1
Sep79: folds 
Ross823: folds 
Dennisuitehv: folds 
chch10: folds 
Uncalled bet ($0.75) returned to Tigak
Tigak collected $0.60 from pot
*** SUMMARY ***
Total pot $0.60 | Rake $0 
Seat 1: nadadogg folded before Flop (didn't bet)
Seat 2: Alameda22 folded before Flop (didn't bet)
Seat 3: pickpocketb folded before Flop (didn't bet)
Seat 4: Tigak collected ($0.60)
Seat 5: Sep79 folded before Flop (didn't bet)
Seat 6: Ross823 (button) folded before Flop (didn't bet)
Seat 7: Dennisuitehv (small blind) folded before Flop
Seat 8: chch10 (big blind) folded before Flop
Seat 9: 147Gorilla folded before Flop (didn't bet)



PokerStars Game #19898325785:  Hold'em No Limit ($0.10/$0.25) - 2008/08/25 - 19:57:25 (ET)
Table 'Pompeja II' 9-max Seat #7 is the button
Seat 1: nadadogg ($24.40 in chips) 
Seat 2: Alameda22 ($22.95 in chips) 
Seat 3: pickpocketb ($52 in chips) 
Seat 4: Tigak ($22.60 in chips) 
Seat 5: Sep79 ($24.65 in chips) 
Seat 6: Ross823 ($30.20 in chips) 
Seat 7: Dennisuitehv ($24.65 in chips) 
Seat 8: chch10 ($26.25 in chips) 
Seat 9: 147Gorilla ($25.70 in chips) 
chch10: posts small blind $0.10
147Gorilla: posts big blind $0.25
*** HOLE CARDS ***
Dealt to Alameda22 [Jd 7d]
nadadogg: folds 
Alameda22: folds 
pickpocketb: folds 
Tigak: raises $0.50 to $0.75
Sep79: folds 
Ross823: calls $0.75
Dennisuitehv: folds 
chch10: folds 
147Gorilla: folds 
*** FLOP *** [9s Jh 4s]
Tigak: bets $1.75
Ross823: calls $1.75
*** TURN *** [9s Jh 4s] [8c]
Tigak: bets $20.10 and is all-in
Ross823: folds 
Uncalled bet ($20.10) returned to Tigak
Tigak collected $5.10 from pot
*** SUMMARY ***
Total pot $5.35 | Rake $0.25 
Board [9s Jh 4s 8c]
Seat 1: nadadogg folded before Flop (didn't bet)
Seat 2: Alameda22 folded before Flop (didn't bet)
Seat 3: pickpocketb folded before Flop (didn't bet)
Seat 4: Tigak collected ($5.10)
Seat 5: Sep79 folded before Flop (didn't bet)
Seat 6: Ross823 folded on the Turn
Seat 7: Dennisuitehv (button) folded before Flop (didn't bet)
Seat 8: chch10 (small blind) folded before Flop
Seat 9: 147Gorilla (big blind) folded before Flop



PokerStars Game #19898346126:  Hold'em No Limit ($0.10/$0.25) - 2008/08/25 - 19:58:20 (ET)
Table 'Pompeja II' 9-max Seat #8 is the button
Seat 1: nadadogg ($24.40 in chips) 
Seat 2: Alameda22 ($22.95 in chips) 
Seat 3: pickpocketb ($52 in chips) 
Seat 4: Tigak ($25.20 in chips) 
Seat 5: Sep79 ($25 in chips) 
Seat 6: Ross823 ($27.70 in chips) 
Seat 7: Dennisuitehv ($24.65 in chips) 
Seat 8: chch10 ($26.15 in chips) 
Seat 9: 147Gorilla ($25.45 in chips) 
147Gorilla: posts small blind $0.10
nadadogg: posts big blind $0.25
*** HOLE CARDS ***
Dealt to Alameda22 [Ad Jh]
Alameda22: folds 
pickpocketb: folds 
Tigak: folds 
Sep79: folds 
Ross823: folds 
Dennisuitehv: folds 
chch10: raises $0.75 to $1
147Gorilla: folds 
nadadogg: folds 
Uncalled bet ($0.75) returned to chch10
chch10 collected $0.60 from pot
chch10: doesn't show hand 
*** SUMMARY ***
Total pot $0.60 | Rake $0 
Seat 1: nadadogg (big blind) folded before Flop
Seat 2: Alameda22 folded before Flop (didn't bet)
Seat 3: pickpocketb folded before Flop (didn't bet)
Seat 4: Tigak folded before Flop (didn't bet)
Seat 5: Sep79 folded before Flop (didn't bet)
Seat 6: Ross823 folded before Flop (didn't bet)
Seat 7: Dennisuitehv folded before Flop (didn't bet)
Seat 8: chch10 (button) collected ($0.60)
Seat 9: 147Gorilla (small blind) folded before Flop



PokerStars Game #19898362678:  Hold'em No Limit ($0.10/$0.25) - 2008/08/25 - 19:59:04 (ET)
Table 'Pompeja II' 9-max Seat #9 is the button
Seat 1: nadadogg ($24.15 in chips) 
Seat 2: Alameda22 ($22.95 in chips) 
Seat 3: pickpocketb ($52 in chips) 
Seat 4: Tigak ($25.20 in chips) 
Seat 5: Sep79 ($25 in chips) 
Seat 6: Ross823 ($27.70 in chips) 
Seat 7: Dennisuitehv ($24.65 in chips) 
Seat 8: chch10 ($26.50 in chips) 
Seat 9: 147Gorilla ($25.35 in chips) 
nadadogg: posts small blind $0.10
Alameda22: posts big blind $0.25
*** HOLE CARDS ***
Dealt to Alameda22 [6h 6s]
pickpocketb: folds 
Tigak: folds 
Sep79: folds 
Ross823: folds 
Dennisuitehv: folds 
chch10: folds 
147Gorilla: folds 
nadadogg: raises $0.25 to $0.50
Alameda22: calls $0.25
*** FLOP *** [5s 6c As]
nadadogg: bets $0.75
Alameda22: raises $1.50 to $2.25
nadadogg: folds 
Uncalled bet ($1.50) returned to Alameda22
Alameda22 collected $2.40 from pot
Alameda22: doesn't show hand 
*** SUMMARY ***
Total pot $2.50 | Rake $0.10 
Board [5s 6c As]
Seat 1: nadadogg (small blind) folded on the Flop
Seat 2: Alameda22 (big blind) collected ($2.40)
Seat 3: pickpocketb folded before Flop (didn't bet)
Seat 4: Tigak folded before Flop (didn't bet)
Seat 5: Sep79 folded before Flop (didn't bet)
Seat 6: Ross823 folded before Flop (didn't bet)
Seat 7: Dennisuitehv folded before Flop (didn't bet)
Seat 8: chch10 folded before Flop (didn't bet)
Seat 9: 147Gorilla (button) folded before Flop (didn't bet)



PokerStars Game #19898385025:  Hold'em No Limit ($0.10/$0.25) - 2008/08/25 - 20:00:01 (ET)
Table 'Pompeja II' 9-max Seat #1 is the button
Seat 1: nadadogg ($22.90 in chips) 
Seat 2: Alameda22 ($24.10 in chips) 
Seat 3: pickpocketb ($52 in chips) 
Seat 4: Tigak ($25.20 in chips) 
Seat 5: Sep79 ($25 in chips) 
Seat 6: Ross823 ($27.70 in chips) 
Seat 7: Dennisuitehv ($24.65 in chips) 
Seat 8: chch10 ($26.50 in chips) 
Seat 9: 147Gorilla ($25.35 in chips) 
Alameda22: posts small blind $0.10
pickpocketb: posts big blind $0.25
*** HOLE CARDS ***
Dealt to Alameda22 [Kd Qh]
Tigak: folds 
Ross823 is disconnected 
Ross823 is connected 
Tigak leaves the table
Sep79: folds 
Ross823: folds 
Dennisuitehv: folds 
chch10: folds 
147Gorilla: folds 
nadadogg: folds 
Alameda22: calls $0.15
pickpocketb: checks 
*** FLOP *** [Ks Th 8c]
Alameda22: bets $0.25
pickpocketb: calls $0.25
*** TURN *** [Ks Th 8c] [7d]
Alameda22: bets $0.75
pickpocketb: calls $0.75
*** RIVER *** [Ks Th 8c 7d] [Td]
Alameda22: checks 
pickpocketb: checks 
*** SHOW DOWN ***
Alameda22: shows [Kd Qh] (two pair, Kings and Tens)
pickpocketb: mucks hand 
Alameda22 collected $2.40 from pot
*** SUMMARY ***
Total pot $2.50 | Rake $0.10 
Board [Ks Th 8c 7d Td]
Seat 1: nadadogg (button) folded before Flop (didn't bet)
Seat 2: Alameda22 (small blind) showed [Kd Qh] and won ($2.40) with two pair, Kings and Tens
Seat 3: pickpocketb (big blind) mucked [4h Kh]
Seat 4: Tigak folded before Flop (didn't bet)
Seat 5: Sep79 folded before Flop (didn't bet)
Seat 6: Ross823 folded before Flop (didn't bet)
Seat 7: Dennisuitehv folded before Flop (didn't bet)
Seat 8: chch10 folded before Flop (didn't bet)
Seat 9: 147Gorilla folded before Flop (didn't bet)



PokerStars Game #19898414940:  Hold'em No Limit ($0.10/$0.25) - 2008/08/25 - 20:01:21 (ET)
Table 'Pompeja II' 9-max Seat #2 is the button
Seat 1: nadadogg ($22.90 in chips) 
Seat 2: Alameda22 ($25.25 in chips) 
Seat 3: pickpocketb ($50.75 in chips) 
Seat 5: Sep79 ($25 in chips) 
Seat 6: Ross823 ($27.70 in chips) 
Seat 7: Dennisuitehv ($24.65 in chips) 
Seat 8: chch10 ($26.50 in chips) 
Seat 9: 147Gorilla ($25.35 in chips) 
pickpocketb: posts small blind $0.10
Sep79: posts big blind $0.25
*** HOLE CARDS ***
Dealt to Alameda22 [9s Qc]
Ross823: folds 
Dennisuitehv: calls $0.25
chch10: folds 
147Gorilla: folds 
nadadogg: folds 
Alameda22: folds 
pickpocketb: folds 
Sep79: checks 
*** FLOP *** [8s Jc 5h]
Sep79: checks 
Dennisuitehv: checks 
*** TURN *** [8s Jc 5h] [Td]
Sep79: checks 
Dennisuitehv: bets $0.50
iefbr14 joins the table at seat #4 
Sep79: calls $0.50
*** RIVER *** [8s Jc 5h Td] [Jh]
Sep79: checks 
Dennisuitehv: bets $1
Sep79: folds 
Uncalled bet ($1) returned to Dennisuitehv
Dennisuitehv collected $1.55 from pot
Dennisuitehv: doesn't show hand 
*** SUMMARY ***
Total pot $1.60 | Rake $0.05 
Board [8s Jc 5h Td Jh]
Seat 1: nadadogg folded before Flop (didn't bet)
Seat 2: Alameda22 (button) folded before Flop (didn't bet)
Seat 3: pickpocketb (small blind) folded before Flop
Seat 5: Sep79 (big blind) folded on the River
Seat 6: Ross823 folded before Flop (didn't bet)
Seat 7: Dennisuitehv collected ($1.55)
Seat 8: chch10 folded before Flop (didn't bet)
Seat 9: 147Gorilla folded before Flop (didn't bet)



PokerStars Game #19898441136:  Hold'em No Limit ($0.10/$0.25) - 2008/08/25 - 20:02:29 (ET)
Table 'Pompeja II' 9-max Seat #3 is the button
Seat 1: nadadogg ($22.90 in chips) 
Seat 2: Alameda22 ($25.25 in chips) 
Seat 3: pickpocketb ($50.65 in chips) 
Seat 5: Sep79 ($24.25 in chips) 
Seat 6: Ross823 ($27.70 in chips) 
Seat 7: Dennisuitehv ($25.45 in chips) 
Seat 8: chch10 ($26.50 in chips) 
Seat 9: 147Gorilla ($25.35 in chips) 
iefbr14 will be allowed to play after the button
Sep79: posts small blind $0.10
Ross823: posts big blind $0.25
*** HOLE CARDS ***
Dealt to Alameda22 [Jd 9d]
Dennisuitehv: calls $0.25
chch10: folds 
147Gorilla: folds 
nadadogg: folds 
Alameda22: folds 
pickpocketb: raises $1.25 to $1.50
Sep79: folds 
Ross823: calls $1.25
Dennisuitehv: calls $1.25
*** FLOP *** [7h Qh Jh]
Ross823: checks 
Dennisuitehv: checks 
pickpocketb: bets $4
Ross823: folds 
Ross823 is sitting out
Dennisuitehv: folds 
Uncalled bet ($4) returned to pickpocketb
Ross823 has returned
pickpocketb collected $4.40 from pot
pickpocketb: doesn't show hand 
*** SUMMARY ***
Total pot $4.60 | Rake $0.20 
Board [7h Qh Jh]
Seat 1: nadadogg folded before Flop (didn't bet)
Seat 2: Alameda22 folded before Flop (didn't bet)
Seat 3: pickpocketb (button) collected ($4.40)
Seat 5: Sep79 (small blind) folded before Flop
Seat 6: Ross823 (big blind) folded on the Flop
Seat 7: Dennisuitehv folded on the Flop
Seat 8: chch10 folded before Flop (didn't bet)
Seat 9: 147Gorilla folded before Flop (didn't bet)



PokerStars Game #19898463409:  Hold'em No Limit ($0.10/$0.25) - 2008/08/25 - 20:03:27 (ET)
Table 'Pompeja II' 9-max Seat #5 is the button
Seat 1: nadadogg ($22.90 in chips) 
Seat 2: Alameda22 ($25.25 in chips) 
Seat 3: pickpocketb ($53.55 in chips) 
Seat 4: iefbr14 ($6.95 in chips) 
Seat 5: Sep79 ($24.15 in chips) 
Seat 6: Ross823 ($26.20 in chips) 
Seat 7: Dennisuitehv ($23.95 in chips) 
Seat 8: chch10 ($26.50 in chips) 
Seat 9: 147Gorilla ($25.35 in chips) 
Ross823: posts small blind $0.10
Dennisuitehv: posts big blind $0.25
iefbr14: posts big blind $0.25
*** HOLE CARDS ***
Dealt to Alameda22 [5h Td]
chch10: folds 
147Gorilla: folds 
nadadogg: folds 
Alameda22: folds 
pickpocketb: calls $0.25
iefbr14: checks 
Sep79: folds 
Ross823: calls $0.15
Dennisuitehv: checks 
*** FLOP *** [6c 7c Ah]
Ross823: checks 
Dennisuitehv: checks 
pickpocketb: checks 
iefbr14: checks 
*** TURN *** [6c 7c Ah] [5d]
Ross823: checks 
Dennisuitehv: checks 
pickpocketb: checks 
iefbr14: checks 
*** RIVER *** [6c 7c Ah 5d] [8c]
Ross823: checks 
Dennisuitehv: checks 
pickpocketb: checks 
iefbr14: checks 
*** SHOW DOWN ***
Ross823: shows [Qd 6d] (a pair of Sixes)
Dennisuitehv: shows [2c 4d] (a straight, Four to Eight)
Ross823 is sitting out
pickpocketb: mucks hand 
iefbr14: mucks hand 
Ross823 has returned
Dennisuitehv collected $0.95 from pot
*** SUMMARY ***
Total pot $1 | Rake $0.05 
Board [6c 7c Ah 5d 8c]
Seat 1: nadadogg folded before Flop (didn't bet)
Seat 2: Alameda22 folded before Flop (didn't bet)
Seat 3: pickpocketb mucked [Qc Jd]
Seat 4: iefbr14 mucked [8d Js]
Seat 5: Sep79 (button) folded before Flop (didn't bet)
Seat 6: Ross823 (small blind) showed [Qd 6d] and lost with a pair of Sixes
Seat 7: Dennisuitehv (big blind) showed [2c 4d] and won ($0.95) with a straight, Four to Eight
Seat 8: chch10 folded before Flop (didn't bet)
Seat 9: 147Gorilla folded before Flop (didn't bet)



PokerStars Game #19898500439:  Hold'em No Limit ($0.10/$0.25) - 2008/08/25 - 20:05:03 (ET)
Table 'Pompeja II' 9-max Seat #6 is the button
Seat 1: nadadogg ($22.90 in chips) 
Seat 2: Alameda22 ($25.25 in chips) 
Seat 3: pickpocketb ($53.30 in chips) 
Seat 4: iefbr14 ($6.70 in chips) 
Seat 5: Sep79 ($25 in chips) 
Seat 6: Ross823 ($25.95 in chips) 
Seat 7: Dennisuitehv ($24.65 in chips) 
Seat 8: chch10 ($26.50 in chips) 
Seat 9: 147Gorilla ($25.35 in chips) 
Dennisuitehv: posts small blind $0.10
chch10: posts big blind $0.25
*** HOLE CARDS ***
Dealt to Alameda22 [4c Jc]
147Gorilla: folds 
nadadogg: folds 
Alameda22: folds 
pickpocketb: folds 
iefbr14: calls $0.25
Sep79: folds 
Ross823: calls $0.25
Dennisuitehv: folds 
chch10: checks 
*** FLOP *** [Kh 8s 6c]
chch10: checks 
iefbr14: bets $1
Ross823: calls $1
chch10: folds 
*** TURN *** [Kh 8s 6c] [2s]
iefbr14: bets $1
Ross823: calls $1
*** RIVER *** [Kh 8s 6c 2s] [Qd]
iefbr14: checks 
Ross823: bets $4.25
iefbr14: calls $4.25
*** SHOW DOWN ***
Ross823: shows [8d 6d] (two pair, Eights and Sixes)
iefbr14: mucks hand 
Ross823 collected $12.70 from pot
Ross823 is sitting out
iefbr14 leaves the table
*** SUMMARY ***
Total pot $13.35 | Rake $0.65 
Board [Kh 8s 6c 2s Qd]
Seat 1: nadadogg folded before Flop (didn't bet)
Seat 2: Alameda22 folded before Flop (didn't bet)
Seat 3: pickpocketb folded before Flop (didn't bet)
Seat 4: iefbr14 mucked [9s Ks]
Seat 5: Sep79 folded before Flop (didn't bet)
Seat 6: Ross823 (button) showed [8d 6d] and won ($12.70) with two pair, Eights and Sixes
Seat 7: Dennisuitehv (small blind) folded before Flop
Seat 8: chch10 (big blind) folded on the Flop
Seat 9: 147Gorilla folded before Flop (didn't bet)



PokerStars Game #19898540238:  Hold'em No Limit ($0.10/$0.25) - 2008/08/25 - 20:06:48 (ET)
Table 'Pompeja II' 9-max Seat #7 is the button
Seat 1: nadadogg ($22.90 in chips) 
Seat 2: Alameda22 ($25.25 in chips) 
Seat 3: pickpocketb ($53.30 in chips) 
Seat 5: Sep79 ($25 in chips) 
Seat 7: Dennisuitehv ($24.55 in chips) 
Seat 8: chch10 ($26.25 in chips) 
Seat 9: 147Gorilla ($25.35 in chips) 
chch10: posts small blind $0.10
147Gorilla: posts big blind $0.25
*** HOLE CARDS ***
Dealt to Alameda22 [2h 7s]
nadadogg: folds 
Alameda22: folds 
Ross823 leaves the table
nadadogg leaves the table
pickpocketb: folds 
Sep79: raises $0.75 to $1
Dennisuitehv: folds 
chch10: folds 
147Gorilla: folds 
Uncalled bet ($0.75) returned to Sep79
Sep79 collected $0.60 from pot
Sep79: doesn't show hand 
*** SUMMARY ***
Total pot $0.60 | Rake $0 
Seat 1: nadadogg folded before Flop (didn't bet)
Seat 2: Alameda22 folded before Flop (didn't bet)
Seat 3: pickpocketb folded before Flop (didn't bet)
Seat 5: Sep79 collected ($0.60)
Seat 7: Dennisuitehv (button) folded before Flop (didn't bet)
Seat 8: chch10 (small blind) folded before Flop
Seat 9: 147Gorilla (big blind) folded before Flop



PokerStars Game #19898554849:  Hold'em No Limit ($0.10/$0.25) - 2008/08/25 - 20:07:26 (ET)
Table 'Pompeja II' 9-max Seat #8 is the button
Seat 2: Alameda22 ($25.25 in chips) 
Seat 3: pickpocketb ($53.30 in chips) 
Seat 5: Sep79 ($25.35 in chips) 
Seat 7: Dennisuitehv ($24.55 in chips) 
Seat 8: chch10 ($26.15 in chips) 
Seat 9: 147Gorilla ($25.10 in chips) 
147Gorilla: posts small blind $0.10
Alameda22: posts big blind $0.25
*** HOLE CARDS ***
Dealt to Alameda22 [Ad Qd]
pickpocketb: folds 
Sep79: folds 
Dennisuitehv: folds 
atsmug joins the table at seat #4 
chch10: folds 
147Gorilla: folds 
Uncalled bet ($0.15) returned to Alameda22
Alameda22 collected $0.20 from pot
Alameda22: doesn't show hand 
*** SUMMARY ***
Total pot $0.20 | Rake $0 
Seat 2: Alameda22 (big blind) collected ($0.20)
Seat 3: pickpocketb folded before Flop (didn't bet)
Seat 5: Sep79 folded before Flop (didn't bet)
Seat 7: Dennisuitehv folded before Flop (didn't bet)
Seat 8: chch10 (button) folded before Flop (didn't bet)
Seat 9: 147Gorilla (small blind) folded before Flop



PokerStars Game #19898563239:  Hold'em No Limit ($0.10/$0.25) - 2008/08/25 - 20:07:48 (ET)
Table 'Pompeja II' 9-max Seat #9 is the button
Seat 2: Alameda22 ($25.35 in chips) 
Seat 3: pickpocketb ($53.30 in chips) 
Seat 5: Sep79 ($25.35 in chips) 
Seat 7: Dennisuitehv ($24.55 in chips) 
Seat 8: chch10 ($26.15 in chips) 
Seat 9: 147Gorilla ($25 in chips) 
Alameda22: posts small blind $0.10
pickpocketb: posts big blind $0.25
atsmug: sits out 
*** HOLE CARDS ***
Dealt to Alameda22 [Kc 5s]
Sep79: folds 
Dennisuitehv: folds 
chch10: folds 
147Gorilla: folds 
winni1974 joins the table at seat #6 
Alameda22: folds 
Uncalled bet ($0.15) returned to pickpocketb
pickpocketb collected $0.20 from pot
*** SUMMARY ***
Total pot $0.20 | Rake $0 
Seat 2: Alameda22 (small blind) folded before Flop
Seat 3: pickpocketb (big blind) collected ($0.20)
Seat 5: Sep79 folded before Flop (didn't bet)
Seat 7: Dennisuitehv folded before Flop (didn't bet)
Seat 8: chch10 folded before Flop (didn't bet)
Seat 9: 147Gorilla (button) folded before Flop (didn't bet)



PokerStars Game #19898577076:  Hold'em No Limit ($0.10/$0.25) - 2008/08/25 - 20:08:24 (ET)
Table 'Pompeja II' 9-max Seat #2 is the button
Seat 2: Alameda22 ($25.25 in chips) 
Seat 3: pickpocketb ($53.40 in chips) 
Seat 4: atsmug ($25 in chips) 
Seat 5: Sep79 ($25.35 in chips) 
Seat 6: winni1974 ($10 in chips) 
Seat 7: Dennisuitehv ($24.55 in chips) 
Seat 8: chch10 ($26.15 in chips) 
Seat 9: 147Gorilla ($25 in chips) 
pickpocketb: posts small blind $0.10
atsmug: posts big blind $0.25
winni1974: posts big blind $0.25
*** HOLE CARDS ***
Dealt to Alameda22 [9h 7c]
Sep79: folds 
winni1974: checks 
Dennisuitehv: calls $0.25
chch10: folds 
147Gorilla: folds 
Alameda22: folds 
pickpocketb: folds 
atsmug: checks 
*** FLOP *** [Tc 2h 6s]
atsmug: checks 
winni1974: checks 
Dennisuitehv: checks 
*** TURN *** [Tc 2h 6s] [9d]
atsmug: checks 
winni1974: checks 
Dennisuitehv: bets $0.50
atsmug: folds 
winni1974: folds 
Uncalled bet ($0.50) returned to Dennisuitehv
Dennisuitehv collected $0.85 from pot
Dennisuitehv: doesn't show hand 
*** SUMMARY ***
Total pot $0.85 | Rake $0 
Board [Tc 2h 6s 9d]
Seat 2: Alameda22 (button) folded before Flop (didn't bet)
Seat 3: pickpocketb (small blind) folded before Flop
Seat 4: atsmug (big blind) folded on the Turn
Seat 5: Sep79 folded before Flop (didn't bet)
Seat 6: winni1974 folded on the Turn
Seat 7: Dennisuitehv collected ($0.85)
Seat 8: chch10 folded before Flop (didn't bet)
Seat 9: 147Gorilla folded before Flop (didn't bet)



PokerStars Game #19898602574:  Hold'em No Limit ($0.10/$0.25) - 2008/08/25 - 20:09:30 (ET)
Table 'Pompeja II' 9-max Seat #3 is the button
Seat 2: Alameda22 ($25.25 in chips) 
Seat 3: pickpocketb ($53.30 in chips) 
Seat 4: atsmug ($24.75 in chips) 
Seat 5: Sep79 ($25.35 in chips) 
Seat 6: winni1974 ($9.75 in chips) 
Seat 7: Dennisuitehv ($25.15 in chips) 
Seat 8: chch10 ($26.15 in chips) 
Seat 9: 147Gorilla ($25 in chips) 
atsmug: posts small blind $0.10
Sep79: posts big blind $0.25
*** HOLE CARDS ***
Dealt to Alameda22 [Kh 5s]
winni1974: folds 
Dennisuitehv: calls $0.25
bodyman5646 joins the table at seat #1 
chch10: folds 
147Gorilla: folds 
Alameda22: folds 
pickpocketb: folds 
pickpocketb is sitting out
atsmug: calls $0.15
Sep79: checks 
*** FLOP *** [7h 8d 7d]
atsmug: checks 
Sep79: checks 
Dennisuitehv: bets $0.75
atsmug: raises $1 to $1.75
Sep79: folds 
Dennisuitehv: folds 
Uncalled bet ($1) returned to atsmug
atsmug collected $2.15 from pot
atsmug: doesn't show hand 
*** SUMMARY ***
Total pot $2.25 | Rake $0.10 
Board [7h 8d 7d]
Seat 2: Alameda22 folded before Flop (didn't bet)
Seat 3: pickpocketb (button) folded before Flop (didn't bet)
Seat 4: atsmug (small blind) collected ($2.15)
Seat 5: Sep79 (big blind) folded on the Flop
Seat 6: winni1974 folded before Flop (didn't bet)
Seat 7: Dennisuitehv folded on the Flop
Seat 8: chch10 folded before Flop (didn't bet)
Seat 9: 147Gorilla folded before Flop (didn't bet)



PokerStars Game #19898632247:  Hold'em No Limit ($0.10/$0.25) - 2008/08/25 - 20:10:48 (ET)
Table 'Pompeja II' 9-max Seat #4 is the button
Seat 1: bodyman5646 ($25 in chips) 
Seat 2: Alameda22 ($25.25 in chips) 
Seat 4: atsmug ($25.90 in chips) 
Seat 5: Sep79 ($25.10 in chips) 
Seat 6: winni1974 ($9.75 in chips) 
Seat 7: Dennisuitehv ($24.15 in chips) 
Seat 8: chch10 ($26.15 in chips) 
Seat 9: 147Gorilla ($25 in chips) 
Sep79: posts small blind $0.10
winni1974: posts big blind $0.25
bodyman5646: posts big blind $0.25
*** HOLE CARDS ***
Dealt to Alameda22 [3s 9c]
Dennisuitehv: calls $0.25
chch10: folds 
147Gorilla: folds 
bodyman5646: checks 
Alameda22: folds 
atsmug: folds 
Sep79: folds 
winni1974: checks 
*** FLOP *** [8s 8d As]
winni1974: checks 
Dennisuitehv: checks 
bodyman5646: checks 
*** TURN *** [8s 8d As] [5h]
winni1974: checks 
Dennisuitehv: bets $0.75
bodyman5646: folds 
winni1974: folds 
Uncalled bet ($0.75) returned to Dennisuitehv
Dennisuitehv collected $0.85 from pot
Dennisuitehv: doesn't show hand 
*** SUMMARY ***
Total pot $0.85 | Rake $0 
Board [8s 8d As 5h]
Seat 1: bodyman5646 folded on the Turn
Seat 2: Alameda22 folded before Flop (didn't bet)
Seat 4: atsmug (button) folded before Flop (didn't bet)
Seat 5: Sep79 (small blind) folded before Flop
Seat 6: winni1974 (big blind) folded on the Turn
Seat 7: Dennisuitehv collected ($0.85)
Seat 8: chch10 folded before Flop (didn't bet)
Seat 9: 147Gorilla folded before Flop (didn't bet)



PokerStars Game #19898656474:  Hold'em No Limit ($0.10/$0.25) - 2008/08/25 - 20:11:52 (ET)
Table 'Pompeja II' 9-max Seat #5 is the button
Seat 1: bodyman5646 ($24.75 in chips) 
Seat 2: Alameda22 ($25.25 in chips) 
Seat 4: atsmug ($25.90 in chips) 
Seat 5: Sep79 ($25 in chips) 
Seat 6: winni1974 ($9.50 in chips) 
Seat 7: Dennisuitehv ($24.75 in chips) 
Seat 8: chch10 ($26.15 in chips) 
Seat 9: 147Gorilla ($25 in chips) 
winni1974: posts small blind $0.10
Dennisuitehv: posts big blind $0.25
*** HOLE CARDS ***
Dealt to Alameda22 [Ts 9d]
chch10: folds 
147Gorilla: folds 
bodyman5646: calls $0.25
Alameda22: folds 
atsmug: raises $2 to $2.25
Sep79: folds 
winni1974: folds 
Dennisuitehv: calls $2
bodyman5646: folds 
*** FLOP *** [7s Qs 4d]
bodyman5646 leaves the table
Dennisuitehv: bets $3
atsmug: calls $3
*** TURN *** [7s Qs 4d] [9s]
pickpocketb has returned
Dennisuitehv: checks 
atsmug: checks 
*** RIVER *** [7s Qs 4d 9s] [7d]
Dennisuitehv: checks 
atsmug: checks 
*** SHOW DOWN ***
Dennisuitehv: shows [Tc Td] (two pair, Tens and Sevens)
atsmug: shows [Ac Qc] (two pair, Queens and Sevens)
atsmug collected $10.35 from pot
*** SUMMARY ***
Total pot $10.85 | Rake $0.50 
Board [7s Qs 4d 9s 7d]
Seat 1: bodyman5646 folded before Flop
Seat 2: Alameda22 folded before Flop (didn't bet)
Seat 4: atsmug showed [Ac Qc] and won ($10.35) with two pair, Queens and Sevens
Seat 5: Sep79 (button) folded before Flop (didn't bet)
Seat 6: winni1974 (small blind) folded before Flop
Seat 7: Dennisuitehv (big blind) showed [Tc Td] and lost with two pair, Tens and Sevens
Seat 8: chch10 folded before Flop (didn't bet)
Seat 9: 147Gorilla folded before Flop (didn't bet)



PokerStars Game #19898687157:  Hold'em No Limit ($0.10/$0.25) - 2008/08/25 - 20:13:13 (ET)
Table 'Pompeja II' 9-max Seat #6 is the button
Seat 2: Alameda22 ($25.25 in chips) 
Seat 3: pickpocketb ($53.30 in chips) 
Seat 4: atsmug ($31 in chips) 
Seat 5: Sep79 ($25 in chips) 
Seat 6: winni1974 ($9.40 in chips) 
Seat 7: Dennisuitehv ($19.50 in chips) 
Seat 8: chch10 ($26.15 in chips) 
Seat 9: 147Gorilla ($25 in chips) 
Dennisuitehv: posts small blind $0.10
chch10: posts big blind $0.25
*** HOLE CARDS ***
Dealt to Alameda22 [7d 5s]
147Gorilla: folds 
Alameda22: folds 
pickpocketb: raises $0.50 to $0.75
atsmug: folds 
Sep79: calls $0.75
winni1974: raises $1.75 to $2.50
Dennisuitehv: folds 
chch10: folds 
pickpocketb: folds 
atsmug leaves the table
Sep79: calls $1.75
*** FLOP *** [Kc 4s 3c]
Sep79: checks 
winni1974: bets $2
Sep79: folds 
Uncalled bet ($2) returned to winni1974
winni1974 collected $5.80 from pot
*** SUMMARY ***
Total pot $6.10 | Rake $0.30 
Board [Kc 4s 3c]
Seat 2: Alameda22 folded before Flop (didn't bet)
Seat 3: pickpocketb folded before Flop
Seat 4: atsmug folded before Flop (didn't bet)
Seat 5: Sep79 folded on the Flop
Seat 6: winni1974 (button) collected ($5.80)
Seat 7: Dennisuitehv (small blind) folded before Flop
Seat 8: chch10 (big blind) folded before Flop
Seat 9: 147Gorilla folded before Flop (didn't bet)



PokerStars Game #19898715496:  Hold'em No Limit ($0.10/$0.25) - 2008/08/25 - 20:14:28 (ET)
Table 'Pompeja II' 9-max Seat #7 is the button
Seat 2: Alameda22 ($25.25 in chips) 
Seat 3: pickpocketb ($52.55 in chips) 
Seat 5: Sep79 ($25 in chips) 
Seat 6: winni1974 ($12.70 in chips) 
Seat 7: Dennisuitehv ($25 in chips) 
Seat 8: chch10 ($25.90 in chips) 
Seat 9: 147Gorilla ($25 in chips) 
chch10: posts small blind $0.10
147Gorilla: posts big blind $0.25
*** HOLE CARDS ***
Dealt to Alameda22 [7s 9h]
Alameda22: folds 
pickpocketb: folds 
Sep79: raises $0.75 to $1
winni1974: folds 
Dennisuitehv: folds 
chch10: folds 
147Gorilla: folds 
Uncalled bet ($0.75) returned to Sep79
Sep79 collected $0.60 from pot
Sep79: doesn't show hand 
*** SUMMARY ***
Total pot $0.60 | Rake $0 
Seat 2: Alameda22 folded before Flop (didn't bet)
Seat 3: pickpocketb folded before Flop (didn't bet)
Seat 5: Sep79 collected ($0.60)
Seat 6: winni1974 folded before Flop (didn't bet)
Seat 7: Dennisuitehv (button) folded before Flop (didn't bet)
Seat 8: chch10 (small blind) folded before Flop
Seat 9: 147Gorilla (big blind) folded before Flop



PokerStars Game #19898730407:  Hold'em No Limit ($0.10/$0.25) - 2008/08/25 - 20:15:05 (ET)
Table 'Pompeja II' 9-max Seat #8 is the button
Seat 2: Alameda22 ($25.25 in chips) 
Seat 3: pickpocketb ($52.55 in chips) 
Seat 5: Sep79 ($25.35 in chips) 
Seat 6: winni1974 ($12.70 in chips) 
Seat 7: Dennisuitehv ($25 in chips) 
Seat 8: chch10 ($25.80 in chips) 
Seat 9: 147Gorilla ($25 in chips) 
147Gorilla: posts small blind $0.10
Alameda22: posts big blind $0.25
*** HOLE CARDS ***
Dealt to Alameda22 [4c 2h]
pickpocketb: folds 
Sep79: folds 
winni1974: folds 
Dennisuitehv: folds 
chch10: folds 
147Gorilla: raises $0.75 to $1
Alameda22: folds 
Uncalled bet ($0.75) returned to 147Gorilla
147Gorilla collected $0.50 from pot
147Gorilla: doesn't show hand 
147Gorilla is sitting out
*** SUMMARY ***
Total pot $0.50 | Rake $0 
Seat 2: Alameda22 (big blind) folded before Flop
Seat 3: pickpocketb folded before Flop (didn't bet)
Seat 5: Sep79 folded before Flop (didn't bet)
Seat 6: winni1974 folded before Flop (didn't bet)
Seat 7: Dennisuitehv folded before Flop (didn't bet)
Seat 8: chch10 (button) folded before Flop (didn't bet)
Seat 9: 147Gorilla (small blind) collected ($0.50)



PokerStars Game #19898743380:  Hold'em No Limit ($0.10/$0.25) - 2008/08/25 - 20:15:39 (ET)
Table 'Pompeja II' 9-max Seat #2 is the button
Seat 2: Alameda22 ($25 in chips) 
Seat 3: pickpocketb ($52.55 in chips) 
Seat 5: Sep79 ($25.35 in chips) 
Seat 6: winni1974 ($12.70 in chips) 
Seat 7: Dennisuitehv ($25 in chips) 
Seat 8: chch10 ($25.80 in chips) 
pickpocketb: posts small blind $0.10
Sep79: posts big blind $0.25
*** HOLE CARDS ***
Dealt to Alameda22 [4s 4d]
147Gorilla leaves the table
winni1974: folds 
Dennisuitehv: calls $0.25
chch10: folds 
Alameda22: calls $0.25
pickpocketb: calls $0.15
Sep79: checks 
*** FLOP *** [Td Tc 6c]
pickpocketb: checks 
Sep79: checks 
Dennisuitehv: bets $0.75
Alameda22: folds 
pickpocketb: folds 
Sep79: folds 
Uncalled bet ($0.75) returned to Dennisuitehv
Dennisuitehv collected $0.95 from pot
Dennisuitehv: doesn't show hand 
*** SUMMARY ***
Total pot $1 | Rake $0.05 
Board [Td Tc 6c]
Seat 2: Alameda22 (button) folded on the Flop
Seat 3: pickpocketb (small blind) folded on the Flop
Seat 5: Sep79 (big blind) folded on the Flop
Seat 6: winni1974 folded before Flop (didn't bet)
Seat 7: Dennisuitehv collected ($0.95)
Seat 8: chch10 folded before Flop (didn't bet)



PokerStars Game #19898775622:  Hold'em No Limit ($0.10/$0.25) - 2008/08/25 - 20:17:01 (ET)
Table 'Pompeja II' 9-max Seat #3 is the button
Seat 2: Alameda22 ($24.75 in chips) 
Seat 3: pickpocketb ($52.30 in chips) 
Seat 5: Sep79 ($25.10 in chips) 
Seat 6: winni1974 ($12.70 in chips) 
Seat 7: Dennisuitehv ($25.70 in chips) 
Seat 8: chch10 ($25.80 in chips) 
Sep79: posts small blind $0.10
winni1974: posts big blind $0.25
*** HOLE CARDS ***
Dealt to Alameda22 [Js 4d]
Dennisuitehv: folds 
chch10: folds 
Alameda22: folds 
pickpocketb: raises $0.50 to $0.75
Sep79: folds 
winni1974: calls $0.50
*** FLOP *** [3h 6h 5s]
winni1974: checks 
pickpocketb: bets $1
winni1974: folds 
Uncalled bet ($1) returned to pickpocketb
pickpocketb collected $1.55 from pot
pickpocketb: doesn't show hand 
*** SUMMARY ***
Total pot $1.60 | Rake $0.05 
Board [3h 6h 5s]
Seat 2: Alameda22 folded before Flop (didn't bet)
Seat 3: pickpocketb (button) collected ($1.55)
Seat 5: Sep79 (small blind) folded before Flop
Seat 6: winni1974 (big blind) folded on the Flop
Seat 7: Dennisuitehv folded before Flop (didn't bet)
Seat 8: chch10 folded before Flop (didn't bet)



PokerStars Game #19898793209:  Hold'em No Limit ($0.10/$0.25) - 2008/08/25 - 20:17:46 (ET)
Table 'Pompeja II' 9-max Seat #5 is the button
Seat 2: Alameda22 ($24.75 in chips) 
Seat 3: pickpocketb ($53.10 in chips) 
Seat 5: Sep79 ($25 in chips) 
Seat 6: winni1974 ($11.95 in chips) 
Seat 7: Dennisuitehv ($25.70 in chips) 
Seat 8: chch10 ($25.80 in chips) 
winni1974: posts small blind $0.10
Dennisuitehv: posts big blind $0.25
*** HOLE CARDS ***
Dealt to Alameda22 [8s Jc]
chch10: folds 
Alameda22: folds 
pickpocketb: folds 
Sep79: raises $0.75 to $1
winni1974: calls $0.90
Dennisuitehv: calls $0.75
*** FLOP *** [8c Kd Ad]
winni1974: checks 
Dennisuitehv: bets $1.50
Sep79: folds 
winni1974: folds 
Uncalled bet ($1.50) returned to Dennisuitehv
Dennisuitehv collected $2.85 from pot
Dennisuitehv: doesn't show hand 
*** SUMMARY ***
Total pot $3 | Rake $0.15 
Board [8c Kd Ad]
Seat 2: Alameda22 folded before Flop (didn't bet)
Seat 3: pickpocketb folded before Flop (didn't bet)
Seat 5: Sep79 (button) folded on the Flop
Seat 6: winni1974 (small blind) folded on the Flop
Seat 7: Dennisuitehv (big blind) collected ($2.85)
Seat 8: chch10 folded before Flop (didn't bet)



PokerStars Game #19898813608:  Hold'em No Limit ($0.10/$0.25) - 2008/08/25 - 20:18:37 (ET)
Table 'Pompeja II' 9-max Seat #6 is the button
Seat 2: Alameda22 ($24.75 in chips) 
Seat 3: pickpocketb ($53.10 in chips) 
Seat 5: Sep79 ($24 in chips) 
Seat 6: winni1974 ($10.95 in chips) 
Seat 7: Dennisuitehv ($27.55 in chips) 
Seat 8: chch10 ($25.80 in chips) 
Dennisuitehv: posts small blind $0.10
chch10: posts big blind $0.25
*** HOLE CARDS ***
Dealt to Alameda22 [Kc 6d]
Alameda22: folds 
pickpocketb: folds 
SaraFeeny joins the table at seat #9 
Sep79: folds 
winni1974: folds 
winni1974 leaves the table
Dennisuitehv: raises $0.50 to $0.75
chch10: folds 
Uncalled bet ($0.50) returned to Dennisuitehv
Dennisuitehv collected $0.50 from pot
Dennisuitehv: doesn't show hand 
*** SUMMARY ***
Total pot $0.50 | Rake $0 
Seat 2: Alameda22 folded before Flop (didn't bet)
Seat 3: pickpocketb folded before Flop (didn't bet)
Seat 5: Sep79 folded before Flop (didn't bet)
Seat 6: winni1974 (button) folded before Flop (didn't bet)
Seat 7: Dennisuitehv (small blind) collected ($0.50)
Seat 8: chch10 (big blind) folded before Flop



PokerStars Game #19898833234:  Hold'em No Limit ($0.10/$0.25) - 2008/08/25 - 20:19:27 (ET)
Table 'Pompeja II' 9-max Seat #7 is the button
Seat 2: Alameda22 ($24.75 in chips) 
Seat 3: pickpocketb ($53.10 in chips) 
Seat 5: Sep79 ($24 in chips) 
Seat 7: Dennisuitehv ($27.80 in chips) 
Seat 8: chch10 ($25.55 in chips) 
Seat 9: SaraFeeny ($5 in chips) 
chch10: posts small blind $0.10
SaraFeeny: posts big blind $0.25
*** HOLE CARDS ***
Dealt to Alameda22 [6s Kh]
Alameda22: folds 
pickpocketb: folds 
Sep79: folds 
Dennisuitehv: folds 
chch10: folds 
Uncalled bet ($0.15) returned to SaraFeeny
SaraFeeny collected $0.20 from pot
*** SUMMARY ***
Total pot $0.20 | Rake $0 
Seat 2: Alameda22 folded before Flop (didn't bet)
Seat 3: pickpocketb folded before Flop (didn't bet)
Seat 5: Sep79 folded before Flop (didn't bet)
Seat 7: Dennisuitehv (button) folded before Flop (didn't bet)
Seat 8: chch10 (small blind) folded before Flop
Seat 9: SaraFeeny (big blind) collected ($0.20)



PokerStars Game #19898851896:  Hold'em No Limit ($0.10/$0.25) - 2008/08/25 - 20:20:15 (ET)
Table 'Pompeja II' 9-max Seat #8 is the button
Seat 2: Alameda22 ($24.75 in chips) 
Seat 3: pickpocketb ($53.10 in chips) 
Seat 5: Sep79 ($24 in chips) 
Seat 7: Dennisuitehv ($27.80 in chips) 
Seat 8: chch10 ($25.45 in chips) 
Seat 9: SaraFeeny ($5.10 in chips) 
SaraFeeny: posts small blind $0.10
Alameda22: posts big blind $0.25
*** HOLE CARDS ***
Dealt to Alameda22 [Ac Qh]
pickpocketb: folds 
Sep79: folds 
Dennisuitehv: folds 
chch10: raises $0.75 to $1
SaraFeeny: folds 
Alameda22: raises $2 to $3
chch10: calls $2
*** FLOP *** [Kd 3s Jd]
Alameda22: bets $3.75
chch10: folds 
Uncalled bet ($3.75) returned to Alameda22
Alameda22 collected $5.80 from pot
Alameda22: doesn't show hand 
*** SUMMARY ***
Total pot $6.10 | Rake $0.30 
Board [Kd 3s Jd]
Seat 2: Alameda22 (big blind) collected ($5.80)
Seat 3: pickpocketb folded before Flop (didn't bet)
Seat 5: Sep79 folded before Flop (didn't bet)
Seat 7: Dennisuitehv folded before Flop (didn't bet)
Seat 8: chch10 (button) folded on the Flop
Seat 9: SaraFeeny (small blind) folded before Flop



PokerStars Game #19898876763:  Hold'em No Limit ($0.10/$0.25) - 2008/08/25 - 20:21:18 (ET)
Table 'Pompeja II' 9-max Seat #9 is the button
Seat 2: Alameda22 ($27.55 in chips) 
Seat 3: pickpocketb ($53.10 in chips) 
Seat 5: Sep79 ($24 in chips) 
Seat 7: Dennisuitehv ($27.80 in chips) 
Seat 8: chch10 ($25 in chips) 
Seat 9: SaraFeeny ($5 in chips) 
Alameda22: posts small blind $0.10
pickpocketb: posts big blind $0.25
*** HOLE CARDS ***
Dealt to Alameda22 [Ks Jd]
Sep79: raises $0.75 to $1
Dennisuitehv: folds 
chch10: raises $2 to $3
SaraFeeny: folds 
Alameda22: folds 
pickpocketb: folds 
Sep79: calls $2
*** FLOP *** [8c 3c 3s]
Sep79: checks 
chch10: bets $5.75
Sep79: calls $5.75
*** TURN *** [8c 3c 3s] [7d]
Sep79: checks 
chch10: checks 
*** RIVER *** [8c 3c 3s 7d] [Th]
Sep79: bets $9
chch10: folds 
Uncalled bet ($9) returned to Sep79
Sep79 collected $17 from pot
Sep79: doesn't show hand 
*** SUMMARY ***
Total pot $17.85 | Rake $0.85 
Board [8c 3c 3s 7d Th]
Seat 2: Alameda22 (small blind) folded before Flop
Seat 3: pickpocketb (big blind) folded before Flop
Seat 5: Sep79 collected ($17)
Seat 7: Dennisuitehv folded before Flop (didn't bet)
Seat 8: chch10 folded on the River
Seat 9: SaraFeeny (button) folded before Flop (didn't bet)



PokerStars Game #19898907381:  Hold'em No Limit ($0.10/$0.25) - 2008/08/25 - 20:22:37 (ET)
Table 'Pompeja II' 9-max Seat #2 is the button
Seat 2: Alameda22 ($27.45 in chips) 
Seat 3: pickpocketb ($52.85 in chips) 
Seat 5: Sep79 ($32.25 in chips) 
Seat 7: Dennisuitehv ($27.80 in chips) 
Seat 8: chch10 ($25 in chips) 
Seat 9: SaraFeeny ($5 in chips) 
pickpocketb: posts small blind $0.10
Sep79: posts big blind $0.25
*** HOLE CARDS ***
Dealt to Alameda22 [2d Ah]
Dennisuitehv: folds 
chch10: folds 
SaraFeeny: folds 
Alameda22: folds 
pickpocketb: folds 
Uncalled bet ($0.15) returned to Sep79
Sep79 collected $0.20 from pot
Sep79: doesn't show hand 
*** SUMMARY ***
Total pot $0.20 | Rake $0 
Seat 2: Alameda22 (button) folded before Flop (didn't bet)
Seat 3: pickpocketb (small blind) folded before Flop
Seat 5: Sep79 (big blind) collected ($0.20)
Seat 7: Dennisuitehv folded before Flop (didn't bet)
Seat 8: chch10 folded before Flop (didn't bet)
Seat 9: SaraFeeny folded before Flop (didn't bet)



PokerStars Game #19898922899:  Hold'em No Limit ($0.10/$0.25) - 2008/08/25 - 20:23:17 (ET)
Table 'Pompeja II' 9-max Seat #3 is the button
Seat 2: Alameda22 ($27.45 in chips) 
Seat 3: pickpocketb ($52.75 in chips) 
Seat 5: Sep79 ($32.35 in chips) 
Seat 7: Dennisuitehv ($27.80 in chips) 
Seat 8: chch10 ($25 in chips) 
Seat 9: SaraFeeny ($5 in chips) 
Sep79: posts small blind $0.10
Dennisuitehv: posts big blind $0.25
*** HOLE CARDS ***
Dealt to Alameda22 [3d 4h]
chch10: folds 
SaraFeeny: folds 
Alameda22: folds 
pickpocketb: raises $0.50 to $0.75
Sep79: folds 
Dennisuitehv: folds 
Uncalled bet ($0.50) returned to pickpocketb
pickpocketb collected $0.60 from pot
pickpocketb: doesn't show hand 
*** SUMMARY ***
Total pot $0.60 | Rake $0 
Seat 2: Alameda22 folded before Flop (didn't bet)
Seat 3: pickpocketb (button) collected ($0.60)
Seat 5: Sep79 (small blind) folded before Flop
Seat 7: Dennisuitehv (big blind) folded before Flop
Seat 8: chch10 folded before Flop (didn't bet)
Seat 9: SaraFeeny folded before Flop (didn't bet)



PokerStars Game #19898936531:  Hold'em No Limit ($0.10/$0.25) - 2008/08/25 - 20:23:52 (ET)
Table 'Pompeja II' 9-max Seat #5 is the button
Seat 2: Alameda22 ($27.45 in chips) 
Seat 3: pickpocketb ($53.10 in chips) 
Seat 5: Sep79 ($32.25 in chips) 
Seat 7: Dennisuitehv ($27.55 in chips) 
Seat 8: chch10 ($25 in chips) 
Seat 9: SaraFeeny ($5 in chips) 
Dennisuitehv: posts small blind $0.10
chch10: posts big blind $0.25
*** HOLE CARDS ***
Dealt to Alameda22 [Jh 4s]
SaraFeeny: folds 
Alameda22: folds 
pickpocketb: folds 
Sep79: folds 
Dennisuitehv: calls $0.15
chch10: checks 
*** FLOP *** [Jc 4c 2s]
Dennisuitehv: checks 
chch10: checks 
*** TURN *** [Jc 4c 2s] [4h]
Dennisuitehv: checks 
chch10: checks 
*** RIVER *** [Jc 4c 2s 4h] [5c]
Dennisuitehv: checks 
chch10: checks 
*** SHOW DOWN ***
Dennisuitehv: shows [Qh 3h] (a pair of Fours)
chch10: shows [Kc Qd] (a pair of Fours - King kicker)
chch10 collected $0.50 from pot
*** SUMMARY ***
Total pot $0.50 | Rake $0 
Board [Jc 4c 2s 4h 5c]
Seat 2: Alameda22 folded before Flop (didn't bet)
Seat 3: pickpocketb folded before Flop (didn't bet)
Seat 5: Sep79 (button) folded before Flop (didn't bet)
Seat 7: Dennisuitehv (small blind) showed [Qh 3h] and lost with a pair of Fours
Seat 8: chch10 (big blind) showed [Kc Qd] and won ($0.50) with a pair of Fours
Seat 9: SaraFeeny folded before Flop (didn't bet)



PokerStars Game #19898953211:  Hold'em No Limit ($0.10/$0.25) - 2008/08/25 - 20:24:35 (ET)
Table 'Pompeja II' 9-max Seat #7 is the button
Seat 2: Alameda22 ($27.45 in chips) 
Seat 3: pickpocketb ($53.10 in chips) 
Seat 5: Sep79 ($32.25 in chips) 
Seat 7: Dennisuitehv ($27.30 in chips) 
Seat 8: chch10 ($25.25 in chips) 
Seat 9: SaraFeeny ($5 in chips) 
chch10: posts small blind $0.10
SaraFeeny: posts big blind $0.25
*** HOLE CARDS ***
Dealt to Alameda22 [Ah 2h]
Alameda22: folds 
pickpocketb: folds 
Sep79: folds 
Dennisuitehv: raises $1 to $1.25
chch10: folds 
SaraFeeny: calls $1
*** FLOP *** [3c Tc Td]
SaraFeeny: checks 
Dennisuitehv: bets $1.75
SaraFeeny: raises $2 to $3.75 and is all-in
Dennisuitehv: calls $2
*** TURN *** [3c Tc Td] [Ks]
*** RIVER *** [3c Tc Td Ks] [5s]
*** SHOW DOWN ***
SaraFeeny: shows [Kd Ts] (a full house, Tens full of Kings)
Dennisuitehv: mucks hand 
SaraFeeny collected $9.60 from pot
*** SUMMARY ***
Total pot $10.10 | Rake $0.50 
Board [3c Tc Td Ks 5s]
Seat 2: Alameda22 folded before Flop (didn't bet)
Seat 3: pickpocketb folded before Flop (didn't bet)
Seat 5: Sep79 folded before Flop (didn't bet)
Seat 7: Dennisuitehv (button) mucked [9d 9c]
Seat 8: chch10 (small blind) folded before Flop
Seat 9: SaraFeeny (big blind) showed [Kd Ts] and won ($9.60) with a full house, Tens full of Kings



PokerStars Game #19898976171:  Hold'em No Limit ($0.10/$0.25) - 2008/08/25 - 20:25:34 (ET)
Table 'Pompeja II' 9-max Seat #8 is the button
Seat 2: Alameda22 ($27.45 in chips) 
Seat 3: pickpocketb ($53.10 in chips) 
Seat 5: Sep79 ($32.25 in chips) 
Seat 7: Dennisuitehv ($22.30 in chips) 
Seat 8: chch10 ($25.15 in chips) 
Seat 9: SaraFeeny ($9.60 in chips) 
SaraFeeny: posts small blind $0.10
Alameda22: posts big blind $0.25
*** HOLE CARDS ***
Dealt to Alameda22 [Ac Jd]
pickpocketb: folds 
Sep79: folds 
Dennisuitehv: folds 
chch10: raises $0.75 to $1
SaraFeeny: folds 
Alameda22: calls $0.75
*** FLOP *** [8c Td 2h]
SaraFeeny leaves the table
Alameda22: checks 
chch10: checks 
*** TURN *** [8c Td 2h] [8h]
Alameda22: bets $1.25
chch10: folds 
Uncalled bet ($1.25) returned to Alameda22
Alameda22 collected $2 from pot
Alameda22: doesn't show hand 
*** SUMMARY ***
Total pot $2.10 | Rake $0.10 
Board [8c Td 2h 8h]
Seat 2: Alameda22 (big blind) collected ($2)
Seat 3: pickpocketb folded before Flop (didn't bet)
Seat 5: Sep79 folded before Flop (didn't bet)
Seat 7: Dennisuitehv folded before Flop (didn't bet)
Seat 8: chch10 (button) folded on the Turn
Seat 9: SaraFeeny (small blind) folded before Flop



PokerStars Game #19898999543:  Hold'em No Limit ($0.10/$0.25) - 2008/08/25 - 20:26:34 (ET)
Table 'Pompeja II' 9-max Seat #2 is the button
Seat 2: Alameda22 ($28.45 in chips) 
Seat 3: pickpocketb ($53.10 in chips) 
Seat 5: Sep79 ($32.25 in chips) 
Seat 7: Dennisuitehv ($22.30 in chips) 
Seat 8: chch10 ($24.15 in chips) 
pickpocketb: posts small blind $0.10
Sep79: posts big blind $0.25
*** HOLE CARDS ***
Dealt to Alameda22 [Kd 9c]
Dennisuitehv: folds 
chch10: folds 
Alameda22: folds 
pickpocketb: folds 
Uncalled bet ($0.15) returned to Sep79
Sep79 collected $0.20 from pot
Sep79: doesn't show hand 
*** SUMMARY ***
Total pot $0.20 | Rake $0 
Seat 2: Alameda22 (button) folded before Flop (didn't bet)
Seat 3: pickpocketb (small blind) folded before Flop
Seat 5: Sep79 (big blind) collected ($0.20)
Seat 7: Dennisuitehv folded before Flop (didn't bet)
Seat 8: chch10 folded before Flop (didn't bet)



