PokerStars Game #20142278014:  Hold'em No Limit ($0.10/$0.25) - 2008/09/04 13:48:55 ET
Table 'Vesale II' 9-max Seat #5 is the button
Seat 1: 9Roy9 ($27.70 in chips) 
Seat 2: Surfside182 ($25.35 in chips) 
Seat 3: cruiseplanne ($10.30 in chips) 
Seat 4: gagefixer ($27.05 in chips) 
Seat 5: Flushboy21 ($8.05 in chips) 
Seat 6: f1rstplace ($25.45 in chips) 
Seat 7: Alameda22 ($25 in chips) 
Seat 8: Ramon47 ($24.65 in chips) 
Seat 9: drnal3x ($24.75 in chips) 
f1rstplace: posts small blind $0.10
Alameda22: posts big blind $0.25
*** HOLE CARDS ***
Dealt to Alameda22 [Js 3s]
Ramon47: folds 
drnal3x: folds 
9Roy9: calls $0.25
Surfside182: folds 
cruiseplanne: folds 
gagefixer: calls $0.25
Flushboy21: calls $0.25
f1rstplace: calls $0.15
Alameda22: checks 
*** FLOP *** [5d Qs Kc]
f1rstplace: checks 
Alameda22: checks 
9Roy9: bets $0.50
gagefixer: calls $0.50
Flushboy21: calls $0.50
f1rstplace: folds 
Alameda22: folds 
*** TURN *** [5d Qs Kc] [7d]
9Roy9: bets $0.50
gagefixer: calls $0.50
Flushboy21: calls $0.50
*** RIVER *** [5d Qs Kc 7d] [5s]
9Roy9: bets $0.50
gagefixer: calls $0.50
Flushboy21: calls $0.50
*** SHOW DOWN ***
9Roy9: shows [Kh Jc] (two pair, Kings and Fives)
gagefixer: mucks hand 
Flushboy21: mucks hand 
9Roy9 collected $5.50 from pot
*** SUMMARY ***
Total pot $5.75 | Rake $0.25 
Board [5d Qs Kc 7d 5s]
Seat 1: 9Roy9 showed [Kh Jc] and won ($5.50) with two pair, Kings and Fives
Seat 2: Surfside182 folded before Flop (didn't bet)
Seat 3: cruiseplanne folded before Flop (didn't bet)
Seat 4: gagefixer mucked [Qc Ts]
Seat 5: Flushboy21 (button) mucked [6c 6d]
Seat 6: f1rstplace (small blind) folded on the Flop
Seat 7: Alameda22 (big blind) folded on the Flop
Seat 8: Ramon47 folded before Flop (didn't bet)
Seat 9: drnal3x folded before Flop (didn't bet)



PokerStars Game #20142311015:  Hold'em No Limit ($0.10/$0.25) - 2008/09/04 13:50:16 ET
Table 'Vesale II' 9-max Seat #6 is the button
Seat 1: 9Roy9 ($31.45 in chips) 
Seat 2: Surfside182 ($25.35 in chips) 
Seat 3: cruiseplanne ($10.30 in chips) 
Seat 4: gagefixer ($25.30 in chips) 
Seat 5: Flushboy21 ($6.30 in chips) 
Seat 6: f1rstplace ($25.20 in chips) 
Seat 7: Alameda22 ($24.75 in chips) 
Seat 8: Ramon47 ($24.65 in chips) 
Seat 9: drnal3x ($24.75 in chips) 
Alameda22: posts small blind $0.10
Ramon47: posts big blind $0.25
*** HOLE CARDS ***
Dealt to Alameda22 [6h 4h]
drnal3x: folds 
9Roy9: folds 
Surfside182: folds 
cruiseplanne: calls $0.25
gagefixer: folds 
Flushboy21: folds 
f1rstplace: folds 
Alameda22: folds 
Ramon47: checks 
*** FLOP *** [7c Qd Ts]
Ramon47: checks 
cruiseplanne: checks 
*** TURN *** [7c Qd Ts] [Jc]
Ramon47: checks 
cruiseplanne: checks 
*** RIVER *** [7c Qd Ts Jc] [5c]
Ramon47: folds 
cruiseplanne collected $0.60 from pot
cruiseplanne: doesn't show hand 
*** SUMMARY ***
Total pot $0.60 | Rake $0 
Board [7c Qd Ts Jc 5c]
Seat 1: 9Roy9 folded before Flop (didn't bet)
Seat 2: Surfside182 folded before Flop (didn't bet)
Seat 3: cruiseplanne collected ($0.60)
Seat 4: gagefixer folded before Flop (didn't bet)
Seat 5: Flushboy21 folded before Flop (didn't bet)
Seat 6: f1rstplace (button) folded before Flop (didn't bet)
Seat 7: Alameda22 (small blind) folded before Flop
Seat 8: Ramon47 (big blind) folded on the River
Seat 9: drnal3x folded before Flop (didn't bet)



PokerStars Game #20142329150:  Hold'em No Limit ($0.10/$0.25) - 2008/09/04 13:51:00 ET
Table 'Vesale II' 9-max Seat #7 is the button
Seat 1: 9Roy9 ($31.45 in chips) 
Seat 2: Surfside182 ($25.35 in chips) 
Seat 3: cruiseplanne ($10.65 in chips) 
Seat 4: gagefixer ($25.30 in chips) 
Seat 5: Flushboy21 ($6.30 in chips) 
Seat 6: f1rstplace ($25.20 in chips) 
Seat 7: Alameda22 ($24.65 in chips) 
Seat 8: Ramon47 ($24.40 in chips) 
Seat 9: drnal3x ($24.75 in chips) 
Ramon47: posts small blind $0.10
drnal3x: posts big blind $0.25
*** HOLE CARDS ***
Dealt to Alameda22 [9d 6d]
9Roy9: folds 
Surfside182: folds 
cruiseplanne: calls $0.25
gagefixer: folds 
Flushboy21: folds 
f1rstplace: folds 
Alameda22: folds 
Ramon47: calls $0.15
drnal3x: checks 
*** FLOP *** [Qh Ah Qc]
Ramon47: checks 
drnal3x: checks 
cruiseplanne: bets $0.75
Ramon47: folds 
drnal3x: folds 
Uncalled bet ($0.75) returned to cruiseplanne
cruiseplanne collected $0.75 from pot
cruiseplanne: doesn't show hand 
*** SUMMARY ***
Total pot $0.75 | Rake $0 
Board [Qh Ah Qc]
Seat 1: 9Roy9 folded before Flop (didn't bet)
Seat 2: Surfside182 folded before Flop (didn't bet)
Seat 3: cruiseplanne collected ($0.75)
Seat 4: gagefixer folded before Flop (didn't bet)
Seat 5: Flushboy21 folded before Flop (didn't bet)
Seat 6: f1rstplace folded before Flop (didn't bet)
Seat 7: Alameda22 (button) folded before Flop (didn't bet)
Seat 8: Ramon47 (small blind) folded on the Flop
Seat 9: drnal3x (big blind) folded on the Flop



PokerStars Game #20142344090:  Hold'em No Limit ($0.10/$0.25) - 2008/09/04 13:51:37 ET
Table 'Vesale II' 9-max Seat #8 is the button
Seat 1: 9Roy9 ($31.45 in chips) 
Seat 2: Surfside182 ($25.35 in chips) 
Seat 3: cruiseplanne ($11.15 in chips) 
Seat 4: gagefixer ($25.30 in chips) 
Seat 5: Flushboy21 ($6.30 in chips) 
Seat 6: f1rstplace ($25.20 in chips) 
Seat 7: Alameda22 ($24.65 in chips) 
Seat 8: Ramon47 ($24.15 in chips) 
Seat 9: drnal3x ($24.50 in chips) 
drnal3x: posts small blind $0.10
9Roy9: posts big blind $0.25
*** HOLE CARDS ***
Dealt to Alameda22 [Qs 5h]
Surfside182: folds 
cruiseplanne: folds 
gagefixer: folds 
Flushboy21: raises $0.25 to $0.50
f1rstplace: folds 
Alameda22: folds 
Ramon47: folds 
drnal3x: calls $0.40
9Roy9: folds 
*** FLOP *** [Jd 7d 2d]
drnal3x: checks 
Flushboy21: bets $2
drnal3x: folds 
Uncalled bet ($2) returned to Flushboy21
Flushboy21 collected $1.20 from pot
Flushboy21: shows [Ad Kh] (high card Ace)
*** SUMMARY ***
Total pot $1.25 | Rake $0.05 
Board [Jd 7d 2d]
Seat 1: 9Roy9 (big blind) folded before Flop
Seat 2: Surfside182 folded before Flop (didn't bet)
Seat 3: cruiseplanne folded before Flop (didn't bet)
Seat 4: gagefixer folded before Flop (didn't bet)
Seat 5: Flushboy21 collected ($1.20)
Seat 6: f1rstplace folded before Flop (didn't bet)
Seat 7: Alameda22 folded before Flop (didn't bet)
Seat 8: Ramon47 (button) folded before Flop (didn't bet)
Seat 9: drnal3x (small blind) folded on the Flop



PokerStars Game #20142370810:  Hold'em No Limit ($0.10/$0.25) - 2008/09/04 13:52:43 ET
Table 'Vesale II' 9-max Seat #9 is the button
Seat 1: 9Roy9 ($31.20 in chips) 
Seat 2: Surfside182 ($25.35 in chips) 
Seat 3: cruiseplanne ($11.15 in chips) 
Seat 4: gagefixer ($25.30 in chips) 
Seat 5: Flushboy21 ($7 in chips) 
Seat 6: f1rstplace ($25.20 in chips) 
Seat 7: Alameda22 ($24.65 in chips) 
Seat 8: Ramon47 ($24.15 in chips) 
Seat 9: drnal3x ($24 in chips) 
9Roy9: posts small blind $0.10
Surfside182: posts big blind $0.25
*** HOLE CARDS ***
Dealt to Alameda22 [9h 3h]
cruiseplanne: folds 
gagefixer: folds 
Flushboy21: calls $0.25
f1rstplace: folds 
Alameda22: folds 
Ramon47: raises $1 to $1.25
drnal3x: folds 
9Roy9: folds 
Surfside182: folds 
Flushboy21: calls $1
*** FLOP *** [Tc Kh 3s]
Flushboy21: checks 
Ramon47: bets $1.50
Flushboy21: folds 
Uncalled bet ($1.50) returned to Ramon47
Ramon47 collected $2.75 from pot
Ramon47: doesn't show hand 
*** SUMMARY ***
Total pot $2.85 | Rake $0.10 
Board [Tc Kh 3s]
Seat 1: 9Roy9 (small blind) folded before Flop
Seat 2: Surfside182 (big blind) folded before Flop
Seat 3: cruiseplanne folded before Flop (didn't bet)
Seat 4: gagefixer folded before Flop (didn't bet)
Seat 5: Flushboy21 folded on the Flop
Seat 6: f1rstplace folded before Flop (didn't bet)
Seat 7: Alameda22 folded before Flop (didn't bet)
Seat 8: Ramon47 collected ($2.75)
Seat 9: drnal3x (button) folded before Flop (didn't bet)



PokerStars Game #20142390647:  Hold'em No Limit ($0.10/$0.25) - 2008/09/04 13:53:33 ET
Table 'Vesale II' 9-max Seat #1 is the button
Seat 1: 9Roy9 ($31.10 in chips) 
Seat 2: Surfside182 ($25.10 in chips) 
Seat 3: cruiseplanne ($11.15 in chips) 
Seat 4: gagefixer ($25.30 in chips) 
Seat 5: Flushboy21 ($5.75 in chips) 
Seat 6: f1rstplace ($25.20 in chips) 
Seat 7: Alameda22 ($24.65 in chips) 
Seat 8: Ramon47 ($25.65 in chips) 
Seat 9: drnal3x ($24 in chips) 
Surfside182: posts small blind $0.10
cruiseplanne: posts big blind $0.25
*** HOLE CARDS ***
Dealt to Alameda22 [5h 3c]
gagefixer: calls $0.25
Flushboy21: folds 
f1rstplace: folds 
Alameda22: folds 
Ramon47: calls $0.25
drnal3x: folds 
9Roy9: folds 
Surfside182: folds 
cruiseplanne: checks 
*** FLOP *** [Td 9s Js]
cruiseplanne: checks 
gagefixer: checks 
Ramon47: bets $0.50
cruiseplanne: calls $0.50
gagefixer: calls $0.50
*** TURN *** [Td 9s Js] [5c]
cruiseplanne: checks 
gagefixer: checks 
Ramon47: bets $1
cruiseplanne: raises $1 to $2
gagefixer: folds 
Ramon47: calls $1
*** RIVER *** [Td 9s Js 5c] [4c]
cruiseplanne: bets $3
Ramon47: folds 
Uncalled bet ($3) returned to cruiseplanne
cruiseplanne collected $6.05 from pot
cruiseplanne: doesn't show hand 
*** SUMMARY ***
Total pot $6.35 | Rake $0.30 
Board [Td 9s Js 5c 4c]
Seat 1: 9Roy9 (button) folded before Flop (didn't bet)
Seat 2: Surfside182 (small blind) folded before Flop
Seat 3: cruiseplanne (big blind) collected ($6.05)
Seat 4: gagefixer folded on the Turn
Seat 5: Flushboy21 folded before Flop (didn't bet)
Seat 6: f1rstplace folded before Flop (didn't bet)
Seat 7: Alameda22 folded before Flop (didn't bet)
Seat 8: Ramon47 folded on the River
Seat 9: drnal3x folded before Flop (didn't bet)



PokerStars Game #20142424226:  Hold'em No Limit ($0.10/$0.25) - 2008/09/04 13:54:57 ET
Table 'Vesale II' 9-max Seat #2 is the button
Seat 1: 9Roy9 ($31.10 in chips) 
Seat 2: Surfside182 ($25 in chips) 
Seat 3: cruiseplanne ($14.45 in chips) 
Seat 4: gagefixer ($24.55 in chips) 
Seat 5: Flushboy21 ($5.75 in chips) 
Seat 6: f1rstplace ($25.20 in chips) 
Seat 7: Alameda22 ($24.65 in chips) 
Seat 8: Ramon47 ($22.90 in chips) 
Seat 9: drnal3x ($24 in chips) 
cruiseplanne: posts small blind $0.10
gagefixer: posts big blind $0.25
*** HOLE CARDS ***
Dealt to Alameda22 [Qh 5c]
Flushboy21: folds 
f1rstplace: folds 
Alameda22: folds 
Ramon47: folds 
drnal3x: folds 
9Roy9: folds 
Surfside182: folds 
cruiseplanne: calls $0.15
gagefixer: checks 
*** FLOP *** [Ac Tc Ts]
cruiseplanne: checks 
gagefixer: checks 
*** TURN *** [Ac Tc Ts] [Td]
cruiseplanne: bets $0.50
gagefixer: calls $0.50
*** RIVER *** [Ac Tc Ts Td] [9h]
cruiseplanne: checks 
gagefixer: bets $0.75
cruiseplanne: calls $0.75
*** SHOW DOWN ***
gagefixer: shows [9d As] (a full house, Tens full of Aces)
cruiseplanne: mucks hand 
gagefixer collected $2.90 from pot
cruiseplanne said, "nh"
*** SUMMARY ***
Total pot $3 | Rake $0.10 
Board [Ac Tc Ts Td 9h]
Seat 1: 9Roy9 folded before Flop (didn't bet)
Seat 2: Surfside182 (button) folded before Flop (didn't bet)
Seat 3: cruiseplanne (small blind) mucked [3c 3d]
Seat 4: gagefixer (big blind) showed [9d As] and won ($2.90) with a full house, Tens full of Aces
Seat 5: Flushboy21 folded before Flop (didn't bet)
Seat 6: f1rstplace folded before Flop (didn't bet)
Seat 7: Alameda22 folded before Flop (didn't bet)
Seat 8: Ramon47 folded before Flop (didn't bet)
Seat 9: drnal3x folded before Flop (didn't bet)



PokerStars Game #20142444883:  Hold'em No Limit ($0.10/$0.25) - 2008/09/04 13:55:52 ET
Table 'Vesale II' 9-max Seat #3 is the button
Seat 1: 9Roy9 ($31.10 in chips) 
Seat 2: Surfside182 ($25 in chips) 
Seat 3: cruiseplanne ($12.95 in chips) 
Seat 4: gagefixer ($25.95 in chips) 
Seat 5: Flushboy21 ($5.75 in chips) 
Seat 6: f1rstplace ($25.20 in chips) 
Seat 7: Alameda22 ($24.65 in chips) 
Seat 8: Ramon47 ($22.90 in chips) 
Seat 9: drnal3x ($24 in chips) 
gagefixer: posts small blind $0.10
Flushboy21: posts big blind $0.25
*** HOLE CARDS ***
Dealt to Alameda22 [8h 4s]
gagefixer said, "ty"
f1rstplace: folds 
Alameda22: folds 
cruiseplanne said, "33"
gagefixer said, "ahh"
Ramon47 is disconnected 
Ramon47 is connected 
Ramon47: folds 
drnal3x: folds 
9Roy9: folds 
gagefixer said, "i would call too"
Surfside182: calls $0.25
cruiseplanne: folds 
gagefixer: calls $0.15
Flushboy21: checks 
*** FLOP *** [6h 9d As]
gagefixer: checks 
Flushboy21: checks 
Surfside182: checks 
*** TURN *** [6h 9d As] [5d]
gagefixer: checks 
Flushboy21: checks 
Surfside182: bets $0.75
gagefixer: folds 
Flushboy21: folds 
Uncalled bet ($0.75) returned to Surfside182
Surfside182 collected $0.75 from pot
Surfside182: doesn't show hand 
*** SUMMARY ***
Total pot $0.75 | Rake $0 
Board [6h 9d As 5d]
Seat 1: 9Roy9 folded before Flop (didn't bet)
Seat 2: Surfside182 collected ($0.75)
Seat 3: cruiseplanne (button) folded before Flop (didn't bet)
Seat 4: gagefixer (small blind) folded on the Turn
Seat 5: Flushboy21 (big blind) folded on the Turn
Seat 6: f1rstplace folded before Flop (didn't bet)
Seat 7: Alameda22 folded before Flop (didn't bet)
Seat 8: Ramon47 folded before Flop (didn't bet)
Seat 9: drnal3x folded before Flop (didn't bet)



PokerStars Game #20142469717:  Hold'em No Limit ($0.10/$0.25) - 2008/09/04 13:56:56 ET
Table 'Vesale II' 9-max Seat #4 is the button
Seat 1: 9Roy9 ($31.10 in chips) 
Seat 2: Surfside182 ($25.50 in chips) 
Seat 3: cruiseplanne ($12.95 in chips) 
Seat 4: gagefixer ($25.70 in chips) 
Seat 5: Flushboy21 ($5.50 in chips) 
Seat 6: f1rstplace ($25.20 in chips) 
Seat 7: Alameda22 ($24.65 in chips) 
Seat 8: Ramon47 ($22.90 in chips) 
Seat 9: drnal3x ($24 in chips) 
Flushboy21: posts small blind $0.10
f1rstplace: posts big blind $0.25
*** HOLE CARDS ***
Dealt to Alameda22 [4h 9c]
Alameda22: folds 
Ramon47: raises $0.50 to $0.75
drnal3x: folds 
9Roy9: folds 
Surfside182: folds 
cruiseplanne: folds 
gagefixer: calls $0.75
Flushboy21: calls $0.65
f1rstplace: folds 
*** FLOP *** [5c 9s 8d]
Flushboy21: checks 
Ramon47: bets $1.50
gagefixer: folds 
Flushboy21: folds 
Uncalled bet ($1.50) returned to Ramon47
Ramon47 collected $2.40 from pot
Ramon47: doesn't show hand 
*** SUMMARY ***
Total pot $2.50 | Rake $0.10 
Board [5c 9s 8d]
Seat 1: 9Roy9 folded before Flop (didn't bet)
Seat 2: Surfside182 folded before Flop (didn't bet)
Seat 3: cruiseplanne folded before Flop (didn't bet)
Seat 4: gagefixer (button) folded on the Flop
Seat 5: Flushboy21 (small blind) folded on the Flop
Seat 6: f1rstplace (big blind) folded before Flop
Seat 7: Alameda22 folded before Flop (didn't bet)
Seat 8: Ramon47 collected ($2.40)
Seat 9: drnal3x folded before Flop (didn't bet)



PokerStars Game #20142489621:  Hold'em No Limit ($0.10/$0.25) - 2008/09/04 13:57:46 ET
Table 'Vesale II' 9-max Seat #5 is the button
Seat 1: 9Roy9 ($31.10 in chips) 
Seat 2: Surfside182 ($25.50 in chips) 
Seat 3: cruiseplanne ($12.95 in chips) 
Seat 4: gagefixer ($24.95 in chips) 
Seat 5: Flushboy21 ($4.75 in chips) 
Seat 6: f1rstplace ($24.95 in chips) 
Seat 7: Alameda22 ($24.65 in chips) 
Seat 8: Ramon47 ($24.55 in chips) 
Seat 9: drnal3x ($24 in chips) 
f1rstplace: posts small blind $0.10
Alameda22: posts big blind $0.25
*** HOLE CARDS ***
Dealt to Alameda22 [4d 4h]
Ramon47: folds 
drnal3x: folds 
9Roy9: folds 
Surfside182: calls $0.25
cruiseplanne: folds 
gagefixer: calls $0.25
Flushboy21: calls $0.25
f1rstplace: folds 
Alameda22: checks 
*** FLOP *** [9d 2s 5c]
Alameda22: checks 
Surfside182: bets $1
gagefixer: folds 
Flushboy21: folds 
Alameda22: folds 
Uncalled bet ($1) returned to Surfside182
Surfside182 collected $1.05 from pot
Surfside182: doesn't show hand 
*** SUMMARY ***
Total pot $1.10 | Rake $0.05 
Board [9d 2s 5c]
Seat 1: 9Roy9 folded before Flop (didn't bet)
Seat 2: Surfside182 collected ($1.05)
Seat 3: cruiseplanne folded before Flop (didn't bet)
Seat 4: gagefixer folded on the Flop
Seat 5: Flushboy21 (button) folded on the Flop
Seat 6: f1rstplace (small blind) folded before Flop
Seat 7: Alameda22 (big blind) folded on the Flop
Seat 8: Ramon47 folded before Flop (didn't bet)
Seat 9: drnal3x folded before Flop (didn't bet)



PokerStars Game #20142512436:  Hold'em No Limit ($0.10/$0.25) - 2008/09/04 13:58:43 ET
Table 'Vesale II' 9-max Seat #6 is the button
Seat 1: 9Roy9 ($31.10 in chips) 
Seat 2: Surfside182 ($26.30 in chips) 
Seat 3: cruiseplanne ($12.95 in chips) 
Seat 4: gagefixer ($24.70 in chips) 
Seat 5: Flushboy21 ($4.50 in chips) 
Seat 6: f1rstplace ($24.85 in chips) 
Seat 7: Alameda22 ($24.40 in chips) 
Seat 8: Ramon47 ($24.55 in chips) 
Seat 9: drnal3x ($24 in chips) 
Alameda22: posts small blind $0.10
Ramon47: posts big blind $0.25
*** HOLE CARDS ***
Dealt to Alameda22 [Jh 6h]
drnal3x: calls $0.25
9Roy9: folds 
Surfside182: folds 
cruiseplanne: folds 
gagefixer: folds 
Flushboy21: calls $0.25
f1rstplace: folds 
Alameda22: folds 
Ramon47: checks 
*** FLOP *** [Ad Js Jc]
Ramon47: checks 
drnal3x: checks 
Flushboy21: bets $1
Ramon47: folds 
drnal3x: folds 
Uncalled bet ($1) returned to Flushboy21
Flushboy21 collected $0.85 from pot
Flushboy21: doesn't show hand 
*** SUMMARY ***
Total pot $0.85 | Rake $0 
Board [Ad Js Jc]
Seat 1: 9Roy9 folded before Flop (didn't bet)
Seat 2: Surfside182 folded before Flop (didn't bet)
Seat 3: cruiseplanne folded before Flop (didn't bet)
Seat 4: gagefixer folded before Flop (didn't bet)
Seat 5: Flushboy21 collected ($0.85)
Seat 6: f1rstplace (button) folded before Flop (didn't bet)
Seat 7: Alameda22 (small blind) folded before Flop
Seat 8: Ramon47 (big blind) folded on the Flop
Seat 9: drnal3x folded on the Flop



PokerStars Game #20142532352:  Hold'em No Limit ($0.10/$0.25) - 2008/09/04 13:59:34 ET
Table 'Vesale II' 9-max Seat #7 is the button
Seat 1: 9Roy9 ($31.10 in chips) 
Seat 2: Surfside182 ($26.30 in chips) 
Seat 3: cruiseplanne ($12.95 in chips) 
Seat 4: gagefixer ($24.70 in chips) 
Seat 5: Flushboy21 ($5.10 in chips) 
Seat 6: f1rstplace ($24.85 in chips) 
Seat 7: Alameda22 ($24.30 in chips) 
Seat 8: Ramon47 ($24.30 in chips) 
Seat 9: drnal3x ($23.75 in chips) 
Ramon47: posts small blind $0.10
drnal3x: posts big blind $0.25
*** HOLE CARDS ***
Dealt to Alameda22 [Ah As]
Flushboy21 said, "-*/+"
9Roy9: folds 
Surfside182: folds 
9Roy9 is sitting out
cruiseplanne: folds 
gagefixer: folds 
Flushboy21: folds 
f1rstplace: folds 
9Roy9 leaves the table
Alameda22: raises $0.75 to $1
Ramon47: folds 
drnal3x: folds 
Uncalled bet ($0.75) returned to Alameda22
Alameda22 collected $0.60 from pot
Alameda22: doesn't show hand 
Cardgrrl joins the table at seat #1 
*** SUMMARY ***
Total pot $0.60 | Rake $0 
Seat 1: 9Roy9 folded before Flop (didn't bet)
Seat 2: Surfside182 folded before Flop (didn't bet)
Seat 3: cruiseplanne folded before Flop (didn't bet)
Seat 4: gagefixer folded before Flop (didn't bet)
Seat 5: Flushboy21 folded before Flop (didn't bet)
Seat 6: f1rstplace folded before Flop (didn't bet)
Seat 7: Alameda22 (button) collected ($0.60)
Seat 8: Ramon47 (small blind) folded before Flop
Seat 9: drnal3x (big blind) folded before Flop



PokerStars Game #20142545434:  Hold'em No Limit ($0.10/$0.25) - 2008/09/04 14:00:06 ET
Table 'Vesale II' 9-max Seat #8 is the button
Seat 2: Surfside182 ($26.30 in chips) 
Seat 3: cruiseplanne ($12.95 in chips) 
Seat 4: gagefixer ($24.70 in chips) 
Seat 5: Flushboy21 ($5.10 in chips) 
Seat 6: f1rstplace ($24.85 in chips) 
Seat 7: Alameda22 ($24.65 in chips) 
Seat 8: Ramon47 ($24.20 in chips) 
Seat 9: drnal3x ($23.50 in chips) 
drnal3x: posts small blind $0.10
Cardgrrl has timed out
Cardgrrl: is sitting out 
Surfside182: posts big blind $0.25
*** HOLE CARDS ***
Dealt to Alameda22 [2c 3c]
Cardgrrl has returned
cruiseplanne: folds 
gagefixer: folds 
Flushboy21: folds 
f1rstplace: folds 
Alameda22: folds 
Ramon47: folds 
drnal3x: calls $0.15
Surfside182: checks 
*** FLOP *** [As Qc 4s]
drnal3x: checks 
Surfside182: checks 
*** TURN *** [As Qc 4s] [8c]
drnal3x: checks 
Surfside182: checks 
*** RIVER *** [As Qc 4s 8c] [7c]
drnal3x: bets $0.25
Surfside182: folds 
Uncalled bet ($0.25) returned to drnal3x
drnal3x collected $0.50 from pot
drnal3x: doesn't show hand 
*** SUMMARY ***
Total pot $0.50 | Rake $0 
Board [As Qc 4s 8c 7c]
Seat 2: Surfside182 (big blind) folded on the River
Seat 3: cruiseplanne folded before Flop (didn't bet)
Seat 4: gagefixer folded before Flop (didn't bet)
Seat 5: Flushboy21 folded before Flop (didn't bet)
Seat 6: f1rstplace folded before Flop (didn't bet)
Seat 7: Alameda22 folded before Flop (didn't bet)
Seat 8: Ramon47 (button) folded before Flop (didn't bet)
Seat 9: drnal3x (small blind) collected ($0.50)



PokerStars Game #20142579500:  Hold'em No Limit ($0.10/$0.25) - 2008/09/04 14:01:30 ET
Table 'Vesale II' 9-max Seat #9 is the button
Seat 2: Surfside182 ($26.05 in chips) 
Seat 3: cruiseplanne ($12.95 in chips) 
Seat 4: gagefixer ($24.70 in chips) 
Seat 5: Flushboy21 ($5.10 in chips) 
Seat 6: f1rstplace ($24.85 in chips) 
Seat 7: Alameda22 ($24.65 in chips) 
Seat 8: Ramon47 ($24.20 in chips) 
Seat 9: drnal3x ($23.75 in chips) 
Cardgrrl will be allowed to play after the button
Surfside182: posts small blind $0.10
cruiseplanne: posts big blind $0.25
*** HOLE CARDS ***
Dealt to Alameda22 [7d 7h]
gagefixer: folds 
Flushboy21: raises $0.25 to $0.50
f1rstplace: calls $0.50
Alameda22: calls $0.50
Ramon47: folds 
drnal3x: folds 
Surfside182: folds 
cruiseplanne: folds 
*** FLOP *** [9c 9d Ks]
Flushboy21: checks 
f1rstplace: checks 
Alameda22: bets $1.25
Flushboy21: calls $1.25
f1rstplace: calls $1.25
*** TURN *** [9c 9d Ks] [3d]
Flushboy21: checks 
f1rstplace: checks 
Alameda22: checks 
*** RIVER *** [9c 9d Ks 3d] [8s]
Flushboy21: bets $2.50
f1rstplace: raises $2.50 to $5
Alameda22: folds 
Flushboy21: calls $0.85 and is all-in
Uncalled bet ($1.65) returned to f1rstplace
*** SHOW DOWN ***
f1rstplace: shows [Qh Kh] (two pair, Kings and Nines)
Flushboy21: shows [9s Qs] (three of a kind, Nines)
Flushboy21 collected $11.70 from pot
*** SUMMARY ***
Total pot $12.30 | Rake $0.60 
Board [9c 9d Ks 3d 8s]
Seat 2: Surfside182 (small blind) folded before Flop
Seat 3: cruiseplanne (big blind) folded before Flop
Seat 4: gagefixer folded before Flop (didn't bet)
Seat 5: Flushboy21 showed [9s Qs] and won ($11.70) with three of a kind, Nines
Seat 6: f1rstplace showed [Qh Kh] and lost with two pair, Kings and Nines
Seat 7: Alameda22 folded on the River
Seat 8: Ramon47 folded before Flop (didn't bet)
Seat 9: drnal3x (button) folded before Flop (didn't bet)



PokerStars Game #20142626179:  Hold'em No Limit ($0.10/$0.25) - 2008/09/04 14:03:26 ET
Table 'Vesale II' 9-max Seat #2 is the button
Seat 1: Cardgrrl ($15 in chips) 
Seat 2: Surfside182 ($25.95 in chips) 
Seat 3: cruiseplanne ($12.70 in chips) 
Seat 4: gagefixer ($24.70 in chips) 
Seat 5: Flushboy21 ($11.70 in chips) 
Seat 6: f1rstplace ($19.75 in chips) 
Seat 7: Alameda22 ($22.90 in chips) 
Seat 8: Ramon47 ($24.20 in chips) 
Seat 9: drnal3x ($23.75 in chips) 
cruiseplanne: posts small blind $0.10
gagefixer: posts big blind $0.25
Cardgrrl: posts big blind $0.25
*** HOLE CARDS ***
Dealt to Alameda22 [Kc 7d]
Flushboy21: folds 
f1rstplace: folds 
Alameda22: folds 
Ramon47: raises $1 to $1.25
drnal3x: calls $1.25
Cardgrrl: folds 
Surfside182: folds 
cruiseplanne: folds 
gagefixer: folds 
*** FLOP *** [6c 9d 7s]
Ramon47: bets $2
drnal3x: folds 
Uncalled bet ($2) returned to Ramon47
Ramon47 collected $2.95 from pot
Ramon47: doesn't show hand 
*** SUMMARY ***
Total pot $3.10 | Rake $0.15 
Board [6c 9d 7s]
Seat 1: Cardgrrl folded before Flop
Seat 2: Surfside182 (button) folded before Flop (didn't bet)
Seat 3: cruiseplanne (small blind) folded before Flop
Seat 4: gagefixer (big blind) folded before Flop
Seat 5: Flushboy21 folded before Flop (didn't bet)
Seat 6: f1rstplace folded before Flop (didn't bet)
Seat 7: Alameda22 folded before Flop (didn't bet)
Seat 8: Ramon47 collected ($2.95)
Seat 9: drnal3x folded on the Flop



PokerStars Game #20142646344:  Hold'em No Limit ($0.10/$0.25) - 2008/09/04 14:04:14 ET
Table 'Vesale II' 9-max Seat #3 is the button
Seat 1: Cardgrrl ($14.75 in chips) 
Seat 2: Surfside182 ($25.95 in chips) 
Seat 3: cruiseplanne ($12.60 in chips) 
Seat 4: gagefixer ($24.45 in chips) 
Seat 5: Flushboy21 ($11.70 in chips) 
Seat 6: f1rstplace ($25 in chips) 
Seat 7: Alameda22 ($22.90 in chips) 
Seat 8: Ramon47 ($25.90 in chips) 
Seat 9: drnal3x ($22.50 in chips) 
gagefixer: posts small blind $0.10
Flushboy21: posts big blind $0.25
*** HOLE CARDS ***
Dealt to Alameda22 [5h Kd]
f1rstplace: folds 
Alameda22: folds 
Ramon47: folds 
drnal3x: folds 
Cardgrrl: folds 
Surfside182: folds 
cruiseplanne: folds 
gagefixer: calls $0.15
Flushboy21: checks 
*** FLOP *** [Ts 3s 8h]
gagefixer: checks 
Flushboy21: bets $0.50
gagefixer: calls $0.50
*** TURN *** [Ts 3s 8h] [6h]
gagefixer: checks 
Flushboy21: bets $0.50
gagefixer: calls $0.50
*** RIVER *** [Ts 3s 8h 6h] [Td]
gagefixer: checks 
Flushboy21: bets $1
gagefixer: folds 
Uncalled bet ($1) returned to Flushboy21
Flushboy21 collected $2.40 from pot
Flushboy21: doesn't show hand 
*** SUMMARY ***
Total pot $2.50 | Rake $0.10 
Board [Ts 3s 8h 6h Td]
Seat 1: Cardgrrl folded before Flop (didn't bet)
Seat 2: Surfside182 folded before Flop (didn't bet)
Seat 3: cruiseplanne (button) folded before Flop (didn't bet)
Seat 4: gagefixer (small blind) folded on the River
Seat 5: Flushboy21 (big blind) collected ($2.40)
Seat 6: f1rstplace folded before Flop (didn't bet)
Seat 7: Alameda22 folded before Flop (didn't bet)
Seat 8: Ramon47 folded before Flop (didn't bet)
Seat 9: drnal3x folded before Flop (didn't bet)



PokerStars Game #20142667370:  Hold'em No Limit ($0.10/$0.25) - 2008/09/04 14:05:05 ET
Table 'Vesale II' 9-max Seat #4 is the button
Seat 1: Cardgrrl ($14.75 in chips) 
Seat 2: Surfside182 ($25.95 in chips) 
Seat 3: cruiseplanne ($12.60 in chips) 
Seat 4: gagefixer ($23.20 in chips) 
Seat 5: Flushboy21 ($12.85 in chips) 
Seat 7: Alameda22 ($22.90 in chips) 
Seat 8: Ramon47 ($25.90 in chips) 
Seat 9: drnal3x ($22.50 in chips) 
Flushboy21: posts small blind $0.10
f1rstplace: is sitting out 
Alameda22: posts big blind $0.25
*** HOLE CARDS ***
Dealt to Alameda22 [Qh 2s]
f1rstplace leaves the table
Ramon47: folds 
drnal3x: folds 
Cardgrrl: folds 
Surfside182: folds 
cruiseplanne: folds 
gagefixer: calls $0.25
Flushboy21: folds 
Alameda22: checks 
*** FLOP *** [5c 4d Qc]
Alameda22: checks 
gagefixer: checks 
*** TURN *** [5c 4d Qc] [Jc]
Alameda22: bets $0.25
gagefixer: folds 
Uncalled bet ($0.25) returned to Alameda22
Alameda22 collected $0.60 from pot
Alameda22: doesn't show hand 
*** SUMMARY ***
Total pot $0.60 | Rake $0 
Board [5c 4d Qc Jc]
Seat 1: Cardgrrl folded before Flop (didn't bet)
Seat 2: Surfside182 folded before Flop (didn't bet)
Seat 3: cruiseplanne folded before Flop (didn't bet)
Seat 4: gagefixer (button) folded on the Turn
Seat 5: Flushboy21 (small blind) folded before Flop
Seat 7: Alameda22 (big blind) collected ($0.60)
Seat 8: Ramon47 folded before Flop (didn't bet)
Seat 9: drnal3x folded before Flop (didn't bet)



PokerStars Game #20142684809:  Hold'em No Limit ($0.10/$0.25) - 2008/09/04 14:05:47 ET
Table 'Vesale II' 9-max Seat #5 is the button
Seat 1: Cardgrrl ($14.75 in chips) 
Seat 2: Surfside182 ($25.95 in chips) 
Seat 3: cruiseplanne ($12.60 in chips) 
Seat 4: gagefixer ($22.95 in chips) 
Seat 5: Flushboy21 ($12.75 in chips) 
Seat 7: Alameda22 ($23.25 in chips) 
Seat 8: Ramon47 ($25.90 in chips) 
Seat 9: drnal3x ($22.50 in chips) 
Alameda22: posts small blind $0.10
Ramon47: posts big blind $0.25
*** HOLE CARDS ***
Dealt to Alameda22 [Th 6d]
drnal3x: folds 
Cardgrrl: folds 
Surfside182: folds 
cruiseplanne: folds 
gagefixer: folds 
drnal3x leaves the table
Flushboy21: folds 
Alameda22: folds 
Uncalled bet ($0.15) returned to Ramon47
Ramon47 collected $0.20 from pot
Ramon47: doesn't show hand 
*** SUMMARY ***
Total pot $0.20 | Rake $0 
Seat 1: Cardgrrl folded before Flop (didn't bet)
Seat 2: Surfside182 folded before Flop (didn't bet)
Seat 3: cruiseplanne folded before Flop (didn't bet)
Seat 4: gagefixer folded before Flop (didn't bet)
Seat 5: Flushboy21 (button) folded before Flop (didn't bet)
Seat 7: Alameda22 (small blind) folded before Flop
Seat 8: Ramon47 (big blind) collected ($0.20)
Seat 9: drnal3x folded before Flop (didn't bet)



PokerStars Game #20142694491:  Hold'em No Limit ($0.10/$0.25) - 2008/09/04 14:06:11 ET
Table 'Vesale II' 9-max Seat #7 is the button
Seat 1: Cardgrrl ($14.75 in chips) 
Seat 2: Surfside182 ($25.95 in chips) 
Seat 3: cruiseplanne ($12.60 in chips) 
Seat 4: gagefixer ($22.95 in chips) 
Seat 5: Flushboy21 ($12.75 in chips) 
Seat 7: Alameda22 ($23.15 in chips) 
Seat 8: Ramon47 ($26 in chips) 
Ramon47: posts small blind $0.10
Cardgrrl: posts big blind $0.25
*** HOLE CARDS ***
Dealt to Alameda22 [Kh 5h]
Surfside182: raises $0.75 to $1
cruiseplanne: folds 
gagefixer: folds 
Flushboy21: folds 
Flushboy21 leaves the table
Alameda22: folds 
Ramon47: folds 
Cardgrrl: folds 
Uncalled bet ($0.75) returned to Surfside182
Surfside182 collected $0.60 from pot
Surfside182: doesn't show hand 
*** SUMMARY ***
Total pot $0.60 | Rake $0 
Seat 1: Cardgrrl (big blind) folded before Flop
Seat 2: Surfside182 collected ($0.60)
Seat 3: cruiseplanne folded before Flop (didn't bet)
Seat 4: gagefixer folded before Flop (didn't bet)
Seat 5: Flushboy21 folded before Flop (didn't bet)
Seat 7: Alameda22 (button) folded before Flop (didn't bet)
Seat 8: Ramon47 (small blind) folded before Flop



PokerStars Game #20142704384:  Hold'em No Limit ($0.10/$0.25) - 2008/09/04 14:06:34 ET
Table 'Vesale II' 9-max Seat #8 is the button
Seat 1: Cardgrrl ($14.50 in chips) 
Seat 2: Surfside182 ($26.30 in chips) 
Seat 3: cruiseplanne ($12.60 in chips) 
Seat 4: gagefixer ($22.95 in chips) 
Seat 7: Alameda22 ($23.15 in chips) 
Seat 8: Ramon47 ($25.90 in chips) 
Cardgrrl: posts small blind $0.10
Surfside182: posts big blind $0.25
*** HOLE CARDS ***
Dealt to Alameda22 [5h Ah]
cruiseplanne: folds 
gagefixer: folds 
cruiseplanne is sitting out
cruiseplanne leaves the table
Alameda22: folds 
Ramon47: folds 
Cardgrrl: raises $0.50 to $0.75
Surfside182: folds 
Uncalled bet ($0.50) returned to Cardgrrl
Cardgrrl collected $0.50 from pot
Cardgrrl: doesn't show hand 
*** SUMMARY ***
Total pot $0.50 | Rake $0 
Seat 1: Cardgrrl (small blind) collected ($0.50)
Seat 2: Surfside182 (big blind) folded before Flop
Seat 3: cruiseplanne folded before Flop (didn't bet)
Seat 4: gagefixer folded before Flop (didn't bet)
Seat 7: Alameda22 folded before Flop (didn't bet)
Seat 8: Ramon47 (button) folded before Flop (didn't bet)



PokerStars Game #20142716402:  Hold'em No Limit ($0.10/$0.25) - 2008/09/04 14:07:04 ET
Table 'Vesale II' 9-max Seat #1 is the button
Seat 1: Cardgrrl ($14.75 in chips) 
Seat 2: Surfside182 ($26.05 in chips) 
Seat 4: gagefixer ($22.95 in chips) 
Seat 7: Alameda22 ($23.15 in chips) 
Seat 8: Ramon47 ($25.90 in chips) 
Surfside182: posts small blind $0.10
gagefixer: posts big blind $0.25
*** HOLE CARDS ***
Dealt to Alameda22 [Jh Kd]
Alameda22: folds 
Ramon47: folds 
Cardgrrl: folds 
Surfside182: folds 
Uncalled bet ($0.15) returned to gagefixer
gagefixer collected $0.20 from pot
gagefixer: doesn't show hand 
*** SUMMARY ***
Total pot $0.20 | Rake $0 
Seat 1: Cardgrrl (button) folded before Flop (didn't bet)
Seat 2: Surfside182 (small blind) folded before Flop
Seat 4: gagefixer (big blind) collected ($0.20)
Seat 7: Alameda22 folded before Flop (didn't bet)
Seat 8: Ramon47 folded before Flop (didn't bet)



PokerStars Game #20142728341:  Hold'em No Limit ($0.10/$0.25) - 2008/09/04 14:07:32 ET
Table 'Vesale II' 9-max Seat #2 is the button
Seat 1: Cardgrrl ($14.75 in chips) 
Seat 2: Surfside182 ($25.95 in chips) 
Seat 4: gagefixer ($23.05 in chips) 
Seat 7: Alameda22 ($23.15 in chips) 
Seat 8: Ramon47 ($25.90 in chips) 
gagefixer: posts small blind $0.10
Alameda22: posts big blind $0.25
*** HOLE CARDS ***
Dealt to Alameda22 [Kc 7c]
Ramon47: folds 
Cardgrrl: folds 
Surfside182: folds 
gagefixer: calls $0.15
Alameda22: checks 
*** FLOP *** [Ts 4d 9c]
gagefixer: bets $0.25
Alameda22: folds 
Uncalled bet ($0.25) returned to gagefixer
gagefixer collected $0.50 from pot
gagefixer: doesn't show hand 
*** SUMMARY ***
Total pot $0.50 | Rake $0 
Board [Ts 4d 9c]
Seat 1: Cardgrrl folded before Flop (didn't bet)
Seat 2: Surfside182 (button) folded before Flop (didn't bet)
Seat 4: gagefixer (small blind) collected ($0.50)
Seat 7: Alameda22 (big blind) folded on the Flop
Seat 8: Ramon47 folded before Flop (didn't bet)



