PokerStars Game #20100612821:  Hold'em No Limit ($0.10/$0.25) - 2008/09/02 18:47:26 ET
Table 'Pomona IV' 9-max Seat #5 is the button
Seat 1: TheInstaller ($14.95 in chips) 
Seat 2: angelface007 ($19.15 in chips) 
Seat 3: Sep79 ($24.65 in chips) 
Seat 4: moss\boss ($23.75 in chips) 
Seat 5: bibool33 ($22.45 in chips) 
Seat 6: J Burrow ($15.30 in chips) 
Seat 7: Alameda22 ($25 in chips) 
J Burrow: posts small blind $0.10
Alameda22: posts big blind $0.25
Sandertjeboy: sits out 
Siberia766: sits out 
*** HOLE CARDS ***
Dealt to Alameda22 [7h 4c]
TheInstaller: calls $0.25
angelface007: folds 
Sep79: folds 
moss\boss: folds 
bibool33: raises $0.75 to $1
J Burrow: folds 
Alameda22: folds 
TheInstaller: calls $0.75
*** FLOP *** [Js Jh 5d]
TheInstaller: checks 
bibool33: bets $0.75
TheInstaller: calls $0.75
*** TURN *** [Js Jh 5d] [Jd]
TheInstaller: bets $2.25
bibool33: calls $2.25
*** RIVER *** [Js Jh 5d Jd] [7c]
TheInstaller: bets $5.50
bibool33: calls $5.50
*** SHOW DOWN ***
TheInstaller: shows [6d Kh] (three of a kind, Jacks)
bibool33: shows [6h 6s] (a full house, Jacks full of Sixes)
bibool33 collected $18.45 from pot
*** SUMMARY ***
Total pot $19.35 | Rake $0.90 
Board [Js Jh 5d Jd 7c]
Seat 1: TheInstaller showed [6d Kh] and lost with three of a kind, Jacks
Seat 2: angelface007 folded before Flop (didn't bet)
Seat 3: Sep79 folded before Flop (didn't bet)
Seat 4: moss\boss folded before Flop (didn't bet)
Seat 5: bibool33 (button) showed [6h 6s] and won ($18.45) with a full house, Jacks full of Sixes
Seat 6: J Burrow (small blind) folded before Flop
Seat 7: Alameda22 (big blind) folded before Flop



PokerStars Game #20100659707:  Hold'em No Limit ($0.10/$0.25) - 2008/09/02 18:49:33 ET
Table 'Pomona IV' 9-max Seat #6 is the button
Seat 1: TheInstaller ($5.45 in chips) 
Seat 2: angelface007 ($19.15 in chips) 
Seat 3: Sep79 ($24.65 in chips) 
Seat 4: moss\boss ($23.75 in chips) 
Seat 5: bibool33 ($31.40 in chips) 
Seat 6: J Burrow ($15.20 in chips) 
Seat 7: Alameda22 ($24.75 in chips) 
Seat 8: Sandertjeboy ($25 in chips) 
Alameda22: posts small blind $0.10
Sandertjeboy: posts big blind $0.25
Siberia766: sits out 
*** HOLE CARDS ***
Dealt to Alameda22 [6d 9c]
TheInstaller: raises $5.20 to $5.45 and is all-in
angelface007: folds 
Sep79: folds 
moss\boss: folds 
bibool33: folds 
J Burrow: calls $5.45
Alameda22: folds 
Sandertjeboy: folds 
*** FLOP *** [2s Kd 7s]
*** TURN *** [2s Kd 7s] [8d]
*** RIVER *** [2s Kd 7s 8d] [Jh]
*** SHOW DOWN ***
TheInstaller: shows [Jc Qc] (a pair of Jacks)
J Burrow: mucks hand 
TheInstaller collected $10.70 from pot
*** SUMMARY ***
Total pot $11.25 | Rake $0.55 
Board [2s Kd 7s 8d Jh]
Seat 1: TheInstaller showed [Jc Qc] and won ($10.70) with a pair of Jacks
Seat 2: angelface007 folded before Flop (didn't bet)
Seat 3: Sep79 folded before Flop (didn't bet)
Seat 4: moss\boss folded before Flop (didn't bet)
Seat 5: bibool33 folded before Flop (didn't bet)
Seat 6: J Burrow (button) mucked [Ac Qh]
Seat 7: Alameda22 (small blind) folded before Flop
Seat 8: Sandertjeboy (big blind) folded before Flop



PokerStars Game #20100682561:  Hold'em No Limit ($0.10/$0.25) - 2008/09/02 18:50:35 ET
Table 'Pomona IV' 9-max Seat #7 is the button
Seat 1: TheInstaller ($10.70 in chips) 
Seat 2: angelface007 ($19.15 in chips) 
Seat 3: Sep79 ($24.65 in chips) 
Seat 4: moss\boss ($23.75 in chips) 
Seat 5: bibool33 ($31.40 in chips) 
Seat 6: J Burrow ($9.75 in chips) 
Seat 7: Alameda22 ($24.65 in chips) 
Seat 8: Sandertjeboy ($24.75 in chips) 
Seat 9: Siberia766 ($5 in chips) 
Sandertjeboy: posts small blind $0.10
Siberia766: posts big blind $0.25
*** HOLE CARDS ***
Dealt to Alameda22 [Td 7s]
TheInstaller: calls $0.25
angelface007: calls $0.25
Sep79: folds 
moss\boss: calls $0.25
bibool33: calls $0.25
J Burrow: folds 
Alameda22: folds 
Sandertjeboy: folds 
Siberia766: checks 
*** FLOP *** [Qh 9d Jh]
Siberia766: checks 
TheInstaller: bets $3
angelface007: folds 
moss\boss: folds 
bibool33: folds 
Siberia766: folds 
Uncalled bet ($3) returned to TheInstaller
TheInstaller collected $1.30 from pot
*** SUMMARY ***
Total pot $1.35 | Rake $0.05 
Board [Qh 9d Jh]
Seat 1: TheInstaller collected ($1.30)
Seat 2: angelface007 folded on the Flop
Seat 3: Sep79 folded before Flop (didn't bet)
Seat 4: moss\boss folded on the Flop
Seat 5: bibool33 folded on the Flop
Seat 6: J Burrow folded before Flop (didn't bet)
Seat 7: Alameda22 (button) folded before Flop (didn't bet)
Seat 8: Sandertjeboy (small blind) folded before Flop
Seat 9: Siberia766 (big blind) folded on the Flop



PokerStars Game #20100707700:  Hold'em No Limit ($0.10/$0.25) - 2008/09/02 18:51:44 ET
Table 'Pomona IV' 9-max Seat #8 is the button
Seat 1: TheInstaller ($11.75 in chips) 
Seat 2: angelface007 ($18.90 in chips) 
Seat 3: Sep79 ($24.65 in chips) 
Seat 4: moss\boss ($23.50 in chips) 
Seat 5: bibool33 ($31.15 in chips) 
Seat 6: J Burrow ($25 in chips) 
Seat 7: Alameda22 ($24.65 in chips) 
Seat 8: Sandertjeboy ($24.65 in chips) 
Seat 9: Siberia766 ($4.75 in chips) 
Siberia766: posts small blind $0.10
TheInstaller: posts big blind $0.25
*** HOLE CARDS ***
Dealt to Alameda22 [2s Jc]
angelface007: calls $0.25
Sep79: folds 
moss\boss: folds 
bibool33: raises $0.50 to $0.75
J Burrow: folds 
Alameda22: folds 
Sandertjeboy: folds 
Siberia766: folds 
TheInstaller: raises $4.75 to $5.50
angelface007: raises $4.75 to $10.25
bibool33: folds 
TheInstaller: raises $1.50 to $11.75 and is all-in
angelface007: calls $1.50
*** FLOP *** [6h 5c 4h]
*** TURN *** [6h 5c 4h] [Qd]
*** RIVER *** [6h 5c 4h Qd] [6c]
*** SHOW DOWN ***
TheInstaller: shows [8s Qs] (two pair, Queens and Sixes)
angelface007: shows [Ah Ad] (two pair, Aces and Sixes)
angelface007 collected $23.15 from pot
*** SUMMARY ***
Total pot $24.35 | Rake $1.20 
Board [6h 5c 4h Qd 6c]
Seat 1: TheInstaller (big blind) showed [8s Qs] and lost with two pair, Queens and Sixes
Seat 2: angelface007 showed [Ah Ad] and won ($23.15) with two pair, Aces and Sixes
Seat 3: Sep79 folded before Flop (didn't bet)
Seat 4: moss\boss folded before Flop (didn't bet)
Seat 5: bibool33 folded before Flop
Seat 6: J Burrow folded before Flop (didn't bet)
Seat 7: Alameda22 folded before Flop (didn't bet)
Seat 8: Sandertjeboy (button) folded before Flop (didn't bet)
Seat 9: Siberia766 (small blind) folded before Flop



PokerStars Game #20100745312:  Hold'em No Limit ($0.10/$0.25) - 2008/09/02 18:53:26 ET
Table 'Pomona IV' 9-max Seat #9 is the button
Seat 2: angelface007 ($30.30 in chips) 
Seat 4: moss\boss ($23.50 in chips) 
Seat 5: bibool33 ($30.40 in chips) 
Seat 6: J Burrow ($25 in chips) 
Seat 7: Alameda22 ($24.65 in chips) 
Seat 8: Sandertjeboy ($24.65 in chips) 
Seat 9: Siberia766 ($4.65 in chips) 
angelface007: posts small blind $0.10
Sep79: is sitting out 
moss\boss: posts big blind $0.25
*** HOLE CARDS ***
Dealt to Alameda22 [Ac 6c]
TheInstaller leaves the table
Sep79 leaves the table
bibool33: calls $0.25
J Burrow: folds 
Alameda22: folds 
gogobati joins the table at seat #1 
Sandertjeboy: folds 
Siberia766: folds 
angelface007: calls $0.15
moss\boss: checks 
*** FLOP *** [Qd Qs 8h]
angelface007: checks 
moss\boss: checks 
bibool33: checks 
*** TURN *** [Qd Qs 8h] [Kd]
Nealix87 joins the table at seat #3 
angelface007: checks 
moss\boss: checks 
bibool33: checks 
*** RIVER *** [Qd Qs 8h Kd] [3c]
angelface007: checks 
moss\boss: checks 
bibool33: checks 
*** SHOW DOWN ***
angelface007: shows [Jd Ah] (a pair of Queens)
moss\boss: mucks hand 
bibool33: mucks hand 
angelface007 collected $0.75 from pot
*** SUMMARY ***
Total pot $0.75 | Rake $0 
Board [Qd Qs 8h Kd 3c]
Seat 2: angelface007 (small blind) showed [Jd Ah] and won ($0.75) with a pair of Queens
Seat 4: moss\boss (big blind) mucked [Th 7c]
Seat 5: bibool33 mucked [9h 5h]
Seat 6: J Burrow folded before Flop (didn't bet)
Seat 7: Alameda22 folded before Flop (didn't bet)
Seat 8: Sandertjeboy folded before Flop (didn't bet)
Seat 9: Siberia766 (button) folded before Flop (didn't bet)



PokerStars Game #20100767509:  Hold'em No Limit ($0.10/$0.25) - 2008/09/02 18:54:27 ET
Table 'Pomona IV' 9-max Seat #2 is the button
Seat 1: gogobati ($25 in chips) 
Seat 2: angelface007 ($30.80 in chips) 
Seat 4: moss\boss ($23.25 in chips) 
Seat 5: bibool33 ($30.15 in chips) 
Seat 6: J Burrow ($25 in chips) 
Seat 7: Alameda22 ($24.65 in chips) 
Seat 8: Sandertjeboy ($24.65 in chips) 
Seat 9: Siberia766 ($4.65 in chips) 
Nealix87 will be allowed to play after the button
moss\boss: posts small blind $0.10
bibool33: posts big blind $0.25
gogobati: posts big blind $0.25
*** HOLE CARDS ***
Dealt to Alameda22 [4d 5d]
J Burrow: folds 
Alameda22: folds 
Sandertjeboy: calls $0.25
Siberia766: folds 
gogobati: checks 
angelface007: calls $0.25
moss\boss: calls $0.15
bibool33: checks 
*** FLOP *** [Jh 5h 7d]
moss\boss: checks 
bibool33: bets $0.25
Sandertjeboy: folds 
gogobati: raises $0.25 to $0.50
angelface007: calls $0.50
moss\boss: folds 
bibool33: calls $0.25
*** TURN *** [Jh 5h 7d] [Ac]
bibool33: checks 
gogobati: bets $2
angelface007: calls $2
bibool33: folds 
*** RIVER *** [Jh 5h 7d Ac] [Js]
gogobati: bets $22.25 and is all-in
angelface007: folds 
Uncalled bet ($22.25) returned to gogobati
gogobati collected $6.45 from pot
gogobati: doesn't show hand 
*** SUMMARY ***
Total pot $6.75 | Rake $0.30 
Board [Jh 5h 7d Ac Js]
Seat 1: gogobati collected ($6.45)
Seat 2: angelface007 (button) folded on the River
Seat 4: moss\boss (small blind) folded on the Flop
Seat 5: bibool33 (big blind) folded on the Turn
Seat 6: J Burrow folded before Flop (didn't bet)
Seat 7: Alameda22 folded before Flop (didn't bet)
Seat 8: Sandertjeboy folded on the Flop
Seat 9: Siberia766 folded before Flop (didn't bet)



PokerStars Game #20100797110:  Hold'em No Limit ($0.10/$0.25) - 2008/09/02 18:55:48 ET
Table 'Pomona IV' 9-max Seat #4 is the button
Seat 1: gogobati ($28.70 in chips) 
Seat 2: angelface007 ($28.05 in chips) 
Seat 4: moss\boss ($23 in chips) 
Seat 5: bibool33 ($29.40 in chips) 
Seat 6: J Burrow ($25 in chips) 
Seat 7: Alameda22 ($24.65 in chips) 
Seat 8: Sandertjeboy ($24.40 in chips) 
Seat 9: Siberia766 ($4.65 in chips) 
bibool33: posts small blind $0.10
J Burrow: posts big blind $0.25
Nealix87: sits out 
*** HOLE CARDS ***
Dealt to Alameda22 [2h 7h]
Alameda22: folds 
Sandertjeboy: raises $0.50 to $0.75
Siberia766: folds 
gogobati: folds 
angelface007: calls $0.75
moss\boss: folds 
bibool33: folds 
J Burrow: calls $0.50
*** FLOP *** [Kh 3h Th]
J Burrow: checks 
Sandertjeboy: bets $1
angelface007: folds 
J Burrow: folds 
Uncalled bet ($1) returned to Sandertjeboy
moss\boss leaves the table
Sandertjeboy collected $2.25 from pot
*** SUMMARY ***
Total pot $2.35 | Rake $0.10 
Board [Kh 3h Th]
Seat 1: gogobati folded before Flop (didn't bet)
Seat 2: angelface007 folded on the Flop
Seat 4: moss\boss (button) folded before Flop (didn't bet)
Seat 5: bibool33 (small blind) folded before Flop
Seat 6: J Burrow (big blind) folded on the Flop
Seat 7: Alameda22 folded before Flop (didn't bet)
Seat 8: Sandertjeboy collected ($2.25)
Seat 9: Siberia766 folded before Flop (didn't bet)



PokerStars Game #20100817460:  Hold'em No Limit ($0.10/$0.25) - 2008/09/02 18:56:44 ET
Table 'Pomona IV' 9-max Seat #5 is the button
Seat 1: gogobati ($28.70 in chips) 
Seat 2: angelface007 ($27.30 in chips) 
Seat 5: bibool33 ($29.30 in chips) 
Seat 6: J Burrow ($24.25 in chips) 
Seat 7: Alameda22 ($24.65 in chips) 
Seat 8: Sandertjeboy ($25.90 in chips) 
Seat 9: Siberia766 ($4.65 in chips) 
J Burrow: posts small blind $0.10
Alameda22: posts big blind $0.25
Nealix87: sits out 
*** HOLE CARDS ***
Dealt to Alameda22 [Ts Ks]
Sandertjeboy: folds 
Siberia766: folds 
gogobati: raises $0.75 to $1
angelface007: calls $1
bibool33: folds 
J Burrow: calls $0.90
Vicolino joins the table at seat #4 
Alameda22: folds 
*** FLOP *** [Jh Kd 8s]
J Burrow: checks 
gogobati: bets $2
angelface007: raises $2 to $4
J Burrow: folds 
gogobati: folds 
Uncalled bet ($2) returned to angelface007
angelface007 collected $6.90 from pot
angelface007: doesn't show hand 
*** SUMMARY ***
Total pot $7.25 | Rake $0.35 
Board [Jh Kd 8s]
Seat 1: gogobati folded on the Flop
Seat 2: angelface007 collected ($6.90)
Seat 5: bibool33 (button) folded before Flop (didn't bet)
Seat 6: J Burrow (small blind) folded on the Flop
Seat 7: Alameda22 (big blind) folded before Flop
Seat 8: Sandertjeboy folded before Flop (didn't bet)
Seat 9: Siberia766 folded before Flop (didn't bet)



PokerStars Game #20100843695:  Hold'em No Limit ($0.10/$0.25) - 2008/09/02 18:57:57 ET
Table 'Pomona IV' 9-max Seat #6 is the button
Seat 1: gogobati ($25.70 in chips) 
Seat 2: angelface007 ($31.20 in chips) 
Seat 5: bibool33 ($29.30 in chips) 
Seat 6: J Burrow ($23.25 in chips) 
Seat 7: Alameda22 ($24.40 in chips) 
Seat 8: Sandertjeboy ($25.90 in chips) 
Seat 9: Siberia766 ($4.65 in chips) 
Alameda22: posts small blind $0.10
Sandertjeboy: posts big blind $0.25
Nealix87: sits out 
Vicolino: sits out 
*** HOLE CARDS ***
Dealt to Alameda22 [Qs 6h]
Siberia766: folds 
gogobati: raises $0.75 to $1
angelface007: calls $1
bibool33: folds 
J Burrow: folds 
Alameda22: folds 
Sandertjeboy: calls $0.75
*** FLOP *** [2d 2c Ks]
Sandertjeboy: checks 
gogobati: checks 
angelface007: checks 
*** TURN *** [2d 2c Ks] [Ad]
Sandertjeboy: checks 
gogobati: checks 
angelface007: checks 
*** RIVER *** [2d 2c Ks Ad] [5d]
Sandertjeboy: checks 
gogobati: checks 
angelface007: checks 
*** SHOW DOWN ***
Sandertjeboy: shows [Qd Th] (a pair of Deuces)
gogobati: shows [7s 7d] (two pair, Sevens and Deuces)
angelface007: mucks hand 
gogobati collected $2.95 from pot
*** SUMMARY ***
Total pot $3.10 | Rake $0.15 
Board [2d 2c Ks Ad 5d]
Seat 1: gogobati showed [7s 7d] and won ($2.95) with two pair, Sevens and Deuces
Seat 2: angelface007 mucked [8c Qh]
Seat 5: bibool33 folded before Flop (didn't bet)
Seat 6: J Burrow (button) folded before Flop (didn't bet)
Seat 7: Alameda22 (small blind) folded before Flop
Seat 8: Sandertjeboy (big blind) showed [Qd Th] and lost with a pair of Deuces
Seat 9: Siberia766 folded before Flop (didn't bet)



PokerStars Game #20100882246:  Hold'em No Limit ($0.10/$0.25) - 2008/09/02 18:59:43 ET
Table 'Pomona IV' 9-max Seat #7 is the button
Seat 1: gogobati ($27.65 in chips) 
Seat 2: angelface007 ($30.20 in chips) 
Seat 5: bibool33 ($29.30 in chips) 
Seat 6: J Burrow ($23.25 in chips) 
Seat 7: Alameda22 ($24.30 in chips) 
Seat 8: Sandertjeboy ($24.90 in chips) 
Seat 9: Siberia766 ($4.65 in chips) 
Sandertjeboy: posts small blind $0.10
Siberia766: posts big blind $0.25
Nealix87: sits out 
Vicolino: sits out 
*** HOLE CARDS ***
Dealt to Alameda22 [Jc 2c]
gogobati: raises $0.75 to $1
angelface007: calls $1
bibool33: folds 
J Burrow: folds 
Alameda22: folds 
Sandertjeboy: folds 
Siberia766: folds 
*** FLOP *** [Qs 7h Ac]
gogobati: bets $2
angelface007: folds 
Uncalled bet ($2) returned to gogobati
gogobati collected $2.25 from pot
gogobati: doesn't show hand 
*** SUMMARY ***
Total pot $2.35 | Rake $0.10 
Board [Qs 7h Ac]
Seat 1: gogobati collected ($2.25)
Seat 2: angelface007 folded on the Flop
Seat 5: bibool33 folded before Flop (didn't bet)
Seat 6: J Burrow folded before Flop (didn't bet)
Seat 7: Alameda22 (button) folded before Flop (didn't bet)
Seat 8: Sandertjeboy (small blind) folded before Flop
Seat 9: Siberia766 (big blind) folded before Flop



PokerStars Game #20100898219:  Hold'em No Limit ($0.10/$0.25) - 2008/09/02 19:00:26 ET
Table 'Pomona IV' 9-max Seat #8 is the button
Seat 1: gogobati ($28.90 in chips) 
Seat 2: angelface007 ($29.20 in chips) 
Seat 5: bibool33 ($29.30 in chips) 
Seat 6: J Burrow ($23.25 in chips) 
Seat 7: Alameda22 ($24.30 in chips) 
Seat 8: Sandertjeboy ($24.80 in chips) 
Seat 9: Siberia766 ($4.40 in chips) 
Siberia766: posts small blind $0.10
gogobati: posts big blind $0.25
Nealix87: sits out 
Vicolino: sits out 
*** HOLE CARDS ***
Dealt to Alameda22 [6d Js]
angelface007: calls $0.25
bibool33: folds 
J Burrow: calls $0.25
Alameda22: folds 
Sandertjeboy: folds 
Siberia766: folds 
gogobati: checks 
*** FLOP *** [2c 8c 3s]
gogobati: checks 
angelface007: bets $0.25
J Burrow: raises $0.50 to $0.75
gogobati: folds 
angelface007: calls $0.50
*** TURN *** [2c 8c 3s] [As]
angelface007: bets $0.25
J Burrow: calls $0.25
*** RIVER *** [2c 8c 3s As] [5h]
angelface007: bets $2.75
J Burrow: calls $2.75
*** SHOW DOWN ***
angelface007: shows [Ts 9d] (high card Ace)
J Burrow: shows [6h Ah] (a pair of Aces)
J Burrow collected $7.95 from pot
*** SUMMARY ***
Total pot $8.35 | Rake $0.40 
Board [2c 8c 3s As 5h]
Seat 1: gogobati (big blind) folded on the Flop
Seat 2: angelface007 showed [Ts 9d] and lost with high card Ace
Seat 5: bibool33 folded before Flop (didn't bet)
Seat 6: J Burrow showed [6h Ah] and won ($7.95) with a pair of Aces
Seat 7: Alameda22 folded before Flop (didn't bet)
Seat 8: Sandertjeboy (button) folded before Flop (didn't bet)
Seat 9: Siberia766 (small blind) folded before Flop



PokerStars Game #20100923304:  Hold'em No Limit ($0.10/$0.25) - 2008/09/02 19:01:34 ET
Table 'Pomona IV' 9-max Seat #9 is the button
Seat 1: gogobati ($28.65 in chips) 
Seat 2: angelface007 ($25.20 in chips) 
Seat 5: bibool33 ($29.30 in chips) 
Seat 6: J Burrow ($27.20 in chips) 
Seat 7: Alameda22 ($24.30 in chips) 
Seat 8: Sandertjeboy ($24.80 in chips) 
Seat 9: Siberia766 ($4.30 in chips) 
gogobati: posts small blind $0.10
angelface007: posts big blind $0.25
Nealix87: sits out 
Vicolino: sits out 
*** HOLE CARDS ***
Dealt to Alameda22 [6h Qh]
bibool33: calls $0.25
J Burrow: calls $0.25
Alameda22: folds 
Sandertjeboy: folds 
Siberia766: folds 
gogobati: folds 
angelface007: checks 
*** FLOP *** [2c Ah As]
angelface007: checks 
bibool33: checks 
J Burrow: bets $0.50
angelface007: calls $0.50
bibool33: folds 
*** TURN *** [2c Ah As] [3d]
angelface007: checks 
J Burrow: bets $1
angelface007: calls $1
*** RIVER *** [2c Ah As 3d] [Kc]
angelface007: checks 
J Burrow: checks 
*** SHOW DOWN ***
angelface007: shows [4c 4s] (two pair, Aces and Fours)
J Burrow: shows [Kd Tc] (two pair, Aces and Kings)
J Burrow collected $3.70 from pot
*** SUMMARY ***
Total pot $3.85 | Rake $0.15 
Board [2c Ah As 3d Kc]
Seat 1: gogobati (small blind) folded before Flop
Seat 2: angelface007 (big blind) showed [4c 4s] and lost with two pair, Aces and Fours
Seat 5: bibool33 folded on the Flop
Seat 6: J Burrow showed [Kd Tc] and won ($3.70) with two pair, Aces and Kings
Seat 7: Alameda22 folded before Flop (didn't bet)
Seat 8: Sandertjeboy folded before Flop (didn't bet)
Seat 9: Siberia766 (button) folded before Flop (didn't bet)



PokerStars Game #20100954774:  Hold'em No Limit ($0.10/$0.25) - 2008/09/02 19:02:59 ET
Table 'Pomona IV' 9-max Seat #1 is the button
Seat 1: gogobati ($28.55 in chips) 
Seat 2: angelface007 ($23.45 in chips) 
Seat 3: Nealix87 ($25 in chips) 
Seat 5: bibool33 ($29.05 in chips) 
Seat 6: J Burrow ($29.15 in chips) 
Seat 7: Alameda22 ($24.30 in chips) 
Seat 8: Sandertjeboy ($24.80 in chips) 
Seat 9: Siberia766 ($4.30 in chips) 
angelface007: posts small blind $0.10
Nealix87: posts big blind $0.25
Vicolino: sits out 
*** HOLE CARDS ***
Dealt to Alameda22 [2h Qd]
bibool33: folds 
J Burrow: calls $0.25
Alameda22: folds 
Sandertjeboy: folds 
Siberia766: folds 
gogobati: raises $1 to $1.25
angelface007: folds 
Nealix87: folds 
J Burrow: calls $1
*** FLOP *** [Js 5c 7c]
J Burrow: checks 
gogobati: bets $2
J Burrow: calls $2
*** TURN *** [Js 5c 7c] [5d]
J Burrow: checks 
gogobati: checks 
*** RIVER *** [Js 5c 7c 5d] [9c]
J Burrow: bets $2
gogobati: folds 
Uncalled bet ($2) returned to J Burrow
J Burrow collected $6.55 from pot
J Burrow: doesn't show hand 
*** SUMMARY ***
Total pot $6.85 | Rake $0.30 
Board [Js 5c 7c 5d 9c]
Seat 1: gogobati (button) folded on the River
Seat 2: angelface007 (small blind) folded before Flop
Seat 3: Nealix87 (big blind) folded before Flop
Seat 5: bibool33 folded before Flop (didn't bet)
Seat 6: J Burrow collected ($6.55)
Seat 7: Alameda22 folded before Flop (didn't bet)
Seat 8: Sandertjeboy folded before Flop (didn't bet)
Seat 9: Siberia766 folded before Flop (didn't bet)



PokerStars Game #20100989174:  Hold'em No Limit ($0.10/$0.25) - 2008/09/02 19:04:32 ET
Table 'Pomona IV' 9-max Seat #2 is the button
Seat 1: gogobati ($25.30 in chips) 
Seat 2: angelface007 ($23.35 in chips) 
Seat 3: Nealix87 ($24.75 in chips) 
Seat 4: Vicolino ($10 in chips) 
Seat 5: bibool33 ($29.05 in chips) 
Seat 6: J Burrow ($32.45 in chips) 
Seat 7: Alameda22 ($24.30 in chips) 
Seat 8: Sandertjeboy ($24.80 in chips) 
Seat 9: Siberia766 ($4.30 in chips) 
Nealix87: posts small blind $0.10
Vicolino: posts big blind $0.25
*** HOLE CARDS ***
Dealt to Alameda22 [9s Kd]
bibool33: folds 
J Burrow: folds 
Alameda22: folds 
Sandertjeboy: folds 
Siberia766: folds 
gogobati: folds 
angelface007: raises $0.25 to $0.50
Nealix87: calls $0.40
Vicolino: calls $0.25
*** FLOP *** [4h Ad 3h]
Nealix87: checks 
Vicolino: checks 
angelface007: bets $0.75
Nealix87: folds 
Vicolino: calls $0.75
*** TURN *** [4h Ad 3h] [Td]
Vicolino: checks 
angelface007: bets $1.50
Vicolino: calls $1.50
*** RIVER *** [4h Ad 3h Td] [Ks]
Vicolino: checks 
angelface007: bets $1.50
Vicolino: calls $1.50
*** SHOW DOWN ***
angelface007: shows [6h Ah] (a pair of Aces)
Vicolino: shows [Js Ac] (a pair of Aces - King+Jack kicker)
Vicolino collected $8.60 from pot
*** SUMMARY ***
Total pot $9 | Rake $0.40 
Board [4h Ad 3h Td Ks]
Seat 1: gogobati folded before Flop (didn't bet)
Seat 2: angelface007 (button) showed [6h Ah] and lost with a pair of Aces
Seat 3: Nealix87 (small blind) folded on the Flop
Seat 4: Vicolino (big blind) showed [Js Ac] and won ($8.60) with a pair of Aces
Seat 5: bibool33 folded before Flop (didn't bet)
Seat 6: J Burrow folded before Flop (didn't bet)
Seat 7: Alameda22 folded before Flop (didn't bet)
Seat 8: Sandertjeboy folded before Flop (didn't bet)
Seat 9: Siberia766 folded before Flop (didn't bet)



PokerStars Game #20101017467:  Hold'em No Limit ($0.10/$0.25) - 2008/09/02 19:05:48 ET
Table 'Pomona IV' 9-max Seat #3 is the button
Seat 1: gogobati ($25.30 in chips) 
Seat 2: angelface007 ($19.10 in chips) 
Seat 3: Nealix87 ($24.25 in chips) 
Seat 4: Vicolino ($14.35 in chips) 
Seat 5: bibool33 ($29.05 in chips) 
Seat 6: J Burrow ($32.45 in chips) 
Seat 7: Alameda22 ($24.30 in chips) 
Seat 8: Sandertjeboy ($24.80 in chips) 
Seat 9: Siberia766 ($4.30 in chips) 
Vicolino: posts small blind $0.10
bibool33: posts big blind $0.25
*** HOLE CARDS ***
Dealt to Alameda22 [5c 4h]
J Burrow: folds 
Alameda22: folds 
Sandertjeboy: folds 
Siberia766: folds 
gogobati: folds 
angelface007: calls $0.25
Nealix87: calls $0.25
Vicolino: folds 
bibool33: checks 
*** FLOP *** [8s Jh 5d]
bibool33: checks 
angelface007: bets $0.50
Nealix87: folds 
bibool33: folds 
Uncalled bet ($0.50) returned to angelface007
angelface007 collected $0.85 from pot
angelface007: doesn't show hand 
*** SUMMARY ***
Total pot $0.85 | Rake $0 
Board [8s Jh 5d]
Seat 1: gogobati folded before Flop (didn't bet)
Seat 2: angelface007 collected ($0.85)
Seat 3: Nealix87 (button) folded on the Flop
Seat 4: Vicolino (small blind) folded before Flop
Seat 5: bibool33 (big blind) folded on the Flop
Seat 6: J Burrow folded before Flop (didn't bet)
Seat 7: Alameda22 folded before Flop (didn't bet)
Seat 8: Sandertjeboy folded before Flop (didn't bet)
Seat 9: Siberia766 folded before Flop (didn't bet)



PokerStars Game #20101041573:  Hold'em No Limit ($0.10/$0.25) - 2008/09/02 19:06:55 ET
Table 'Pomona IV' 9-max Seat #4 is the button
Seat 1: gogobati ($25.30 in chips) 
Seat 2: angelface007 ($19.70 in chips) 
Seat 3: Nealix87 ($24 in chips) 
Seat 4: Vicolino ($14.25 in chips) 
Seat 5: bibool33 ($28.80 in chips) 
Seat 6: J Burrow ($32.45 in chips) 
Seat 7: Alameda22 ($24.30 in chips) 
Seat 8: Sandertjeboy ($24.80 in chips) 
Seat 9: Siberia766 ($4.30 in chips) 
bibool33: posts small blind $0.10
J Burrow: posts big blind $0.25
*** HOLE CARDS ***
Dealt to Alameda22 [5d 6s]
Alameda22: folds 
Sandertjeboy: folds 
Siberia766: folds 
gogobati: folds 
angelface007: raises $0.25 to $0.50
Nealix87: folds 
Vicolino: folds 
bibool33: folds 
J Burrow: calls $0.25
*** FLOP *** [Td Jc 4c]
J Burrow: checks 
angelface007: bets $0.75
J Burrow: calls $0.75
*** TURN *** [Td Jc 4c] [7h]
J Burrow: checks 
angelface007: checks 
*** RIVER *** [Td Jc 4c 7h] [Qc]
J Burrow: checks 
angelface007: checks 
*** SHOW DOWN ***
J Burrow: shows [8h Jh] (a pair of Jacks)
angelface007: mucks hand 
J Burrow collected $2.50 from pot
*** SUMMARY ***
Total pot $2.60 | Rake $0.10 
Board [Td Jc 4c 7h Qc]
Seat 1: gogobati folded before Flop (didn't bet)
Seat 2: angelface007 mucked [2c 2s]
Seat 3: Nealix87 folded before Flop (didn't bet)
Seat 4: Vicolino (button) folded before Flop (didn't bet)
Seat 5: bibool33 (small blind) folded before Flop
Seat 6: J Burrow (big blind) showed [8h Jh] and won ($2.50) with a pair of Jacks
Seat 7: Alameda22 folded before Flop (didn't bet)
Seat 8: Sandertjeboy folded before Flop (didn't bet)
Seat 9: Siberia766 folded before Flop (didn't bet)



PokerStars Game #20101062106:  Hold'em No Limit ($0.10/$0.25) - 2008/09/02 19:07:51 ET
Table 'Pomona IV' 9-max Seat #5 is the button
Seat 1: gogobati ($25.30 in chips) 
Seat 2: angelface007 ($18.45 in chips) 
Seat 3: Nealix87 ($24 in chips) 
Seat 4: Vicolino ($14.25 in chips) 
Seat 5: bibool33 ($28.70 in chips) 
Seat 6: J Burrow ($33.70 in chips) 
Seat 7: Alameda22 ($24.30 in chips) 
Seat 8: Sandertjeboy ($24.80 in chips) 
Seat 9: Siberia766 ($4.30 in chips) 
J Burrow: posts small blind $0.10
Alameda22: posts big blind $0.25
*** HOLE CARDS ***
Dealt to Alameda22 [4s Th]
Sandertjeboy: folds 
Siberia766: folds 
gogobati: folds 
angelface007: calls $0.25
Nealix87: folds 
Vicolino: folds 
bibool33: calls $0.25
J Burrow: calls $0.15
Alameda22: checks 
*** FLOP *** [8d Ac 8h]
J Burrow: checks 
Alameda22: checks 
angelface007: bets $0.25
bibool33: folds 
J Burrow: folds 
Alameda22: folds 
Uncalled bet ($0.25) returned to angelface007
angelface007 collected $0.95 from pot
angelface007: doesn't show hand 
*** SUMMARY ***
Total pot $1 | Rake $0.05 
Board [8d Ac 8h]
Seat 1: gogobati folded before Flop (didn't bet)
Seat 2: angelface007 collected ($0.95)
Seat 3: Nealix87 folded before Flop (didn't bet)
Seat 4: Vicolino folded before Flop (didn't bet)
Seat 5: bibool33 (button) folded on the Flop
Seat 6: J Burrow (small blind) folded on the Flop
Seat 7: Alameda22 (big blind) folded on the Flop
Seat 8: Sandertjeboy folded before Flop (didn't bet)
Seat 9: Siberia766 folded before Flop (didn't bet)



PokerStars Game #20101081426:  Hold'em No Limit ($0.10/$0.25) - 2008/09/02 19:08:42 ET
Table 'Pomona IV' 9-max Seat #6 is the button
Seat 1: gogobati ($25.30 in chips) 
Seat 2: angelface007 ($19.15 in chips) 
Seat 3: Nealix87 ($24 in chips) 
Seat 4: Vicolino ($14.25 in chips) 
Seat 5: bibool33 ($28.45 in chips) 
Seat 6: J Burrow ($33.45 in chips) 
Seat 7: Alameda22 ($24.05 in chips) 
Seat 8: Sandertjeboy ($24.80 in chips) 
Seat 9: Siberia766 ($4.30 in chips) 
Alameda22: posts small blind $0.10
Sandertjeboy: posts big blind $0.25
*** HOLE CARDS ***
Dealt to Alameda22 [9s 8h]
Siberia766: folds 
gogobati: folds 
angelface007: folds 
Nealix87: folds 
Vicolino: folds 
bibool33: folds 
J Burrow: folds 
Alameda22: folds 
Uncalled bet ($0.15) returned to Sandertjeboy
Sandertjeboy collected $0.20 from pot
*** SUMMARY ***
Total pot $0.20 | Rake $0 
Seat 1: gogobati folded before Flop (didn't bet)
Seat 2: angelface007 folded before Flop (didn't bet)
Seat 3: Nealix87 folded before Flop (didn't bet)
Seat 4: Vicolino folded before Flop (didn't bet)
Seat 5: bibool33 folded before Flop (didn't bet)
Seat 6: J Burrow (button) folded before Flop (didn't bet)
Seat 7: Alameda22 (small blind) folded before Flop
Seat 8: Sandertjeboy (big blind) collected ($0.20)
Seat 9: Siberia766 folded before Flop (didn't bet)



PokerStars Game #20101091396:  Hold'em No Limit ($0.10/$0.25) - 2008/09/02 19:09:10 ET
Table 'Pomona IV' 9-max Seat #7 is the button
Seat 1: gogobati ($25.30 in chips) 
Seat 2: angelface007 ($19.15 in chips) 
Seat 3: Nealix87 ($24 in chips) 
Seat 4: Vicolino ($14.25 in chips) 
Seat 5: bibool33 ($28.45 in chips) 
Seat 6: J Burrow ($33.45 in chips) 
Seat 7: Alameda22 ($23.95 in chips) 
Seat 8: Sandertjeboy ($24.90 in chips) 
Sandertjeboy: posts small blind $0.10
Siberia766: is sitting out 
gogobati: posts big blind $0.25
*** HOLE CARDS ***
Dealt to Alameda22 [2s Tc]
Siberia766 leaves the table
angelface007: calls $0.25
Nealix87: calls $0.25
Vicolino: folds 
bibool33: folds 
J Burrow: folds 
timboaus joins the table at seat #9 
Alameda22: folds 
Sandertjeboy: raises $1 to $1.25
gogobati: calls $1
angelface007: folds 
Nealix87: calls $1
*** FLOP *** [7s 5h 8s]
Sandertjeboy: bets $3
gogobati: calls $3
Nealix87: calls $3
*** TURN *** [7s 5h 8s] [Jh]
Sandertjeboy: bets $5
gogobati: calls $5
Nealix87: calls $5
*** RIVER *** [7s 5h 8s Jh] [7c]
Sandertjeboy: checks 
gogobati: checks 
Nealix87: checks 
*** SHOW DOWN ***
Sandertjeboy: shows [Qd Qs] (two pair, Queens and Sevens)
gogobati: mucks hand 
Nealix87: mucks hand 
Sandertjeboy collected $26.65 from pot
*** SUMMARY ***
Total pot $28 | Rake $1.35 
Board [7s 5h 8s Jh 7c]
Seat 1: gogobati (big blind) mucked [9s 9d]
Seat 2: angelface007 folded before Flop
Seat 3: Nealix87 mucked [8h 9h]
Seat 4: Vicolino folded before Flop (didn't bet)
Seat 5: bibool33 folded before Flop (didn't bet)
Seat 6: J Burrow folded before Flop (didn't bet)
Seat 7: Alameda22 (button) folded before Flop (didn't bet)
Seat 8: Sandertjeboy (small blind) showed [Qd Qs] and won ($26.65) with two pair, Queens and Sevens



PokerStars Game #20101125962:  Hold'em No Limit ($0.10/$0.25) - 2008/09/02 19:10:44 ET
Table 'Pomona IV' 9-max Seat #8 is the button
Seat 1: gogobati ($16.05 in chips) 
Seat 2: angelface007 ($18.90 in chips) 
Seat 3: Nealix87 ($14.75 in chips) 
Seat 4: Vicolino ($14.25 in chips) 
Seat 5: bibool33 ($28.45 in chips) 
Seat 6: J Burrow ($33.45 in chips) 
Seat 7: Alameda22 ($23.95 in chips) 
Seat 8: Sandertjeboy ($42.30 in chips) 
timboaus will be allowed to play after the button
gogobati: posts small blind $0.10
angelface007: posts big blind $0.25
*** HOLE CARDS ***
Dealt to Alameda22 [5d Qc]
Nealix87: folds 
Vicolino: folds 
bibool33: calls $0.25
J Burrow: folds 
Alameda22: folds 
Sandertjeboy: folds 
gogobati: folds 
angelface007: checks 
*** FLOP *** [Jc 5s 6d]
gogobati leaves the table
angelface007: checks 
bibool33: bets $0.50
chris2745 joins the table at seat #1 
angelface007: folds 
Uncalled bet ($0.50) returned to bibool33
bibool33 collected $0.60 from pot
bibool33: doesn't show hand 
*** SUMMARY ***
Total pot $0.60 | Rake $0 
Board [Jc 5s 6d]
Seat 1: gogobati (small blind) folded before Flop
Seat 2: angelface007 (big blind) folded on the Flop
Seat 3: Nealix87 folded before Flop (didn't bet)
Seat 4: Vicolino folded before Flop (didn't bet)
Seat 5: bibool33 collected ($0.60)
Seat 6: J Burrow folded before Flop (didn't bet)
Seat 7: Alameda22 folded before Flop (didn't bet)
Seat 8: Sandertjeboy (button) folded before Flop (didn't bet)



PokerStars Game #20101138973:  Hold'em No Limit ($0.10/$0.25) - 2008/09/02 19:11:20 ET
Table 'Pomona IV' 9-max Seat #2 is the button
Seat 2: angelface007 ($18.65 in chips) 
Seat 3: Nealix87 ($14.75 in chips) 
Seat 4: Vicolino ($14.25 in chips) 
Seat 5: bibool33 ($28.80 in chips) 
Seat 6: J Burrow ($33.45 in chips) 
Seat 7: Alameda22 ($23.95 in chips) 
Seat 8: Sandertjeboy ($42.30 in chips) 
Nealix87: posts small blind $0.10
Vicolino: posts big blind $0.25
timboaus: sits out 
chris2745 has timed out
chris2745: is sitting out 
*** HOLE CARDS ***
Dealt to Alameda22 [Kh Jh]
bibool33: calls $0.25
J Burrow: folds 
Alameda22: folds 
chris2745 has returned
Sandertjeboy: folds 
angelface007: calls $0.25
Nealix87: raises $1.25 to $1.50
Vicolino: folds 
bibool33: calls $1.25
angelface007: calls $1.25
*** FLOP *** [Ks Js 9d]
Nealix87: bets $2.75
bibool33: folds 
angelface007: calls $2.75
*** TURN *** [Ks Js 9d] [Tc]
bibool33 leaves the table
Nealix87: bets $4
angelface007: calls $4
*** RIVER *** [Ks Js 9d Tc] [5c]
Nealix87: bets $6.50 and is all-in
angelface007: calls $6.50
*** SHOW DOWN ***
Nealix87: shows [Qs Ah] (a straight, Ten to Ace)
angelface007: mucks hand 
Nealix87 collected $29.75 from pot
daheights1 joins the table at seat #5 
*** SUMMARY ***
Total pot $31.25 | Rake $1.50 
Board [Ks Js 9d Tc 5c]
Seat 2: angelface007 (button) mucked [8c 7c]
Seat 3: Nealix87 (small blind) showed [Qs Ah] and won ($29.75) with a straight, Ten to Ace
Seat 4: Vicolino (big blind) folded before Flop
Seat 5: bibool33 folded on the Flop
Seat 6: J Burrow folded before Flop (didn't bet)
Seat 7: Alameda22 folded before Flop (didn't bet)
Seat 8: Sandertjeboy folded before Flop (didn't bet)



PokerStars Game #20101176055:  Hold'em No Limit ($0.10/$0.25) - 2008/09/02 19:13:01 ET
Table 'Pomona IV' 9-max Seat #3 is the button
Seat 1: chris2745 ($25 in chips) 
Seat 2: angelface007 ($3.90 in chips) 
Seat 3: Nealix87 ($29.75 in chips) 
Seat 4: Vicolino ($14 in chips) 
Seat 5: daheights1 ($15 in chips) 
Seat 6: J Burrow ($33.45 in chips) 
Seat 7: Alameda22 ($23.95 in chips) 
Seat 8: Sandertjeboy ($42.30 in chips) 
Vicolino: posts small blind $0.10
daheights1: posts big blind $0.25
timboaus: sits out 
chris2745: posts big blind $0.25
*** HOLE CARDS ***
Dealt to Alameda22 [3d 7h]
J Burrow: folds 
Alameda22: folds 
Sandertjeboy: folds 
chris2745: checks 
angelface007: folds 
angelface007 leaves the table
Nealix87: folds 
Vicolino: folds 
daheights1: checks 
*** FLOP *** [Td Th 2s]
daheights1: checks 
MissStax joins the table at seat #2 
chris2745: checks 
*** TURN *** [Td Th 2s] [8c]
daheights1: checks 
chris2745: bets $0.25
daheights1: folds 
Uncalled bet ($0.25) returned to chris2745
chris2745 collected $0.60 from pot
chris2745: doesn't show hand 
*** SUMMARY ***
Total pot $0.60 | Rake $0 
Board [Td Th 2s 8c]
Seat 1: chris2745 collected ($0.60)
Seat 2: angelface007 folded before Flop (didn't bet)
Seat 3: Nealix87 (button) folded before Flop (didn't bet)
Seat 4: Vicolino (small blind) folded before Flop
Seat 5: daheights1 (big blind) folded on the Turn
Seat 6: J Burrow folded before Flop (didn't bet)
Seat 7: Alameda22 folded before Flop (didn't bet)
Seat 8: Sandertjeboy folded before Flop (didn't bet)



PokerStars Game #20101195507:  Hold'em No Limit ($0.10/$0.25) - 2008/09/02 19:13:56 ET
Table 'Pomona IV' 9-max Seat #4 is the button
Seat 1: chris2745 ($25.35 in chips) 
Seat 3: Nealix87 ($29.75 in chips) 
Seat 4: Vicolino ($13.90 in chips) 
Seat 5: daheights1 ($14.75 in chips) 
Seat 6: J Burrow ($33.45 in chips) 
Seat 7: Alameda22 ($23.95 in chips) 
Seat 8: Sandertjeboy ($42.30 in chips) 
daheights1: posts small blind $0.10
J Burrow: posts big blind $0.25
timboaus: sits out 
MissStax: sits out 
*** HOLE CARDS ***
Dealt to Alameda22 [Jh 4h]
Alameda22: folds 
Sandertjeboy: calls $0.25
chris2745: folds 
Nealix87: folds 
Vicolino: folds 
daheights1: calls $0.15
J Burrow: raises $1 to $1.25
Sandertjeboy: folds 
daheights1: calls $1
*** FLOP *** [8d Kd 3c]
daheights1: checks 
J Burrow: bets $1
daheights1: folds 
Uncalled bet ($1) returned to J Burrow
J Burrow collected $2.65 from pot
J Burrow: doesn't show hand 
*** SUMMARY ***
Total pot $2.75 | Rake $0.10 
Board [8d Kd 3c]
Seat 1: chris2745 folded before Flop (didn't bet)
Seat 3: Nealix87 folded before Flop (didn't bet)
Seat 4: Vicolino (button) folded before Flop (didn't bet)
Seat 5: daheights1 (small blind) folded on the Flop
Seat 6: J Burrow (big blind) collected ($2.65)
Seat 7: Alameda22 folded before Flop (didn't bet)
Seat 8: Sandertjeboy folded before Flop



PokerStars Game #20101219360:  Hold'em No Limit ($0.10/$0.25) - 2008/09/02 19:15:03 ET
Table 'Pomona IV' 9-max Seat #5 is the button
Seat 1: chris2745 ($25.35 in chips) 
Seat 3: Nealix87 ($29.75 in chips) 
Seat 4: Vicolino ($13.90 in chips) 
Seat 5: daheights1 ($13.50 in chips) 
Seat 6: J Burrow ($34.85 in chips) 
Seat 7: Alameda22 ($23.95 in chips) 
Seat 8: Sandertjeboy ($42.05 in chips) 
J Burrow: posts small blind $0.10
Alameda22: posts big blind $0.25
timboaus: sits out 
MissStax: sits out 
*** HOLE CARDS ***
Dealt to Alameda22 [3d Qc]
Sandertjeboy: folds 
chris2745: folds 
Nealix87: folds 
Vicolino: folds 
daheights1: calls $0.25
J Burrow: folds 
Alameda22: checks 
*** FLOP *** [Js 8c Jc]
Alameda22: checks 
daheights1: checks 
*** TURN *** [Js 8c Jc] [Ac]
Alameda22: checks 
daheights1: bets $0.75
Alameda22: folds 
Uncalled bet ($0.75) returned to daheights1
daheights1 collected $0.60 from pot
daheights1: doesn't show hand 
*** SUMMARY ***
Total pot $0.60 | Rake $0 
Board [Js 8c Jc Ac]
Seat 1: chris2745 folded before Flop (didn't bet)
Seat 3: Nealix87 folded before Flop (didn't bet)
Seat 4: Vicolino folded before Flop (didn't bet)
Seat 5: daheights1 (button) collected ($0.60)
Seat 6: J Burrow (small blind) folded before Flop
Seat 7: Alameda22 (big blind) folded on the Turn
Seat 8: Sandertjeboy folded before Flop (didn't bet)



PokerStars Game #20101246389:  Hold'em No Limit ($0.10/$0.25) - 2008/09/02 19:16:19 ET
Table 'Pomona IV' 9-max Seat #6 is the button
Seat 1: chris2745 ($25.35 in chips) 
Seat 3: Nealix87 ($29.75 in chips) 
Seat 4: Vicolino ($13.90 in chips) 
Seat 5: daheights1 ($13.85 in chips) 
Seat 6: J Burrow ($34.75 in chips) 
Seat 7: Alameda22 ($23.70 in chips) 
Seat 8: Sandertjeboy ($42.05 in chips) 
Alameda22: posts small blind $0.10
Sandertjeboy: posts big blind $0.25
timboaus: sits out 
MissStax: sits out 
*** HOLE CARDS ***
Dealt to Alameda22 [7c 9h]
chris2745: folds 
Nealix87: folds 
Vicolino: calls $0.25
daheights1: folds 
J Burrow: folds 
Alameda22: folds 
Sandertjeboy: checks 
*** FLOP *** [Td 6c 6d]
Sandertjeboy: bets $0.50
Vicolino: calls $0.50
*** TURN *** [Td 6c 6d] [Qh]
Sandertjeboy: bets $1.50
Vicolino: calls $1.50
*** RIVER *** [Td 6c 6d Qh] [5c]
Sandertjeboy: checks 
Vicolino: checks 
*** SHOW DOWN ***
Sandertjeboy: shows [8d Qd] (two pair, Queens and Sixes)
Vicolino: mucks hand 
Sandertjeboy collected $4.40 from pot
*** SUMMARY ***
Total pot $4.60 | Rake $0.20 
Board [Td 6c 6d Qh 5c]
Seat 1: chris2745 folded before Flop (didn't bet)
Seat 3: Nealix87 folded before Flop (didn't bet)
Seat 4: Vicolino mucked [Jh Js]
Seat 5: daheights1 folded before Flop (didn't bet)
Seat 6: J Burrow (button) folded before Flop (didn't bet)
Seat 7: Alameda22 (small blind) folded before Flop
Seat 8: Sandertjeboy (big blind) showed [8d Qd] and won ($4.40) with two pair, Queens and Sixes



PokerStars Game #20101268150:  Hold'em No Limit ($0.10/$0.25) - 2008/09/02 19:17:18 ET
Table 'Pomona IV' 9-max Seat #7 is the button
Seat 1: chris2745 ($25.35 in chips) 
Seat 3: Nealix87 ($29.75 in chips) 
Seat 4: Vicolino ($11.65 in chips) 
Seat 5: daheights1 ($13.85 in chips) 
Seat 6: J Burrow ($34.75 in chips) 
Seat 7: Alameda22 ($23.60 in chips) 
Seat 8: Sandertjeboy ($44.20 in chips) 
Seat 9: timboaus ($15 in chips) 
Sandertjeboy: posts small blind $0.10
timboaus: posts big blind $0.25
MissStax: sits out 
*** HOLE CARDS ***
Dealt to Alameda22 [Jd 6c]
chris2745: folds 
Nealix87: folds 
Vicolino: folds 
daheights1: calls $0.25
J Burrow: calls $0.25
Alameda22: folds 
Sandertjeboy: folds 
timboaus: checks 
*** FLOP *** [Qh Jh Th]
timboaus: bets $0.40
daheights1: folds 
J Burrow: folds 
Uncalled bet ($0.40) returned to timboaus
timboaus collected $0.85 from pot
*** SUMMARY ***
Total pot $0.85 | Rake $0 
Board [Qh Jh Th]
Seat 1: chris2745 folded before Flop (didn't bet)
Seat 3: Nealix87 folded before Flop (didn't bet)
Seat 4: Vicolino folded before Flop (didn't bet)
Seat 5: daheights1 folded on the Flop
Seat 6: J Burrow folded on the Flop
Seat 7: Alameda22 (button) folded before Flop (didn't bet)
Seat 8: Sandertjeboy (small blind) folded before Flop
Seat 9: timboaus (big blind) collected ($0.85)



PokerStars Game #20101289881:  Hold'em No Limit ($0.10/$0.25) - 2008/09/02 19:18:19 ET
Table 'Pomona IV' 9-max Seat #8 is the button
Seat 1: chris2745 ($25.35 in chips) 
Seat 3: Nealix87 ($29.75 in chips) 
Seat 4: Vicolino ($11.65 in chips) 
Seat 5: daheights1 ($13.60 in chips) 
Seat 6: J Burrow ($34.50 in chips) 
Seat 7: Alameda22 ($23.60 in chips) 
Seat 8: Sandertjeboy ($44.10 in chips) 
Seat 9: timboaus ($15.60 in chips) 
timboaus: posts small blind $0.10
chris2745: posts big blind $0.25
MissStax: sits out 
*** HOLE CARDS ***
Dealt to Alameda22 [9s 3h]
Nealix87: calls $0.25
Vicolino: folds 
daheights1: calls $0.25
J Burrow: calls $0.25
Alameda22: folds 
Sandertjeboy: folds 
timboaus: folds 
chris2745: checks 
*** FLOP *** [3d 8d 8h]
chris2745: checks 
Nealix87: checks 
daheights1: checks 
J Burrow: bets $0.50
chris2745: folds 
Nealix87: calls $0.50
daheights1: folds 
*** TURN *** [3d 8d 8h] [Kd]
Nealix87: checks 
J Burrow: bets $1
Nealix87: folds 
Uncalled bet ($1) returned to J Burrow
J Burrow collected $2 from pot
J Burrow: doesn't show hand 
*** SUMMARY ***
Total pot $2.10 | Rake $0.10 
Board [3d 8d 8h Kd]
Seat 1: chris2745 (big blind) folded on the Flop
Seat 3: Nealix87 folded on the Turn
Seat 4: Vicolino folded before Flop (didn't bet)
Seat 5: daheights1 folded on the Flop
Seat 6: J Burrow collected ($2)
Seat 7: Alameda22 folded before Flop (didn't bet)
Seat 8: Sandertjeboy (button) folded before Flop (didn't bet)
Seat 9: timboaus (small blind) folded before Flop



PokerStars Game #20101317417:  Hold'em No Limit ($0.10/$0.25) - 2008/09/02 19:19:35 ET
Table 'Pomona IV' 9-max Seat #9 is the button
Seat 1: chris2745 ($25.10 in chips) 
Seat 2: MissStax ($25 in chips) 
Seat 3: Nealix87 ($29 in chips) 
Seat 4: Vicolino ($11.65 in chips) 
Seat 5: daheights1 ($13.35 in chips) 
Seat 6: J Burrow ($35.75 in chips) 
Seat 7: Alameda22 ($23.60 in chips) 
Seat 8: Sandertjeboy ($44.10 in chips) 
Seat 9: timboaus ($15.50 in chips) 
chris2745: posts small blind $0.10
MissStax: posts big blind $0.25
*** HOLE CARDS ***
Dealt to Alameda22 [Js Ac]
Nealix87: calls $0.25
Vicolino: folds 
daheights1: folds 
J Burrow: folds 
Alameda22: folds 
Sandertjeboy: folds 
timboaus: raises $1.05 to $1.30
chris2745: folds 
MissStax: folds 
Nealix87: calls $1.05
*** FLOP *** [9d Tc 2s]
Nealix87: checks 
timboaus: bets $1.40
Nealix87: calls $1.40
*** TURN *** [9d Tc 2s] [6c]
Nealix87: checks 
timboaus: bets $3.10
Nealix87: folds 
Uncalled bet ($3.10) returned to timboaus
timboaus collected $5.50 from pot
timboaus: doesn't show hand 
*** SUMMARY ***
Total pot $5.75 | Rake $0.25 
Board [9d Tc 2s 6c]
Seat 1: chris2745 (small blind) folded before Flop
Seat 2: MissStax (big blind) folded before Flop
Seat 3: Nealix87 folded on the Turn
Seat 4: Vicolino folded before Flop (didn't bet)
Seat 5: daheights1 folded before Flop (didn't bet)
Seat 6: J Burrow folded before Flop (didn't bet)
Seat 7: Alameda22 folded before Flop (didn't bet)
Seat 8: Sandertjeboy folded before Flop (didn't bet)
Seat 9: timboaus (button) collected ($5.50)



PokerStars Game #20101343422:  Hold'em No Limit ($0.10/$0.25) - 2008/09/02 19:20:47 ET
Table 'Pomona IV' 9-max Seat #1 is the button
Seat 1: chris2745 ($25 in chips) 
Seat 2: MissStax ($24.75 in chips) 
Seat 3: Nealix87 ($26.30 in chips) 
Seat 4: Vicolino ($11.65 in chips) 
Seat 5: daheights1 ($13.35 in chips) 
Seat 6: J Burrow ($35.75 in chips) 
Seat 7: Alameda22 ($23.60 in chips) 
Seat 8: Sandertjeboy ($44.10 in chips) 
Seat 9: timboaus ($18.30 in chips) 
MissStax: posts small blind $0.10
Nealix87: posts big blind $0.25
*** HOLE CARDS ***
Dealt to Alameda22 [Ad Td]
Vicolino: folds 
daheights1: folds 
J Burrow: calls $0.25
daheights1 is sitting out
Alameda22: folds 
Sandertjeboy: calls $0.25
timboaus: folds 
chris2745: calls $0.25
MissStax: calls $0.15
Nealix87: checks 
*** FLOP *** [Jc Qs 4h]
MissStax: checks 
Nealix87: bets $1
J Burrow: calls $1
Sandertjeboy: folds 
chris2745: calls $1
MissStax: folds 
*** TURN *** [Jc Qs 4h] [Ks]
Nealix87: bets $2.25
J Burrow: raises $2.25 to $4.50
chris2745: calls $4.50
Nealix87: folds 
*** RIVER *** [Jc Qs 4h Ks] [Kd]
J Burrow: bets $5
chris2745: calls $5
*** SHOW DOWN ***
J Burrow: shows [Jh Kc] (a full house, Kings full of Jacks)
chris2745: mucks hand 
J Burrow collected $24.30 from pot
*** SUMMARY ***
Total pot $25.50 | Rake $1.20 
Board [Jc Qs 4h Ks Kd]
Seat 1: chris2745 (button) mucked [Kh As]
Seat 2: MissStax (small blind) folded on the Flop
Seat 3: Nealix87 (big blind) folded on the Turn
Seat 4: Vicolino folded before Flop (didn't bet)
Seat 5: daheights1 folded before Flop (didn't bet)
Seat 6: J Burrow showed [Jh Kc] and won ($24.30) with a full house, Kings full of Jacks
Seat 7: Alameda22 folded before Flop (didn't bet)
Seat 8: Sandertjeboy folded on the Flop
Seat 9: timboaus folded before Flop (didn't bet)



PokerStars Game #20101376800:  Hold'em No Limit ($0.10/$0.25) - 2008/09/02 19:22:19 ET
Table 'Pomona IV' 9-max Seat #2 is the button
Seat 1: chris2745 ($14.25 in chips) 
Seat 2: MissStax ($24.50 in chips) 
Seat 3: Nealix87 ($22.80 in chips) 
Seat 4: Vicolino ($11.65 in chips) 
Seat 6: J Burrow ($49.30 in chips) 
Seat 7: Alameda22 ($23.60 in chips) 
Seat 8: Sandertjeboy ($43.85 in chips) 
Seat 9: timboaus ($18.30 in chips) 
Nealix87: posts small blind $0.10
Vicolino: posts big blind $0.25
*** HOLE CARDS ***
Dealt to Alameda22 [7s 4c]
J Burrow: calls $0.25
Alameda22: folds 
Sandertjeboy: folds 
timboaus: calls $0.25
chris2745: folds 
MissStax: folds 
Nealix87: calls $0.15
Vicolino: checks 
*** FLOP *** [6c 2c 5h]
Nealix87: checks 
Vicolino: checks 
J Burrow: checks 
timboaus: bets $0.60
Nealix87: calls $0.60
Vicolino: calls $0.60
J Burrow: folds 
*** TURN *** [6c 2c 5h] [3s]
Nealix87: checks 
Vicolino: checks 
timboaus: checks 
*** RIVER *** [6c 2c 5h 3s] [4d]
Nealix87: bets $1.25
daheights1 has returned
Vicolino: calls $1.25
timboaus: folds 
*** SHOW DOWN ***
Nealix87: shows [9c 8c] (a straight, Deuce to Six)
Vicolino: shows [6h 6d] (a straight, Deuce to Six)
Nealix87 collected $2.55 from pot
Vicolino collected $2.50 from pot
*** SUMMARY ***
Total pot $5.30 | Rake $0.25 
Board [6c 2c 5h 3s 4d]
Seat 1: chris2745 folded before Flop (didn't bet)
Seat 2: MissStax (button) folded before Flop (didn't bet)
Seat 3: Nealix87 (small blind) showed [9c 8c] and won ($2.55) with a straight, Deuce to Six
Seat 4: Vicolino (big blind) showed [6h 6d] and won ($2.50) with a straight, Deuce to Six
Seat 6: J Burrow folded on the Flop
Seat 7: Alameda22 folded before Flop (didn't bet)
Seat 8: Sandertjeboy folded before Flop (didn't bet)
Seat 9: timboaus folded on the River



PokerStars Game #20101405182:  Hold'em No Limit ($0.10/$0.25) - 2008/09/02 19:23:36 ET
Table 'Pomona IV' 9-max Seat #3 is the button
Seat 1: chris2745 ($14.25 in chips) 
Seat 2: MissStax ($24.50 in chips) 
Seat 3: Nealix87 ($23.25 in chips) 
Seat 4: Vicolino ($12.05 in chips) 
Seat 5: daheights1 ($13.35 in chips) 
Seat 6: J Burrow ($49.05 in chips) 
Seat 7: Alameda22 ($23.60 in chips) 
Seat 8: Sandertjeboy ($43.85 in chips) 
Seat 9: timboaus ($17.45 in chips) 
Vicolino: posts small blind $0.10
daheights1: posts big blind $0.25
*** HOLE CARDS ***
Dealt to Alameda22 [Jd 2h]
J Burrow: calls $0.25
Alameda22: folds 
Sandertjeboy: folds 
timboaus: folds 
chris2745: calls $0.25
MissStax: folds 
Nealix87: folds 
Vicolino: folds 
daheights1: checks 
*** FLOP *** [As 6d 8c]
daheights1: checks 
J Burrow: checks 
chris2745: checks 
*** TURN *** [As 6d 8c] [4s]
daheights1: bets $0.75
J Burrow: folds 
chris2745: calls $0.75
*** RIVER *** [As 6d 8c 4s] [Kh]
daheights1: checks 
chris2745: checks 
*** SHOW DOWN ***
daheights1: shows [3h 5s] (high card Ace)
chris2745: shows [6h 7h] (a pair of Sixes)
chris2745 collected $2.25 from pot
*** SUMMARY ***
Total pot $2.35 | Rake $0.10 
Board [As 6d 8c 4s Kh]
Seat 1: chris2745 showed [6h 7h] and won ($2.25) with a pair of Sixes
Seat 2: MissStax folded before Flop (didn't bet)
Seat 3: Nealix87 (button) folded before Flop (didn't bet)
Seat 4: Vicolino (small blind) folded before Flop
Seat 5: daheights1 (big blind) showed [3h 5s] and lost with high card Ace
Seat 6: J Burrow folded on the Turn
Seat 7: Alameda22 folded before Flop (didn't bet)
Seat 8: Sandertjeboy folded before Flop (didn't bet)
Seat 9: timboaus folded before Flop (didn't bet)



PokerStars Game #20101427830:  Hold'em No Limit ($0.10/$0.25) - 2008/09/02 19:24:37 ET
Table 'Pomona IV' 9-max Seat #4 is the button
Seat 1: chris2745 ($15.50 in chips) 
Seat 2: MissStax ($24.50 in chips) 
Seat 3: Nealix87 ($23.25 in chips) 
Seat 4: Vicolino ($11.95 in chips) 
Seat 5: daheights1 ($12.35 in chips) 
Seat 6: J Burrow ($48.80 in chips) 
Seat 7: Alameda22 ($23.60 in chips) 
Seat 8: Sandertjeboy ($43.85 in chips) 
Seat 9: timboaus ($17.45 in chips) 
daheights1: posts small blind $0.10
J Burrow: posts big blind $0.25
*** HOLE CARDS ***
Dealt to Alameda22 [8h 7s]
Alameda22: folds 
Sandertjeboy: folds 
timboaus: folds 
chris2745: folds 
MissStax: folds 
Nealix87: folds 
Vicolino: raises $0.50 to $0.75
daheights1: folds 
J Burrow: calls $0.50
*** FLOP *** [4c 2h 7c]
J Burrow: checks 
Vicolino: bets $1
J Burrow: folds 
Uncalled bet ($1) returned to Vicolino
Vicolino collected $1.55 from pot
Vicolino: doesn't show hand 
*** SUMMARY ***
Total pot $1.60 | Rake $0.05 
Board [4c 2h 7c]
Seat 1: chris2745 folded before Flop (didn't bet)
Seat 2: MissStax folded before Flop (didn't bet)
Seat 3: Nealix87 folded before Flop (didn't bet)
Seat 4: Vicolino (button) collected ($1.55)
Seat 5: daheights1 (small blind) folded before Flop
Seat 6: J Burrow (big blind) folded on the Flop
Seat 7: Alameda22 folded before Flop (didn't bet)
Seat 8: Sandertjeboy folded before Flop (didn't bet)
Seat 9: timboaus folded before Flop (didn't bet)



PokerStars Game #20101451395:  Hold'em No Limit ($0.10/$0.25) - 2008/09/02 19:25:42 ET
Table 'Pomona IV' 9-max Seat #5 is the button
Seat 1: chris2745 ($15.50 in chips) 
Seat 2: MissStax ($24.50 in chips) 
Seat 3: Nealix87 ($23.25 in chips) 
Seat 4: Vicolino ($12.75 in chips) 
Seat 5: daheights1 ($12.25 in chips) 
Seat 6: J Burrow ($48.05 in chips) 
Seat 7: Alameda22 ($23.60 in chips) 
Seat 8: Sandertjeboy ($43.85 in chips) 
Seat 9: timboaus ($17.45 in chips) 
J Burrow: posts small blind $0.10
Alameda22: posts big blind $0.25
*** HOLE CARDS ***
Dealt to Alameda22 [Qc 6d]
Sandertjeboy: calls $0.25
timboaus: folds 
chris2745: folds 
MissStax: folds 
Nealix87: raises $0.75 to $1
Vicolino: folds 
daheights1: folds 
J Burrow: folds 
Alameda22: folds 
Sandertjeboy: calls $0.75
*** FLOP *** [3c Kd 4c]
Sandertjeboy: checks 
Nealix87: bets $1.25
Sandertjeboy: folds 
Uncalled bet ($1.25) returned to Nealix87
Nealix87 collected $2.25 from pot
*** SUMMARY ***
Total pot $2.35 | Rake $0.10 
Board [3c Kd 4c]
Seat 1: chris2745 folded before Flop (didn't bet)
Seat 2: MissStax folded before Flop (didn't bet)
Seat 3: Nealix87 collected ($2.25)
Seat 4: Vicolino folded before Flop (didn't bet)
Seat 5: daheights1 (button) folded before Flop (didn't bet)
Seat 6: J Burrow (small blind) folded before Flop
Seat 7: Alameda22 (big blind) folded before Flop
Seat 8: Sandertjeboy folded on the Flop
Seat 9: timboaus folded before Flop (didn't bet)



PokerStars Game #20101485522:  Hold'em No Limit ($0.10/$0.25) - 2008/09/02 19:27:16 ET
Table 'Pomona IV' 9-max Seat #6 is the button
Seat 1: chris2745 ($15.50 in chips) 
Seat 2: MissStax ($24.50 in chips) 
Seat 3: Nealix87 ($24.50 in chips) 
Seat 4: Vicolino ($12.75 in chips) 
Seat 5: daheights1 ($12.25 in chips) 
Seat 6: J Burrow ($47.95 in chips) 
Seat 7: Alameda22 ($23.35 in chips) 
Seat 8: Sandertjeboy ($42.85 in chips) 
Seat 9: timboaus ($17.45 in chips) 
Alameda22: posts small blind $0.10
Sandertjeboy: posts big blind $0.25
*** HOLE CARDS ***
Dealt to Alameda22 [Tc 8h]
timboaus: folds 
chris2745: calls $0.25
MissStax: folds 
Nealix87: calls $0.25
Vicolino: folds 
daheights1: calls $0.25
J Burrow: calls $0.25
Alameda22: folds 
Sandertjeboy: checks 
*** FLOP *** [9s 9d 6c]
Sandertjeboy: checks 
chris2745: checks 
Nealix87: bets $0.75
daheights1: folds 
J Burrow: folds 
Sandertjeboy: folds 
chris2745: folds 
Uncalled bet ($0.75) returned to Nealix87
Nealix87 collected $1.30 from pot
Nealix87: doesn't show hand 
*** SUMMARY ***
Total pot $1.35 | Rake $0.05 
Board [9s 9d 6c]
Seat 1: chris2745 folded on the Flop
Seat 2: MissStax folded before Flop (didn't bet)
Seat 3: Nealix87 collected ($1.30)
Seat 4: Vicolino folded before Flop (didn't bet)
Seat 5: daheights1 folded on the Flop
Seat 6: J Burrow (button) folded on the Flop
Seat 7: Alameda22 (small blind) folded before Flop
Seat 8: Sandertjeboy (big blind) folded on the Flop
Seat 9: timboaus folded before Flop (didn't bet)



PokerStars Game #20101505377:  Hold'em No Limit ($0.10/$0.25) - 2008/09/02 19:28:10 ET
Table 'Pomona IV' 9-max Seat #7 is the button
Seat 1: chris2745 ($15.25 in chips) 
Seat 2: MissStax ($24.50 in chips) 
Seat 3: Nealix87 ($25.55 in chips) 
Seat 4: Vicolino ($12.75 in chips) 
Seat 5: daheights1 ($12 in chips) 
Seat 6: J Burrow ($47.70 in chips) 
Seat 7: Alameda22 ($23.25 in chips) 
Seat 8: Sandertjeboy ($42.60 in chips) 
Seat 9: timboaus ($17.45 in chips) 
Sandertjeboy: posts small blind $0.10
timboaus: posts big blind $0.25
*** HOLE CARDS ***
Dealt to Alameda22 [Jc Qh]
chris2745: folds 
MissStax: folds 
Nealix87: raises $0.75 to $1
Vicolino: folds 
daheights1: folds 
J Burrow: folds 
Alameda22: folds 
Sandertjeboy: folds 
timboaus: folds 
Uncalled bet ($0.75) returned to Nealix87
Nealix87 collected $0.60 from pot
Nealix87: doesn't show hand 
*** SUMMARY ***
Total pot $0.60 | Rake $0 
Seat 1: chris2745 folded before Flop (didn't bet)
Seat 2: MissStax folded before Flop (didn't bet)
Seat 3: Nealix87 collected ($0.60)
Seat 4: Vicolino folded before Flop (didn't bet)
Seat 5: daheights1 folded before Flop (didn't bet)
Seat 6: J Burrow folded before Flop (didn't bet)
Seat 7: Alameda22 (button) folded before Flop (didn't bet)
Seat 8: Sandertjeboy (small blind) folded before Flop
Seat 9: timboaus (big blind) folded before Flop



PokerStars Game #20101520111:  Hold'em No Limit ($0.10/$0.25) - 2008/09/02 19:28:51 ET
Table 'Pomona IV' 9-max Seat #8 is the button
Seat 1: chris2745 ($15.25 in chips) 
Seat 2: MissStax ($24.50 in chips) 
Seat 3: Nealix87 ($25.90 in chips) 
Seat 4: Vicolino ($12.75 in chips) 
Seat 5: daheights1 ($12 in chips) 
Seat 6: J Burrow ($47.70 in chips) 
Seat 7: Alameda22 ($23.25 in chips) 
Seat 8: Sandertjeboy ($42.50 in chips) 
Seat 9: timboaus ($17.20 in chips) 
timboaus: posts small blind $0.10
chris2745: posts big blind $0.25
*** HOLE CARDS ***
Dealt to Alameda22 [3h 8d]
MissStax: folds 
Nealix87: folds 
Vicolino: folds 
daheights1: folds 
J Burrow: folds 
Alameda22: folds 
Sandertjeboy: raises $0.50 to $0.75
timboaus: folds 
chris2745: calls $0.50
*** FLOP *** [6s Js 8s]
chris2745: bets $0.75
Sandertjeboy: folds 
Uncalled bet ($0.75) returned to chris2745
chris2745 collected $1.55 from pot
chris2745: doesn't show hand 
*** SUMMARY ***
Total pot $1.60 | Rake $0.05 
Board [6s Js 8s]
Seat 1: chris2745 (big blind) collected ($1.55)
Seat 2: MissStax folded before Flop (didn't bet)
Seat 3: Nealix87 folded before Flop (didn't bet)
Seat 4: Vicolino folded before Flop (didn't bet)
Seat 5: daheights1 folded before Flop (didn't bet)
Seat 6: J Burrow folded before Flop (didn't bet)
Seat 7: Alameda22 folded before Flop (didn't bet)
Seat 8: Sandertjeboy (button) folded on the Flop
Seat 9: timboaus (small blind) folded before Flop



PokerStars Game #20101537186:  Hold'em No Limit ($0.10/$0.25) - 2008/09/02 19:29:38 ET
Table 'Pomona IV' 9-max Seat #9 is the button
Seat 1: chris2745 ($16.05 in chips) 
Seat 2: MissStax ($24.50 in chips) 
Seat 3: Nealix87 ($25.90 in chips) 
Seat 4: Vicolino ($12.75 in chips) 
Seat 5: daheights1 ($12 in chips) 
Seat 6: J Burrow ($47.70 in chips) 
Seat 7: Alameda22 ($23.25 in chips) 
Seat 8: Sandertjeboy ($41.75 in chips) 
Seat 9: timboaus ($17.10 in chips) 
chris2745: posts small blind $0.10
MissStax: posts big blind $0.25
*** HOLE CARDS ***
Dealt to Alameda22 [4s 5s]
Nealix87: folds 
Vicolino: folds 
daheights1: calls $0.25
J Burrow: calls $0.25
Alameda22: folds 
Sandertjeboy: folds 
timboaus: folds 
chris2745: calls $0.15
MissStax: checks 
*** FLOP *** [9s Ks 2s]
chris2745: checks 
MissStax: checks 
daheights1: checks 
J Burrow: bets $0.50
chris2745: calls $0.50
MissStax: folds 
daheights1: folds 
*** TURN *** [9s Ks 2s] [Td]
chris2745: checks 
J Burrow: bets $0.75
chris2745: folds 
Uncalled bet ($0.75) returned to J Burrow
J Burrow collected $1.95 from pot
J Burrow: doesn't show hand 
*** SUMMARY ***
Total pot $2 | Rake $0.05 
Board [9s Ks 2s Td]
Seat 1: chris2745 (small blind) folded on the Turn
Seat 2: MissStax (big blind) folded on the Flop
Seat 3: Nealix87 folded before Flop (didn't bet)
Seat 4: Vicolino folded before Flop (didn't bet)
Seat 5: daheights1 folded on the Flop
Seat 6: J Burrow collected ($1.95)
Seat 7: Alameda22 folded before Flop (didn't bet)
Seat 8: Sandertjeboy folded before Flop (didn't bet)
Seat 9: timboaus (button) folded before Flop (didn't bet)



PokerStars Game #20101567661:  Hold'em No Limit ($0.10/$0.25) - 2008/09/02 19:31:02 ET
Table 'Pomona IV' 9-max Seat #1 is the button
Seat 1: chris2745 ($15.30 in chips) 
Seat 2: MissStax ($24.25 in chips) 
Seat 3: Nealix87 ($25.90 in chips) 
Seat 4: Vicolino ($12.75 in chips) 
Seat 5: daheights1 ($11.75 in chips) 
Seat 6: J Burrow ($48.90 in chips) 
Seat 7: Alameda22 ($23.25 in chips) 
Seat 8: Sandertjeboy ($41.75 in chips) 
Seat 9: timboaus ($17.10 in chips) 
MissStax: posts small blind $0.10
Nealix87: posts big blind $0.25
*** HOLE CARDS ***
Dealt to Alameda22 [Ts Ah]
Vicolino: folds 
daheights1: calls $0.25
J Burrow: folds 
Alameda22: folds 
Sandertjeboy: raises $0.50 to $0.75
timboaus: folds 
chris2745: folds 
MissStax: folds 
Nealix87: raises $1.50 to $2.25
daheights1: calls $2
Sandertjeboy: calls $1.50
*** FLOP *** [Qs 7s 2s]
Nealix87: checks 
daheights1: checks 
Sandertjeboy: bets $3.50
Nealix87: folds 
daheights1: calls $3.50
*** TURN *** [Qs 7s 2s] [Td]
daheights1: checks 
Sandertjeboy: bets $36 and is all-in
daheights1: calls $6 and is all-in
Uncalled bet ($30) returned to Sandertjeboy
*** RIVER *** [Qs 7s 2s Td] [5s]
*** SHOW DOWN ***
daheights1: shows [As Js] (a flush, Ace high)
Sandertjeboy: mucks hand 
daheights1 collected $24.60 from pot
*** SUMMARY ***
Total pot $25.85 | Rake $1.25 
Board [Qs 7s 2s Td 5s]
Seat 1: chris2745 (button) folded before Flop (didn't bet)
Seat 2: MissStax (small blind) folded before Flop
Seat 3: Nealix87 (big blind) folded on the Flop
Seat 4: Vicolino folded before Flop (didn't bet)
Seat 5: daheights1 showed [As Js] and won ($24.60) with a flush, Ace high
Seat 6: J Burrow folded before Flop (didn't bet)
Seat 7: Alameda22 folded before Flop (didn't bet)
Seat 8: Sandertjeboy mucked [Ks Jc]
Seat 9: timboaus folded before Flop (didn't bet)



PokerStars Game #20101605952:  Hold'em No Limit ($0.10/$0.25) - 2008/09/02 19:32:44 ET
Table 'Pomona IV' 9-max Seat #2 is the button
Seat 1: chris2745 ($15.30 in chips) 
Seat 2: MissStax ($24.15 in chips) 
Seat 3: Nealix87 ($23.65 in chips) 
Seat 4: Vicolino ($12.75 in chips) 
Seat 5: daheights1 ($24.60 in chips) 
Seat 6: J Burrow ($48.90 in chips) 
Seat 7: Alameda22 ($23.25 in chips) 
Seat 8: Sandertjeboy ($30 in chips) 
Seat 9: timboaus ($17.10 in chips) 
Nealix87: posts small blind $0.10
Sandertjeboy said, "nh"
Vicolino: posts big blind $0.25
*** HOLE CARDS ***
Dealt to Alameda22 [Jh 8h]
daheights1: folds 
J Burrow: folds 
Alameda22: folds 
daheights1 said, "ty"
Sandertjeboy: calls $0.25
timboaus: folds 
chris2745: folds 
chris2745 is sitting out
MissStax: folds 
Nealix87: folds 
Vicolino: checks 
*** FLOP *** [7s 3d 4d]
Vicolino: checks 
Sandertjeboy: checks 
*** TURN *** [7s 3d 4d] [Qs]
Vicolino: checks 
Sandertjeboy: checks 
*** RIVER *** [7s 3d 4d Qs] [Ah]
Vicolino: checks 
Sandertjeboy: checks 
*** SHOW DOWN ***
Vicolino: shows [2d 9c] (high card Ace)
Sandertjeboy: shows [Js Td] (high card Ace - Queen+Jack kicker)
Sandertjeboy collected $0.60 from pot
*** SUMMARY ***
Total pot $0.60 | Rake $0 
Board [7s 3d 4d Qs Ah]
Seat 1: chris2745 folded before Flop (didn't bet)
Seat 2: MissStax (button) folded before Flop (didn't bet)
Seat 3: Nealix87 (small blind) folded before Flop
Seat 4: Vicolino (big blind) showed [2d 9c] and lost with high card Ace
Seat 5: daheights1 folded before Flop (didn't bet)
Seat 6: J Burrow folded before Flop (didn't bet)
Seat 7: Alameda22 folded before Flop (didn't bet)
Seat 8: Sandertjeboy showed [Js Td] and won ($0.60) with high card Ace
Seat 9: timboaus folded before Flop (didn't bet)



PokerStars Game #20101625736:  Hold'em No Limit ($0.10/$0.25) - 2008/09/02 19:33:38 ET
Table 'Pomona IV' 9-max Seat #3 is the button
Seat 2: MissStax ($24.15 in chips) 
Seat 3: Nealix87 ($23.55 in chips) 
Seat 4: Vicolino ($12.50 in chips) 
Seat 5: daheights1 ($24.60 in chips) 
Seat 6: J Burrow ($48.90 in chips) 
Seat 7: Alameda22 ($23.25 in chips) 
Seat 8: Sandertjeboy ($30.35 in chips) 
Seat 9: timboaus ($17.10 in chips) 
Vicolino: posts small blind $0.10
daheights1: posts big blind $0.25
*** HOLE CARDS ***
Dealt to Alameda22 [9s 8c]
J Burrow: calls $0.25
Alameda22: folds 
Sandertjeboy: folds 
timboaus: folds 
MissStax: raises $1 to $1.25
Nealix87: folds 
Vicolino: folds 
daheights1: folds 
J Burrow: calls $1
*** FLOP *** [Js 5d Kc]
J Burrow: checks 
MissStax: bets $1.25
J Burrow: calls $1.25
*** TURN *** [Js 5d Kc] [3h]
J Burrow: checks 
MissStax: checks 
*** RIVER *** [Js 5d Kc 3h] [2d]
J Burrow: checks 
MissStax: checks 
*** SHOW DOWN ***
J Burrow: shows [Tc Ac] (high card Ace)
MissStax: shows [Qs Ah] (high card Ace - King+Queen kicker)
MissStax collected $5.10 from pot
*** SUMMARY ***
Total pot $5.35 | Rake $0.25 
Board [Js 5d Kc 3h 2d]
Seat 2: MissStax showed [Qs Ah] and won ($5.10) with high card Ace
Seat 3: Nealix87 (button) folded before Flop (didn't bet)
Seat 4: Vicolino (small blind) folded before Flop
Seat 5: daheights1 (big blind) folded before Flop
Seat 6: J Burrow showed [Tc Ac] and lost with high card Ace
Seat 7: Alameda22 folded before Flop (didn't bet)
Seat 8: Sandertjeboy folded before Flop (didn't bet)
Seat 9: timboaus folded before Flop (didn't bet)



PokerStars Game #20101651966:  Hold'em No Limit ($0.10/$0.25) - 2008/09/02 19:34:49 ET
Table 'Pomona IV' 9-max Seat #4 is the button
Seat 2: MissStax ($26.75 in chips) 
Seat 3: Nealix87 ($23.55 in chips) 
Seat 4: Vicolino ($12.40 in chips) 
Seat 5: daheights1 ($24.35 in chips) 
Seat 6: J Burrow ($46.40 in chips) 
Seat 7: Alameda22 ($23.25 in chips) 
Seat 8: Sandertjeboy ($30.35 in chips) 
Seat 9: timboaus ($17.10 in chips) 
daheights1: posts small blind $0.10
J Burrow: posts big blind $0.25
*** HOLE CARDS ***
Dealt to Alameda22 [6h 8s]
Alameda22: folds 
Sandertjeboy: folds 
timboaus: folds 
MissStax: calls $0.25
Nealix87: folds 
Vicolino: folds 
daheights1: folds 
J Burrow: checks 
*** FLOP *** [9d 4c 9c]
J Burrow: checks 
MissStax: bets $0.25
J Burrow: calls $0.25
*** TURN *** [9d 4c 9c] [Qh]
J Burrow: checks 
MissStax: checks 
*** RIVER *** [9d 4c 9c Qh] [2d]
J Burrow: bets $0.50
MissStax: folds 
Uncalled bet ($0.50) returned to J Burrow
J Burrow collected $1.05 from pot
J Burrow: doesn't show hand 
*** SUMMARY ***
Total pot $1.10 | Rake $0.05 
Board [9d 4c 9c Qh 2d]
Seat 2: MissStax folded on the River
Seat 3: Nealix87 folded before Flop (didn't bet)
Seat 4: Vicolino (button) folded before Flop (didn't bet)
Seat 5: daheights1 (small blind) folded before Flop
Seat 6: J Burrow (big blind) collected ($1.05)
Seat 7: Alameda22 folded before Flop (didn't bet)
Seat 8: Sandertjeboy folded before Flop (didn't bet)
Seat 9: timboaus folded before Flop (didn't bet)



PokerStars Game #20101672731:  Hold'em No Limit ($0.10/$0.25) - 2008/09/02 19:35:46 ET
Table 'Pomona IV' 9-max Seat #5 is the button
Seat 2: MissStax ($26.25 in chips) 
Seat 3: Nealix87 ($23.55 in chips) 
Seat 4: Vicolino ($12.40 in chips) 
Seat 5: daheights1 ($24.25 in chips) 
Seat 6: J Burrow ($46.95 in chips) 
Seat 7: Alameda22 ($23.25 in chips) 
Seat 8: Sandertjeboy ($30.35 in chips) 
Seat 9: timboaus ($17.10 in chips) 
J Burrow: posts small blind $0.10
Alameda22: posts big blind $0.25
*** HOLE CARDS ***
Dealt to Alameda22 [2h 9c]
Sandertjeboy: folds 
timboaus: folds 
MissStax: folds 
Nealix87: folds 
Vicolino: folds 
daheights1: calls $0.25
J Burrow: calls $0.15
chris2745 has returned
Alameda22: checks 
*** FLOP *** [Js Jd 7d]
J Burrow: checks 
Alameda22: checks 
daheights1: checks 
*** TURN *** [Js Jd 7d] [3h]
J Burrow: checks 
Alameda22: checks 
daheights1: bets $0.50
J Burrow: folds 
Alameda22: folds 
Uncalled bet ($0.50) returned to daheights1
daheights1 collected $0.75 from pot
daheights1: doesn't show hand 
*** SUMMARY ***
Total pot $0.75 | Rake $0 
Board [Js Jd 7d 3h]
Seat 2: MissStax folded before Flop (didn't bet)
Seat 3: Nealix87 folded before Flop (didn't bet)
Seat 4: Vicolino folded before Flop (didn't bet)
Seat 5: daheights1 (button) collected ($0.75)
Seat 6: J Burrow (small blind) folded on the Turn
Seat 7: Alameda22 (big blind) folded on the Turn
Seat 8: Sandertjeboy folded before Flop (didn't bet)
Seat 9: timboaus folded before Flop (didn't bet)



PokerStars Game #20101699831:  Hold'em No Limit ($0.10/$0.25) - 2008/09/02 19:37:00 ET
Table 'Pomona IV' 9-max Seat #6 is the button
Seat 1: chris2745 ($15.30 in chips) 
Seat 2: MissStax ($26.25 in chips) 
Seat 3: Nealix87 ($23.55 in chips) 
Seat 4: Vicolino ($12.40 in chips) 
Seat 5: daheights1 ($24.75 in chips) 
Seat 6: J Burrow ($46.70 in chips) 
Seat 7: Alameda22 ($23 in chips) 
Seat 8: Sandertjeboy ($30.35 in chips) 
Seat 9: timboaus ($17.10 in chips) 
Alameda22: posts small blind $0.10
Sandertjeboy: posts big blind $0.25
*** HOLE CARDS ***
Dealt to Alameda22 [3h 6d]
timboaus: folds 
chris2745: raises $0.50 to $0.75
MissStax: folds 
Nealix87: folds 
Vicolino: folds 
daheights1: folds 
J Burrow: raises $1.25 to $2
Alameda22: folds 
Sandertjeboy: folds 
chris2745: calls $1.25
*** FLOP *** [2d 5s 4h]
chris2745: bets $2
J Burrow: raises $10.75 to $12.75
chris2745: raises $0.55 to $13.30 and is all-in
J Burrow: calls $0.55
*** TURN *** [2d 5s 4h] [7c]
*** RIVER *** [2d 5s 4h 7c] [Ts]
*** SHOW DOWN ***
chris2745: shows [6s 6c] (a pair of Sixes)
J Burrow: shows [Kd Ks] (a pair of Kings)
J Burrow collected $29.45 from pot
*** SUMMARY ***
Total pot $30.95 | Rake $1.50 
Board [2d 5s 4h 7c Ts]
Seat 1: chris2745 showed [6s 6c] and lost with a pair of Sixes
Seat 2: MissStax folded before Flop (didn't bet)
Seat 3: Nealix87 folded before Flop (didn't bet)
Seat 4: Vicolino folded before Flop (didn't bet)
Seat 5: daheights1 folded before Flop (didn't bet)
Seat 6: J Burrow (button) showed [Kd Ks] and won ($29.45) with a pair of Kings
Seat 7: Alameda22 (small blind) folded before Flop
Seat 8: Sandertjeboy (big blind) folded before Flop
Seat 9: timboaus folded before Flop (didn't bet)



PokerStars Game #20101731838:  Hold'em No Limit ($0.10/$0.25) - 2008/09/02 19:38:29 ET
Table 'Pomona IV' 9-max Seat #7 is the button
Seat 2: MissStax ($26.25 in chips) 
Seat 3: Nealix87 ($23.55 in chips) 
Seat 4: Vicolino ($12.40 in chips) 
Seat 5: daheights1 ($24.75 in chips) 
Seat 6: J Burrow ($60.85 in chips) 
Seat 7: Alameda22 ($22.90 in chips) 
Seat 8: Sandertjeboy ($30.10 in chips) 
Seat 9: timboaus ($17.10 in chips) 
Sandertjeboy: posts small blind $0.10
timboaus: posts big blind $0.25
*** HOLE CARDS ***
Dealt to Alameda22 [Ks Th]
MissStax: folds 
Nealix87: folds 
Vicolino: calls $0.25
daheights1: calls $0.25
J Burrow: folds 
Alameda22: folds 
chris2745 has returned
Sandertjeboy: calls $0.15
timboaus: checks 
*** FLOP *** [8d 4s Ac]
Sandertjeboy: checks 
timboaus: bets $0.75
Vicolino: calls $0.75
daheights1: folds 
Sandertjeboy: folds 
*** TURN *** [8d 4s Ac] [8c]
timboaus: bets $0.70
Vicolino: calls $0.70
*** RIVER *** [8d 4s Ac 8c] [7d]
timboaus: bets $0.60
Vicolino: raises $1.10 to $1.70
timboaus: folds 
Uncalled bet ($1.10) returned to Vicolino
Vicolino collected $4.90 from pot
Vicolino: doesn't show hand 
*** SUMMARY ***
Total pot $5.10 | Rake $0.20 
Board [8d 4s Ac 8c 7d]
Seat 2: MissStax folded before Flop (didn't bet)
Seat 3: Nealix87 folded before Flop (didn't bet)
Seat 4: Vicolino collected ($4.90)
Seat 5: daheights1 folded on the Flop
Seat 6: J Burrow folded before Flop (didn't bet)
Seat 7: Alameda22 (button) folded before Flop (didn't bet)
Seat 8: Sandertjeboy (small blind) folded on the Flop
Seat 9: timboaus (big blind) folded on the River



PokerStars Game #20101771970:  Hold'em No Limit ($0.10/$0.25) - 2008/09/02 19:40:17 ET
Table 'Pomona IV' 9-max Seat #8 is the button
Seat 1: chris2745 ($25 in chips) 
Seat 2: MissStax ($26.25 in chips) 
Seat 3: Nealix87 ($23.55 in chips) 
Seat 4: Vicolino ($15 in chips) 
Seat 5: daheights1 ($24.50 in chips) 
Seat 6: J Burrow ($60.85 in chips) 
Seat 7: Alameda22 ($22.90 in chips) 
Seat 8: Sandertjeboy ($29.85 in chips) 
Seat 9: timboaus ($14.80 in chips) 
timboaus: posts small blind $0.10
chris2745: posts big blind $0.25
*** HOLE CARDS ***
Dealt to Alameda22 [Kd 5c]
MissStax: calls $0.25
Nealix87: folds 
Vicolino: folds 
daheights1: raises $1 to $1.25
J Burrow: calls $1.25
Alameda22: folds 
Sandertjeboy: folds 
timboaus: folds 
chris2745: folds 
MissStax: calls $1
*** FLOP *** [Kc 7d Ks]
MissStax: checks 
daheights1: bets $0.75
J Burrow: folds 
MissStax: folds 
Uncalled bet ($0.75) returned to daheights1
daheights1 collected $3.90 from pot
daheights1: doesn't show hand 
chris2745 is sitting out
*** SUMMARY ***
Total pot $4.10 | Rake $0.20 
Board [Kc 7d Ks]
Seat 1: chris2745 (big blind) folded before Flop
Seat 2: MissStax folded on the Flop
Seat 3: Nealix87 folded before Flop (didn't bet)
Seat 4: Vicolino folded before Flop (didn't bet)
Seat 5: daheights1 collected ($3.90)
Seat 6: J Burrow folded on the Flop
Seat 7: Alameda22 folded before Flop (didn't bet)
Seat 8: Sandertjeboy (button) folded before Flop (didn't bet)
Seat 9: timboaus (small blind) folded before Flop



PokerStars Game #20101796118:  Hold'em No Limit ($0.10/$0.25) - 2008/09/02 19:41:23 ET
Table 'Pomona IV' 9-max Seat #9 is the button
Seat 2: MissStax ($25 in chips) 
Seat 3: Nealix87 ($23.55 in chips) 
Seat 4: Vicolino ($15 in chips) 
Seat 5: daheights1 ($27.15 in chips) 
Seat 6: J Burrow ($59.60 in chips) 
Seat 7: Alameda22 ($22.90 in chips) 
Seat 8: Sandertjeboy ($29.85 in chips) 
Seat 9: timboaus ($14.70 in chips) 
MissStax: posts small blind $0.10
Nealix87: posts big blind $0.25
*** HOLE CARDS ***
Dealt to Alameda22 [7d Td]
chris2745 has returned
Vicolino: folds 
daheights1: folds 
J Burrow: calls $0.25
Alameda22: folds 
Sandertjeboy: calls $0.25
timboaus: folds 
MissStax: folds 
Nealix87: checks 
*** FLOP *** [8s Kd 7h]
Nealix87: checks 
J Burrow: bets $0.50
Sandertjeboy: calls $0.50
Nealix87: folds 
*** TURN *** [8s Kd 7h] [4h]
J Burrow: bets $0.75
Sandertjeboy: calls $0.75
*** RIVER *** [8s Kd 7h 4h] [Ah]
J Burrow: bets $1
Sandertjeboy: raises $2 to $3
J Burrow: raises $4 to $7
Sandertjeboy: raises $5.50 to $12.50
Nealix87 leaves the table
J Burrow: raises $14.50 to $27
Sandertjeboy: raises $1.35 to $28.35 and is all-in
J Burrow: calls $1.35
*** SHOW DOWN ***
Sandertjeboy: shows [8h Jh] (a flush, Ace high)
J Burrow: shows [Th Kh] (a flush, Ace high - King higher)
BufordDalt joins the table at seat #3 
J Burrow collected $57.10 from pot
Sandertjeboy said, "sick"
*** SUMMARY ***
Total pot $60.05 | Rake $2.95 
Board [8s Kd 7h 4h Ah]
Seat 2: MissStax (small blind) folded before Flop
Seat 3: Nealix87 (big blind) folded on the Flop
Seat 4: Vicolino folded before Flop (didn't bet)
Seat 5: daheights1 folded before Flop (didn't bet)
Seat 6: J Burrow showed [Th Kh] and won ($57.10) with a flush, Ace high
Seat 7: Alameda22 folded before Flop (didn't bet)
Seat 8: Sandertjeboy showed [8h Jh] and lost with a flush, Ace high
Seat 9: timboaus (button) folded before Flop (didn't bet)



PokerStars Game #20101842110:  Hold'em No Limit ($0.10/$0.25) - 2008/09/02 19:43:28 ET
Table 'Pomona IV' 9-max Seat #2 is the button
Seat 1: chris2745 ($24.75 in chips) 
Seat 2: MissStax ($24.90 in chips) 
Seat 4: Vicolino ($15 in chips) 
Seat 5: daheights1 ($27.15 in chips) 
Seat 6: J Burrow ($86.85 in chips) 
Seat 7: Alameda22 ($22.90 in chips) 
Seat 9: timboaus ($14.70 in chips) 
BufordDalt will be allowed to play after the button
Vicolino: posts small blind $0.10
daheights1: posts big blind $0.25
chris2745: posts small blind $0.10
*** HOLE CARDS ***
Dealt to Alameda22 [6h 5h]
J Burrow: raises $0.75 to $1
Alameda22: folds 
timboaus: folds 
chris2745: folds 
MissStax: folds 
Vicolino: folds 
daheights1: folds 
Uncalled bet ($0.75) returned to J Burrow
J Burrow collected $0.70 from pot
J Burrow: doesn't show hand 
Sandertjeboy has returned
*** SUMMARY ***
Total pot $0.70 | Rake $0 
Seat 1: chris2745 folded before Flop
Seat 2: MissStax (button) folded before Flop (didn't bet)
Seat 4: Vicolino (small blind) folded before Flop
Seat 5: daheights1 (big blind) folded before Flop
Seat 6: J Burrow collected ($0.70)
Seat 7: Alameda22 folded before Flop (didn't bet)
Seat 9: timboaus folded before Flop (didn't bet)



PokerStars Game #20101859211:  Hold'em No Limit ($0.10/$0.25) - 2008/09/02 19:44:15 ET
Table 'Pomona IV' 9-max Seat #4 is the button
Seat 1: chris2745 ($24.65 in chips) 
Seat 2: MissStax ($24.90 in chips) 
Seat 4: Vicolino ($14.90 in chips) 
Seat 5: daheights1 ($26.90 in chips) 
Seat 6: J Burrow ($87.30 in chips) 
Seat 7: Alameda22 ($22.90 in chips) 
Seat 8: Sandertjeboy ($25 in chips) 
Seat 9: timboaus ($14.70 in chips) 
daheights1: posts small blind $0.10
J Burrow: posts big blind $0.25
BufordDalt: sits out 
*** HOLE CARDS ***
Dealt to Alameda22 [6s 9c]
Alameda22: folds 
Sandertjeboy: raises $0.50 to $0.75
timboaus: folds 
chris2745: folds 
MissStax: folds 
Vicolino: folds 
daheights1: calls $0.65
J Burrow: calls $0.50
*** FLOP *** [5d 4c 5s]
daheights1: bets $1.50
J Burrow: folds 
Sandertjeboy: calls $1.50
*** TURN *** [5d 4c 5s] [Kc]
daheights1: bets $1.50
Sandertjeboy: calls $1.50
*** RIVER *** [5d 4c 5s Kc] [Qc]
daheights1: checks 
Sandertjeboy: checks 
*** SHOW DOWN ***
daheights1: shows [Jh Jd] (two pair, Jacks and Fives)
Sandertjeboy: mucks hand 
daheights1 collected $7.85 from pot
*** SUMMARY ***
Total pot $8.25 | Rake $0.40 
Board [5d 4c 5s Kc Qc]
Seat 1: chris2745 folded before Flop (didn't bet)
Seat 2: MissStax folded before Flop (didn't bet)
Seat 4: Vicolino (button) folded before Flop (didn't bet)
Seat 5: daheights1 (small blind) showed [Jh Jd] and won ($7.85) with two pair, Jacks and Fives
Seat 6: J Burrow (big blind) folded on the Flop
Seat 7: Alameda22 folded before Flop (didn't bet)
Seat 8: Sandertjeboy mucked [Th Td]
Seat 9: timboaus folded before Flop (didn't bet)



PokerStars Game #20101881262:  Hold'em No Limit ($0.10/$0.25) - 2008/09/02 19:45:15 ET
Table 'Pomona IV' 9-max Seat #5 is the button
Seat 1: chris2745 ($24.65 in chips) 
Seat 2: MissStax ($24.90 in chips) 
Seat 4: Vicolino ($14.90 in chips) 
Seat 5: daheights1 ($31 in chips) 
Seat 6: J Burrow ($86.55 in chips) 
Seat 7: Alameda22 ($22.90 in chips) 
Seat 8: Sandertjeboy ($25 in chips) 
Seat 9: timboaus ($14.70 in chips) 
J Burrow: posts small blind $0.10
Alameda22: posts big blind $0.25
BufordDalt: sits out 
*** HOLE CARDS ***
Dealt to Alameda22 [5c 3c]
Sandertjeboy: folds 
timboaus: folds 
chris2745: folds 
MissStax: folds 
Vicolino: folds 
daheights1: folds 
J Burrow: folds 
Uncalled bet ($0.15) returned to Alameda22
Alameda22 collected $0.20 from pot
Alameda22: doesn't show hand 
*** SUMMARY ***
Total pot $0.20 | Rake $0 
Seat 1: chris2745 folded before Flop (didn't bet)
Seat 2: MissStax folded before Flop (didn't bet)
Seat 4: Vicolino folded before Flop (didn't bet)
Seat 5: daheights1 (button) folded before Flop (didn't bet)
Seat 6: J Burrow (small blind) folded before Flop
Seat 7: Alameda22 (big blind) collected ($0.20)
Seat 8: Sandertjeboy folded before Flop (didn't bet)
Seat 9: timboaus folded before Flop (didn't bet)



PokerStars Game #20101891484:  Hold'em No Limit ($0.10/$0.25) - 2008/09/02 19:45:43 ET
Table 'Pomona IV' 9-max Seat #6 is the button
Seat 1: chris2745 ($24.65 in chips) 
Seat 2: MissStax ($24.90 in chips) 
Seat 4: Vicolino ($14.90 in chips) 
Seat 5: daheights1 ($31 in chips) 
Seat 6: J Burrow ($86.45 in chips) 
Seat 7: Alameda22 ($23 in chips) 
Seat 8: Sandertjeboy ($25 in chips) 
Seat 9: timboaus ($14.70 in chips) 
Alameda22: posts small blind $0.10
Sandertjeboy: posts big blind $0.25
BufordDalt: sits out 
*** HOLE CARDS ***
Dealt to Alameda22 [7d Jc]
timboaus: folds 
chris2745: calls $0.25
MissStax: folds 
Vicolino: calls $0.25
daheights1: folds 
J Burrow: raises $0.75 to $1
Alameda22: folds 
Sandertjeboy: folds 
chris2745: folds 
Vicolino: folds 
Uncalled bet ($0.75) returned to J Burrow
J Burrow collected $1.10 from pot
J Burrow: doesn't show hand 
*** SUMMARY ***
Total pot $1.10 | Rake $0 
Seat 1: chris2745 folded before Flop
Seat 2: MissStax folded before Flop (didn't bet)
Seat 4: Vicolino folded before Flop
Seat 5: daheights1 folded before Flop (didn't bet)
Seat 6: J Burrow (button) collected ($1.10)
Seat 7: Alameda22 (small blind) folded before Flop
Seat 8: Sandertjeboy (big blind) folded before Flop
Seat 9: timboaus folded before Flop (didn't bet)



PokerStars Game #20101904099:  Hold'em No Limit ($0.10/$0.25) - 2008/09/02 19:46:17 ET
Table 'Pomona IV' 9-max Seat #7 is the button
Seat 1: chris2745 ($24.40 in chips) 
Seat 2: MissStax ($24.90 in chips) 
Seat 4: Vicolino ($14.65 in chips) 
Seat 5: daheights1 ($31 in chips) 
Seat 6: J Burrow ($87.30 in chips) 
Seat 7: Alameda22 ($22.90 in chips) 
Seat 8: Sandertjeboy ($24.75 in chips) 
Seat 9: timboaus ($14.70 in chips) 
Sandertjeboy: posts small blind $0.10
timboaus: posts big blind $0.25
BufordDalt: sits out 
*** HOLE CARDS ***
Dealt to Alameda22 [Jd Kh]
chris2745: calls $0.25
MissStax: folds 
Vicolino: folds 
daheights1: folds 
J Burrow: folds 
Alameda22: folds 
Sandertjeboy: folds 
timboaus: checks 
*** FLOP *** [3d 7d 3c]
timboaus: bets $0.50
chris2745: folds 
Uncalled bet ($0.50) returned to timboaus
timboaus collected $0.60 from pot
timboaus: doesn't show hand 
*** SUMMARY ***
Total pot $0.60 | Rake $0 
Board [3d 7d 3c]
Seat 1: chris2745 folded on the Flop
Seat 2: MissStax folded before Flop (didn't bet)
Seat 4: Vicolino folded before Flop (didn't bet)
Seat 5: daheights1 folded before Flop (didn't bet)
Seat 6: J Burrow folded before Flop (didn't bet)
Seat 7: Alameda22 (button) folded before Flop (didn't bet)
Seat 8: Sandertjeboy (small blind) folded before Flop
Seat 9: timboaus (big blind) collected ($0.60)



PokerStars Game #20101926728:  Hold'em No Limit ($0.10/$0.25) - 2008/09/02 19:47:21 ET
Table 'Pomona IV' 9-max Seat #8 is the button
Seat 1: chris2745 ($24.15 in chips) 
Seat 2: MissStax ($24.90 in chips) 
Seat 4: Vicolino ($14.65 in chips) 
Seat 5: daheights1 ($31 in chips) 
Seat 6: J Burrow ($87.30 in chips) 
Seat 7: Alameda22 ($22.90 in chips) 
Seat 8: Sandertjeboy ($24.65 in chips) 
Seat 9: timboaus ($15.05 in chips) 
timboaus: posts small blind $0.10
chris2745: posts big blind $0.25
BufordDalt: sits out 
*** HOLE CARDS ***
Dealt to Alameda22 [8h 7h]
MissStax: folds 
Vicolino: folds 
daheights1: folds 
daheights1 leaves the table
J Burrow: folds 
Alameda22: folds 
Sandertjeboy: calls $0.25
timboaus: raises $0.85 to $1.10
chris2745: folds 
Sandertjeboy: calls $0.85
*** FLOP *** [Kc Kd 3s]
timboaus: bets $2.10
Sandertjeboy: folds 
Uncalled bet ($2.10) returned to timboaus
timboaus collected $2.35 from pot
timboaus: doesn't show hand 
*** SUMMARY ***
Total pot $2.45 | Rake $0.10 
Board [Kc Kd 3s]
Seat 1: chris2745 (big blind) folded before Flop
Seat 2: MissStax folded before Flop (didn't bet)
Seat 4: Vicolino folded before Flop (didn't bet)
Seat 5: daheights1 folded before Flop (didn't bet)
Seat 6: J Burrow folded before Flop (didn't bet)
Seat 7: Alameda22 folded before Flop (didn't bet)
Seat 8: Sandertjeboy (button) folded on the Flop
Seat 9: timboaus (small blind) collected ($2.35)



PokerStars Game #20101946338:  Hold'em No Limit ($0.10/$0.25) - 2008/09/02 19:48:14 ET
Table 'Pomona IV' 9-max Seat #9 is the button
Seat 1: chris2745 ($23.90 in chips) 
Seat 2: MissStax ($24.90 in chips) 
Seat 4: Vicolino ($14.65 in chips) 
Seat 6: J Burrow ($87.30 in chips) 
Seat 7: Alameda22 ($22.90 in chips) 
Seat 8: Sandertjeboy ($23.55 in chips) 
Seat 9: timboaus ($16.30 in chips) 
chris2745: posts small blind $0.10
MissStax: posts big blind $0.25
BufordDalt: sits out 
*** HOLE CARDS ***
Dealt to Alameda22 [7s 9c]
Vicolino: folds 
J Burrow: folds 
Alameda22: folds 
Sandertjeboy: raises $0.50 to $0.75
timboaus: folds 
chris2745: folds 
geosat joins the table at seat #5 
MissStax: folds 
Uncalled bet ($0.50) returned to Sandertjeboy
Sandertjeboy collected $0.60 from pot
*** SUMMARY ***
Total pot $0.60 | Rake $0 
Seat 1: chris2745 (small blind) folded before Flop
Seat 2: MissStax (big blind) folded before Flop
Seat 4: Vicolino folded before Flop (didn't bet)
Seat 6: J Burrow folded before Flop (didn't bet)
Seat 7: Alameda22 folded before Flop (didn't bet)
Seat 8: Sandertjeboy collected ($0.60)
Seat 9: timboaus (button) folded before Flop (didn't bet)



PokerStars Game #20101960011:  Hold'em No Limit ($0.10/$0.25) - 2008/09/02 19:48:52 ET
Table 'Pomona IV' 9-max Seat #1 is the button
Seat 1: chris2745 ($23.80 in chips) 
Seat 2: MissStax ($24.65 in chips) 
Seat 3: BufordDalt ($7 in chips) 
Seat 4: Vicolino ($14.65 in chips) 
Seat 6: J Burrow ($87.30 in chips) 
Seat 7: Alameda22 ($22.90 in chips) 
Seat 8: Sandertjeboy ($23.90 in chips) 
Seat 9: timboaus ($16.30 in chips) 
MissStax: posts small blind $0.10
BufordDalt: posts big blind $0.25
geosat: sits out 
*** HOLE CARDS ***
Dealt to Alameda22 [9h 5d]
Vicolino: folds 
J Burrow: folds 
Alameda22: folds 
Sandertjeboy: raises $0.50 to $0.75
timboaus: folds 
chris2745: folds 
MissStax: folds 
BufordDalt: folds 
Uncalled bet ($0.50) returned to Sandertjeboy
Sandertjeboy collected $0.60 from pot
*** SUMMARY ***
Total pot $0.60 | Rake $0 
Seat 1: chris2745 (button) folded before Flop (didn't bet)
Seat 2: MissStax (small blind) folded before Flop
Seat 3: BufordDalt (big blind) folded before Flop
Seat 4: Vicolino folded before Flop (didn't bet)
Seat 6: J Burrow folded before Flop (didn't bet)
Seat 7: Alameda22 folded before Flop (didn't bet)
Seat 8: Sandertjeboy collected ($0.60)
Seat 9: timboaus folded before Flop (didn't bet)



PokerStars Game #20101971192:  Hold'em No Limit ($0.10/$0.25) - 2008/09/02 19:49:23 ET
Table 'Pomona IV' 9-max Seat #2 is the button
Seat 1: chris2745 ($23.80 in chips) 
Seat 2: MissStax ($24.55 in chips) 
Seat 3: BufordDalt ($6.75 in chips) 
Seat 5: geosat ($25 in chips) 
Seat 6: J Burrow ($87.30 in chips) 
Seat 7: Alameda22 ($22.90 in chips) 
Seat 8: Sandertjeboy ($24.25 in chips) 
Seat 9: timboaus ($16.30 in chips) 
BufordDalt: posts small blind $0.10
Vicolino: is sitting out 
geosat: posts big blind $0.25
*** HOLE CARDS ***
Dealt to Alameda22 [As Th]
Vicolino leaves the table
J Burrow: calls $0.25
Alameda22: folds 
Sandertjeboy: folds 
wasserss joins the table at seat #4 
timboaus: raises $0.95 to $1.20
chris2745: folds 
MissStax: folds 
BufordDalt: folds 
geosat: folds 
J Burrow: calls $0.95
*** FLOP *** [Jh Qc 8d]
J Burrow: checks 
timboaus: bets $1.20
J Burrow: raises $3.80 to $5
timboaus: folds 
Uncalled bet ($3.80) returned to J Burrow
J Burrow collected $4.90 from pot
J Burrow: doesn't show hand 
*** SUMMARY ***
Total pot $5.15 | Rake $0.25 
Board [Jh Qc 8d]
Seat 1: chris2745 folded before Flop (didn't bet)
Seat 2: MissStax (button) folded before Flop (didn't bet)
Seat 3: BufordDalt (small blind) folded before Flop
Seat 5: geosat (big blind) folded before Flop
Seat 6: J Burrow collected ($4.90)
Seat 7: Alameda22 folded before Flop (didn't bet)
Seat 8: Sandertjeboy folded before Flop (didn't bet)
Seat 9: timboaus folded on the Flop



PokerStars Game #20101994499:  Hold'em No Limit ($0.10/$0.25) - 2008/09/02 19:50:27 ET
Table 'Pomona IV' 9-max Seat #3 is the button
Seat 1: chris2745 ($23.80 in chips) 
Seat 2: MissStax ($24.55 in chips) 
Seat 3: BufordDalt ($6.65 in chips) 
Seat 5: geosat ($24.75 in chips) 
Seat 6: J Burrow ($89.80 in chips) 
Seat 7: Alameda22 ($22.90 in chips) 
Seat 8: Sandertjeboy ($24.25 in chips) 
Seat 9: timboaus ($13.90 in chips) 
wasserss will be allowed to play after the button
geosat: posts small blind $0.10
J Burrow: posts big blind $0.25
*** HOLE CARDS ***
Dealt to Alameda22 [9s 8d]
Alameda22: folds 
Sandertjeboy: raises $0.50 to $0.75
timboaus: folds 
chris2745: folds 
MissStax: folds 
BufordDalt: folds 
geosat: calls $0.65
J Burrow: folds 
*** FLOP *** [Th 4d 4s]
geosat: checks 
Sandertjeboy: bets $0.75
geosat: folds 
Uncalled bet ($0.75) returned to Sandertjeboy
Sandertjeboy collected $1.70 from pot
*** SUMMARY ***
Total pot $1.75 | Rake $0.05 
Board [Th 4d 4s]
Seat 1: chris2745 folded before Flop (didn't bet)
Seat 2: MissStax folded before Flop (didn't bet)
Seat 3: BufordDalt (button) folded before Flop (didn't bet)
Seat 5: geosat (small blind) folded on the Flop
Seat 6: J Burrow (big blind) folded before Flop
Seat 7: Alameda22 folded before Flop (didn't bet)
Seat 8: Sandertjeboy collected ($1.70)
Seat 9: timboaus folded before Flop (didn't bet)



PokerStars Game #20102010863:  Hold'em No Limit ($0.10/$0.25) - 2008/09/02 19:51:12 ET
Table 'Pomona IV' 9-max Seat #5 is the button
Seat 1: chris2745 ($25 in chips) 
Seat 2: MissStax ($24.55 in chips) 
Seat 3: BufordDalt ($6.65 in chips) 
Seat 4: wasserss ($5 in chips) 
Seat 5: geosat ($25 in chips) 
Seat 6: J Burrow ($89.55 in chips) 
Seat 7: Alameda22 ($22.90 in chips) 
Seat 8: Sandertjeboy ($25.20 in chips) 
Seat 9: timboaus ($13.90 in chips) 
J Burrow: posts small blind $0.10
Alameda22: posts big blind $0.25
wasserss: posts big blind $0.25
*** HOLE CARDS ***
Dealt to Alameda22 [2d Jc]
Sandertjeboy: folds 
timboaus: folds 
chris2745: folds 
MissStax: folds 
BufordDalt: folds 
wasserss: checks 
geosat: raises $1 to $1.25
J Burrow: folds 
Alameda22: folds 
wasserss: folds 
Uncalled bet ($1) returned to geosat
geosat collected $0.85 from pot
geosat: doesn't show hand 
*** SUMMARY ***
Total pot $0.85 | Rake $0 
Seat 1: chris2745 folded before Flop (didn't bet)
Seat 2: MissStax folded before Flop (didn't bet)
Seat 3: BufordDalt folded before Flop (didn't bet)
Seat 4: wasserss folded before Flop
Seat 5: geosat (button) collected ($0.85)
Seat 6: J Burrow (small blind) folded before Flop
Seat 7: Alameda22 (big blind) folded before Flop
Seat 8: Sandertjeboy folded before Flop (didn't bet)
Seat 9: timboaus folded before Flop (didn't bet)



PokerStars Game #20102025661:  Hold'em No Limit ($0.10/$0.25) - 2008/09/02 19:51:54 ET
Table 'Pomona IV' 9-max Seat #6 is the button
Seat 1: chris2745 ($25 in chips) 
Seat 2: MissStax ($24.55 in chips) 
Seat 3: BufordDalt ($6.65 in chips) 
Seat 4: wasserss ($4.75 in chips) 
Seat 5: geosat ($25.60 in chips) 
Seat 6: J Burrow ($89.45 in chips) 
Seat 7: Alameda22 ($22.65 in chips) 
Seat 8: Sandertjeboy ($25.20 in chips) 
Seat 9: timboaus ($13.90 in chips) 
Alameda22: posts small blind $0.10
Sandertjeboy: posts big blind $0.25
*** HOLE CARDS ***
Dealt to Alameda22 [3s 4s]
timboaus: folds 
chris2745: folds 
MissStax: folds 
BufordDalt: folds 
wasserss: folds 
geosat: folds 
J Burrow: folds 
Alameda22: folds 
Uncalled bet ($0.15) returned to Sandertjeboy
Sandertjeboy collected $0.20 from pot
*** SUMMARY ***
Total pot $0.20 | Rake $0 
Seat 1: chris2745 folded before Flop (didn't bet)
Seat 2: MissStax folded before Flop (didn't bet)
Seat 3: BufordDalt folded before Flop (didn't bet)
Seat 4: wasserss folded before Flop (didn't bet)
Seat 5: geosat folded before Flop (didn't bet)
Seat 6: J Burrow (button) folded before Flop (didn't bet)
Seat 7: Alameda22 (small blind) folded before Flop
Seat 8: Sandertjeboy (big blind) collected ($0.20)
Seat 9: timboaus folded before Flop (didn't bet)



PokerStars Game #20102041672:  Hold'em No Limit ($0.10/$0.25) - 2008/09/02 19:52:38 ET
Table 'Pomona IV' 9-max Seat #7 is the button
Seat 1: chris2745 ($25 in chips) 
Seat 2: MissStax ($24.55 in chips) 
Seat 3: BufordDalt ($6.65 in chips) 
Seat 4: wasserss ($4.75 in chips) 
Seat 5: geosat ($25.60 in chips) 
Seat 6: J Burrow ($89.45 in chips) 
Seat 7: Alameda22 ($22.55 in chips) 
Seat 8: Sandertjeboy ($25.30 in chips) 
Seat 9: timboaus ($13.90 in chips) 
Sandertjeboy: posts small blind $0.10
timboaus: posts big blind $0.25
*** HOLE CARDS ***
Dealt to Alameda22 [Td 9d]
chris2745: folds 
MissStax: folds 
BufordDalt: folds 
wasserss: folds 
geosat: calls $0.25
J Burrow: folds 
Alameda22: calls $0.25
Sandertjeboy: calls $0.15
timboaus: checks 
*** FLOP *** [5c 8h 4h]
Sandertjeboy: checks 
timboaus: checks 
geosat: bets $0.75
Alameda22: folds 
MissStax is sitting out
Sandertjeboy: calls $0.75
timboaus: folds 
*** TURN *** [5c 8h 4h] [Qc]
Sandertjeboy: checks 
geosat: bets $2.25
Sandertjeboy: folds 
Uncalled bet ($2.25) returned to geosat
geosat collected $2.40 from pot
geosat: doesn't show hand 
*** SUMMARY ***
Total pot $2.50 | Rake $0.10 
Board [5c 8h 4h Qc]
Seat 1: chris2745 folded before Flop (didn't bet)
Seat 2: MissStax folded before Flop (didn't bet)
Seat 3: BufordDalt folded before Flop (didn't bet)
Seat 4: wasserss folded before Flop (didn't bet)
Seat 5: geosat collected ($2.40)
Seat 6: J Burrow folded before Flop (didn't bet)
Seat 7: Alameda22 (button) folded on the Flop
Seat 8: Sandertjeboy (small blind) folded on the Turn
Seat 9: timboaus (big blind) folded on the Flop



PokerStars Game #20102070867:  Hold'em No Limit ($0.10/$0.25) - 2008/09/02 19:53:58 ET
Table 'Pomona IV' 9-max Seat #8 is the button
Seat 1: chris2745 ($25 in chips) 
Seat 3: BufordDalt ($6.65 in chips) 
Seat 4: wasserss ($4.75 in chips) 
Seat 5: geosat ($27 in chips) 
Seat 6: J Burrow ($89.45 in chips) 
Seat 7: Alameda22 ($22.30 in chips) 
Seat 8: Sandertjeboy ($24.30 in chips) 
Seat 9: timboaus ($13.65 in chips) 
timboaus: posts small blind $0.10
chris2745: posts big blind $0.25
*** HOLE CARDS ***
Dealt to Alameda22 [8s 7h]
BufordDalt: folds 
wasserss: folds 
geosat: folds 
J Burrow: folds 
Alameda22: folds 
Sandertjeboy: folds 
timboaus: raises $0.95 to $1.20
chris2745: folds 
Uncalled bet ($0.95) returned to timboaus
timboaus collected $0.50 from pot
timboaus: doesn't show hand 
*** SUMMARY ***
Total pot $0.50 | Rake $0 
Seat 1: chris2745 (big blind) folded before Flop
Seat 3: BufordDalt folded before Flop (didn't bet)
Seat 4: wasserss folded before Flop (didn't bet)
Seat 5: geosat folded before Flop (didn't bet)
Seat 6: J Burrow folded before Flop (didn't bet)
Seat 7: Alameda22 folded before Flop (didn't bet)
Seat 8: Sandertjeboy (button) folded before Flop (didn't bet)
Seat 9: timboaus (small blind) collected ($0.50)



PokerStars Game #20102084693:  Hold'em No Limit ($0.10/$0.25) - 2008/09/02 19:54:36 ET
Table 'Pomona IV' 9-max Seat #9 is the button
Seat 1: chris2745 ($24.75 in chips) 
Seat 3: BufordDalt ($6.65 in chips) 
Seat 4: wasserss ($4.75 in chips) 
Seat 5: geosat ($27 in chips) 
Seat 6: J Burrow ($89.45 in chips) 
Seat 7: Alameda22 ($22.30 in chips) 
Seat 8: Sandertjeboy ($24.30 in chips) 
Seat 9: timboaus ($13.90 in chips) 
chris2745: posts small blind $0.10
BufordDalt: posts big blind $0.25
*** HOLE CARDS ***
Dealt to Alameda22 [9s Kh]
wasserss: folds 
geosat: folds 
J Burrow: folds 
Alameda22: folds 
Sandertjeboy: calls $0.25
timboaus: folds 
chris2745: calls $0.15
BufordDalt: checks 
*** FLOP *** [Kc 6s 8s]
chris2745: checks 
BufordDalt: checks 
Sandertjeboy: checks 
*** TURN *** [Kc 6s 8s] [Ks]
chris2745: checks 
BufordDalt: checks 
Sandertjeboy: checks 
*** RIVER *** [Kc 6s 8s Ks] [4s]
chris2745: bets $0.50
BufordDalt: folds 
Sandertjeboy: folds 
Uncalled bet ($0.50) returned to chris2745
chris2745 collected $0.75 from pot
chris2745: doesn't show hand 
*** SUMMARY ***
Total pot $0.75 | Rake $0 
Board [Kc 6s 8s Ks 4s]
Seat 1: chris2745 (small blind) collected ($0.75)
Seat 3: BufordDalt (big blind) folded on the River
Seat 4: wasserss folded before Flop (didn't bet)
Seat 5: geosat folded before Flop (didn't bet)
Seat 6: J Burrow folded before Flop (didn't bet)
Seat 7: Alameda22 folded before Flop (didn't bet)
Seat 8: Sandertjeboy folded on the River
Seat 9: timboaus (button) folded before Flop (didn't bet)



PokerStars Game #20102107039:  Hold'em No Limit ($0.10/$0.25) - 2008/09/02 19:55:37 ET
Table 'Pomona IV' 9-max Seat #1 is the button
Seat 1: chris2745 ($25.25 in chips) 
Seat 3: BufordDalt ($6.40 in chips) 
Seat 4: wasserss ($4.75 in chips) 
Seat 5: geosat ($27 in chips) 
Seat 6: J Burrow ($89.45 in chips) 
Seat 7: Alameda22 ($22.30 in chips) 
Seat 8: Sandertjeboy ($24.05 in chips) 
Seat 9: timboaus ($13.90 in chips) 
BufordDalt: posts small blind $0.10
wasserss: posts big blind $0.25
*** HOLE CARDS ***
Dealt to Alameda22 [Ac 7s]
geosat: folds 
J Burrow: folds 
Alameda22: folds 
Sandertjeboy: folds 
timboaus: raises $1.05 to $1.30
chris2745: folds 
BufordDalt: folds 
wasserss: folds 
Uncalled bet ($1.05) returned to timboaus
timboaus collected $0.60 from pot
timboaus: doesn't show hand 
*** SUMMARY ***
Total pot $0.60 | Rake $0 
Seat 1: chris2745 (button) folded before Flop (didn't bet)
Seat 3: BufordDalt (small blind) folded before Flop
Seat 4: wasserss (big blind) folded before Flop
Seat 5: geosat folded before Flop (didn't bet)
Seat 6: J Burrow folded before Flop (didn't bet)
Seat 7: Alameda22 folded before Flop (didn't bet)
Seat 8: Sandertjeboy folded before Flop (didn't bet)
Seat 9: timboaus collected ($0.60)



PokerStars Game #20102125098:  Hold'em No Limit ($0.10/$0.25) - 2008/09/02 19:56:26 ET
Table 'Pomona IV' 9-max Seat #3 is the button
Seat 1: chris2745 ($25.25 in chips) 
Seat 3: BufordDalt ($6.30 in chips) 
Seat 4: wasserss ($4.50 in chips) 
Seat 5: geosat ($27 in chips) 
Seat 6: J Burrow ($89.45 in chips) 
Seat 7: Alameda22 ($22.30 in chips) 
Seat 8: Sandertjeboy ($24.05 in chips) 
Seat 9: timboaus ($14.25 in chips) 
wasserss: posts small blind $0.10
geosat: posts big blind $0.25
*** HOLE CARDS ***
Dealt to Alameda22 [7c 3h]
J Burrow: calls $0.25
Alameda22: folds 
Sandertjeboy: folds 
timboaus: folds 
chris2745: folds 
BufordDalt: folds 
wasserss: raises $1.25 to $1.50
geosat: folds 
J Burrow: folds 
Uncalled bet ($1.25) returned to wasserss
wasserss collected $0.75 from pot
wasserss: doesn't show hand 
*** SUMMARY ***
Total pot $0.75 | Rake $0 
Seat 1: chris2745 folded before Flop (didn't bet)
Seat 3: BufordDalt (button) folded before Flop (didn't bet)
Seat 4: wasserss (small blind) collected ($0.75)
Seat 5: geosat (big blind) folded before Flop
Seat 6: J Burrow folded before Flop
Seat 7: Alameda22 folded before Flop (didn't bet)
Seat 8: Sandertjeboy folded before Flop (didn't bet)
Seat 9: timboaus folded before Flop (didn't bet)



PokerStars Game #20102138973:  Hold'em No Limit ($0.10/$0.25) - 2008/09/02 19:57:04 ET
Table 'Pomona IV' 9-max Seat #4 is the button
Seat 1: chris2745 ($25.25 in chips) 
Seat 3: BufordDalt ($6.30 in chips) 
Seat 4: wasserss ($5 in chips) 
Seat 5: geosat ($26.75 in chips) 
Seat 6: J Burrow ($89.20 in chips) 
Seat 7: Alameda22 ($22.30 in chips) 
Seat 8: Sandertjeboy ($24.05 in chips) 
Seat 9: timboaus ($14.25 in chips) 
geosat: posts small blind $0.10
J Burrow: posts big blind $0.25
*** HOLE CARDS ***
Dealt to Alameda22 [5d 6h]
Alameda22: folds 
Sandertjeboy: folds 
timboaus: folds 
chris2745: calls $0.25
BufordDalt: folds 
wasserss: folds 
geosat: folds 
J Burrow: checks 
*** FLOP *** [3c 4d 8d]
J Burrow: checks 
chris2745: bets $0.25
J Burrow: calls $0.25
*** TURN *** [3c 4d 8d] [7d]
J Burrow: checks 
chris2745: checks 
*** RIVER *** [3c 4d 8d 7d] [Th]
J Burrow: checks 
chris2745: checks 
*** SHOW DOWN ***
J Burrow: shows [Ks Qd] (high card King)
chris2745: shows [9c Ah] (high card Ace)
chris2745 collected $1.05 from pot
*** SUMMARY ***
Total pot $1.10 | Rake $0.05 
Board [3c 4d 8d 7d Th]
Seat 1: chris2745 showed [9c Ah] and won ($1.05) with high card Ace
Seat 3: BufordDalt folded before Flop (didn't bet)
Seat 4: wasserss (button) folded before Flop (didn't bet)
Seat 5: geosat (small blind) folded before Flop
Seat 6: J Burrow (big blind) showed [Ks Qd] and lost with high card King
Seat 7: Alameda22 folded before Flop (didn't bet)
Seat 8: Sandertjeboy folded before Flop (didn't bet)
Seat 9: timboaus folded before Flop (didn't bet)



PokerStars Game #20102160241:  Hold'em No Limit ($0.10/$0.25) - 2008/09/02 19:58:03 ET
Table 'Pomona IV' 9-max Seat #5 is the button
Seat 1: chris2745 ($25.80 in chips) 
Seat 3: BufordDalt ($6.30 in chips) 
Seat 4: wasserss ($5 in chips) 
Seat 5: geosat ($26.65 in chips) 
Seat 6: J Burrow ($88.70 in chips) 
Seat 7: Alameda22 ($22.30 in chips) 
Seat 8: Sandertjeboy ($24.05 in chips) 
Seat 9: timboaus ($14.25 in chips) 
J Burrow: posts small blind $0.10
Alameda22: posts big blind $0.25
*** HOLE CARDS ***
Dealt to Alameda22 [Td As]
Sandertjeboy: calls $0.25
timboaus: folds 
chris2745: calls $0.25
BufordDalt: folds 
wasserss: folds 
geosat: folds 
J Burrow: calls $0.15
Alameda22: checks 
*** FLOP *** [5d Qh Jh]
J Burrow: checks 
Alameda22: checks 
Sandertjeboy: checks 
chris2745: bets $0.75
J Burrow: folds 
Alameda22: folds 
Sandertjeboy: folds 
Uncalled bet ($0.75) returned to chris2745
chris2745 collected $0.95 from pot
chris2745: doesn't show hand 
*** SUMMARY ***
Total pot $1 | Rake $0.05 
Board [5d Qh Jh]
Seat 1: chris2745 collected ($0.95)
Seat 3: BufordDalt folded before Flop (didn't bet)
Seat 4: wasserss folded before Flop (didn't bet)
Seat 5: geosat (button) folded before Flop (didn't bet)
Seat 6: J Burrow (small blind) folded on the Flop
Seat 7: Alameda22 (big blind) folded on the Flop
Seat 8: Sandertjeboy folded on the Flop
Seat 9: timboaus folded before Flop (didn't bet)



PokerStars Game #20102180858:  Hold'em No Limit ($0.10/$0.25) - 2008/09/02 19:59:00 ET
Table 'Pomona IV' 9-max Seat #6 is the button
Seat 1: chris2745 ($26.50 in chips) 
Seat 3: BufordDalt ($6.30 in chips) 
Seat 4: wasserss ($5 in chips) 
Seat 5: geosat ($26.65 in chips) 
Seat 6: J Burrow ($88.45 in chips) 
Seat 7: Alameda22 ($22.05 in chips) 
Seat 8: Sandertjeboy ($23.80 in chips) 
Seat 9: timboaus ($14.25 in chips) 
Alameda22: posts small blind $0.10
Sandertjeboy: posts big blind $0.25
*** HOLE CARDS ***
Dealt to Alameda22 [5d 9c]
timboaus: folds 
chris2745: folds 
BufordDalt: folds 
wasserss: folds 
geosat: folds 
J Burrow: folds 
Alameda22: folds 
Uncalled bet ($0.15) returned to Sandertjeboy
Sandertjeboy collected $0.20 from pot
*** SUMMARY ***
Total pot $0.20 | Rake $0 
Seat 1: chris2745 folded before Flop (didn't bet)
Seat 3: BufordDalt folded before Flop (didn't bet)
Seat 4: wasserss folded before Flop (didn't bet)
Seat 5: geosat folded before Flop (didn't bet)
Seat 6: J Burrow (button) folded before Flop (didn't bet)
Seat 7: Alameda22 (small blind) folded before Flop
Seat 8: Sandertjeboy (big blind) collected ($0.20)
Seat 9: timboaus folded before Flop (didn't bet)



PokerStars Game #20102193272:  Hold'em No Limit ($0.10/$0.25) - 2008/09/02 19:59:35 ET
Table 'Pomona IV' 9-max Seat #7 is the button
Seat 1: chris2745 ($26.50 in chips) 
Seat 3: BufordDalt ($6.30 in chips) 
Seat 4: wasserss ($5 in chips) 
Seat 5: geosat ($26.65 in chips) 
Seat 6: J Burrow ($88.45 in chips) 
Seat 7: Alameda22 ($21.95 in chips) 
Seat 8: Sandertjeboy ($23.90 in chips) 
Seat 9: timboaus ($14.25 in chips) 
Sandertjeboy: posts small blind $0.10
timboaus: posts big blind $0.25
*** HOLE CARDS ***
Dealt to Alameda22 [Jc 2s]
chris2745: folds 
BufordDalt: folds 
wasserss: folds 
geosat: folds 
J Burrow: calls $0.25
Alameda22: folds 
Sandertjeboy: calls $0.15
timboaus: checks 
*** FLOP *** [7c 8d Ks]
Sandertjeboy: checks 
timboaus: checks 
J Burrow: bets $0.50
Sandertjeboy: folds 
timboaus: folds 
Uncalled bet ($0.50) returned to J Burrow
J Burrow collected $0.75 from pot
J Burrow: doesn't show hand 
*** SUMMARY ***
Total pot $0.75 | Rake $0 
Board [7c 8d Ks]
Seat 1: chris2745 folded before Flop (didn't bet)
Seat 3: BufordDalt folded before Flop (didn't bet)
Seat 4: wasserss folded before Flop (didn't bet)
Seat 5: geosat folded before Flop (didn't bet)
Seat 6: J Burrow collected ($0.75)
Seat 7: Alameda22 (button) folded before Flop (didn't bet)
Seat 8: Sandertjeboy (small blind) folded on the Flop
Seat 9: timboaus (big blind) folded on the Flop



PokerStars Game #20102214925:  Hold'em No Limit ($0.10/$0.25) - 2008/09/02 20:00:32 ET
Table 'Pomona IV' 9-max Seat #8 is the button
Seat 5: geosat ($26.65 in chips) 
Seat 6: J Burrow ($88.95 in chips) 
Seat 7: Alameda22 ($21.95 in chips) 
Seat 8: Sandertjeboy ($23.65 in chips) 
Seat 9: timboaus ($14 in chips) 
timboaus: posts small blind $0.10
chris2745 has timed out
chris2745: is sitting out 
BufordDalt: is sitting out 
BufordDalt leaves the table
wasserss: is sitting out 
wasserss leaves the table
geosat: posts big blind $0.25
*** HOLE CARDS ***
Dealt to Alameda22 [Ac 7c]
J Burrow: folds 
MissStax has returned
Alameda22: folds 
chris2745 leaves the table
Sandertjeboy: raises $0.50 to $0.75
timboaus: folds 
geosat: folds 
Uncalled bet ($0.50) returned to Sandertjeboy
Sandertjeboy collected $0.60 from pot
*** SUMMARY ***
Total pot $0.60 | Rake $0 
Seat 5: geosat (big blind) folded before Flop
Seat 6: J Burrow folded before Flop (didn't bet)
Seat 7: Alameda22 folded before Flop (didn't bet)
Seat 8: Sandertjeboy (button) collected ($0.60)
Seat 9: timboaus (small blind) folded before Flop



PokerStars Game #20102242113:  Hold'em No Limit ($0.10/$0.25) - 2008/09/02 20:01:46 ET
Table 'Pomona IV' 9-max Seat #9 is the button
Seat 5: geosat ($26.40 in chips) 
Seat 6: J Burrow ($88.95 in chips) 
Seat 7: Alameda22 ($21.95 in chips) 
Seat 8: Sandertjeboy ($24 in chips) 
Seat 9: timboaus ($13.90 in chips) 
MissStax will be allowed to play after the button
geosat: posts small blind $0.10
J Burrow: posts big blind $0.25
*** HOLE CARDS ***
Dealt to Alameda22 [2d 7h]
Alameda22: folds 
Sandertjeboy: folds 
XXXRIOJAXXX joins the table at seat #4 
timboaus: raises $1.05 to $1.30
geosat: folds 
J Burrow: folds 
Uncalled bet ($1.05) returned to timboaus
timboaus collected $0.60 from pot
timboaus: doesn't show hand 
*** SUMMARY ***
Total pot $0.60 | Rake $0 
Seat 5: geosat (small blind) folded before Flop
Seat 6: J Burrow (big blind) folded before Flop
Seat 7: Alameda22 folded before Flop (didn't bet)
Seat 8: Sandertjeboy folded before Flop (didn't bet)
Seat 9: timboaus (button) collected ($0.60)



PokerStars Game #20102256530:  Hold'em No Limit ($0.10/$0.25) - 2008/09/02 20:02:25 ET
Table 'Pomona IV' 9-max Seat #5 is the button
Seat 2: MissStax ($24.55 in chips) 
Seat 4: XXXRIOJAXXX ($15 in chips) 
Seat 5: geosat ($26.30 in chips) 
Seat 6: J Burrow ($88.70 in chips) 
Seat 7: Alameda22 ($21.95 in chips) 
Seat 8: Sandertjeboy ($24 in chips) 
Seat 9: timboaus ($14.25 in chips) 
J Burrow: posts small blind $0.10
Alameda22: posts big blind $0.25
MissStax: posts small & big blinds $0.35
XXXRIOJAXXX: posts big blind $0.25
*** HOLE CARDS ***
Dealt to Alameda22 [Qh 8s]
Sandertjeboy: folds 
timboaus: folds 
TBNCO joins the table at seat #3 
MissStax: checks 
XXXRIOJAXXX: raises $1.25 to $1.50
geosat: folds 
J Burrow: folds 
Alameda22: folds 
MissStax: folds 
Uncalled bet ($1.25) returned to XXXRIOJAXXX
XXXRIOJAXXX collected $0.95 from pot
XXXRIOJAXXX: doesn't show hand 
*** SUMMARY ***
Total pot $0.95 | Rake $0 
Seat 2: MissStax folded before Flop
Seat 4: XXXRIOJAXXX collected ($0.95)
Seat 5: geosat (button) folded before Flop (didn't bet)
Seat 6: J Burrow (small blind) folded before Flop
Seat 7: Alameda22 (big blind) folded before Flop
Seat 8: Sandertjeboy folded before Flop (didn't bet)
Seat 9: timboaus folded before Flop (didn't bet)



PokerStars Game #20102275065:  Hold'em No Limit ($0.10/$0.25) - 2008/09/02 20:03:16 ET
Table 'Pomona IV' 9-max Seat #6 is the button
Seat 2: MissStax ($24.20 in chips) 
Seat 4: XXXRIOJAXXX ($15.70 in chips) 
Seat 5: geosat ($26.30 in chips) 
Seat 6: J Burrow ($88.60 in chips) 
Seat 7: Alameda22 ($21.70 in chips) 
Seat 8: Sandertjeboy ($24 in chips) 
Seat 9: timboaus ($14.25 in chips) 
Alameda22: posts small blind $0.10
Sandertjeboy: posts big blind $0.25
TBNCO: sits out 
*** HOLE CARDS ***
Dealt to Alameda22 [6h 3c]
timboaus: folds 
MissStax: raises $0.75 to $1
XXXRIOJAXXX: folds 
geosat: folds 
J Burrow: folds 
Alameda22: folds 
Sandertjeboy: folds 
Uncalled bet ($0.75) returned to MissStax
MissStax collected $0.60 from pot
MissStax: doesn't show hand 
*** SUMMARY ***
Total pot $0.60 | Rake $0 
Seat 2: MissStax collected ($0.60)
Seat 4: XXXRIOJAXXX folded before Flop (didn't bet)
Seat 5: geosat folded before Flop (didn't bet)
Seat 6: J Burrow (button) folded before Flop (didn't bet)
Seat 7: Alameda22 (small blind) folded before Flop
Seat 8: Sandertjeboy (big blind) folded before Flop
Seat 9: timboaus folded before Flop (didn't bet)



PokerStars Game #20102293268:  Hold'em No Limit ($0.10/$0.25) - 2008/09/02 20:04:05 ET
Table 'Pomona IV' 9-max Seat #7 is the button
Seat 2: MissStax ($24.55 in chips) 
Seat 4: XXXRIOJAXXX ($15.70 in chips) 
Seat 5: geosat ($26.30 in chips) 
Seat 6: J Burrow ($88.60 in chips) 
Seat 7: Alameda22 ($21.60 in chips) 
Seat 8: Sandertjeboy ($23.75 in chips) 
Seat 9: timboaus ($14.25 in chips) 
Sandertjeboy: posts small blind $0.10
timboaus: posts big blind $0.25
TBNCO: sits out 
*** HOLE CARDS ***
Dealt to Alameda22 [8d Ts]
MissStax: folds 
XXXRIOJAXXX: raises $0.50 to $0.75
geosat: folds 
J Burrow: calls $0.75
Alameda22: folds 
Sandertjeboy: folds 
timboaus: folds 
*** FLOP *** [5s Js Jc]
XXXRIOJAXXX: checks 
J Burrow: checks 
*** TURN *** [5s Js Jc] [3d]
XXXRIOJAXXX: checks 
J Burrow: bets $1
XXXRIOJAXXX: raises $1 to $2
J Burrow: calls $1
*** RIVER *** [5s Js Jc 3d] [Kc]
XXXRIOJAXXX: bets $1
J Burrow: calls $1
*** SHOW DOWN ***
XXXRIOJAXXX: shows [Jd Kd] (a full house, Jacks full of Kings)
J Burrow: mucks hand 
XXXRIOJAXXX collected $7.50 from pot
*** SUMMARY ***
Total pot $7.85 | Rake $0.35 
Board [5s Js Jc 3d Kc]
Seat 2: MissStax folded before Flop (didn't bet)
Seat 4: XXXRIOJAXXX showed [Jd Kd] and won ($7.50) with a full house, Jacks full of Kings
Seat 5: geosat folded before Flop (didn't bet)
Seat 6: J Burrow mucked [9d 9c]
Seat 7: Alameda22 (button) folded before Flop (didn't bet)
Seat 8: Sandertjeboy (small blind) folded before Flop
Seat 9: timboaus (big blind) folded before Flop



PokerStars Game #20102319265:  Hold'em No Limit ($0.10/$0.25) - 2008/09/02 20:05:16 ET
Table 'Pomona IV' 9-max Seat #8 is the button
Seat 2: MissStax ($24.55 in chips) 
Seat 4: XXXRIOJAXXX ($19.45 in chips) 
Seat 5: geosat ($26.30 in chips) 
Seat 6: J Burrow ($84.85 in chips) 
Seat 7: Alameda22 ($21.60 in chips) 
Seat 8: Sandertjeboy ($23.65 in chips) 
Seat 9: timboaus ($14 in chips) 
timboaus: posts small blind $0.10
MissStax: posts big blind $0.25
TBNCO: sits out 
*** HOLE CARDS ***
Dealt to Alameda22 [2d Ac]
XXXRIOJAXXX: raises $0.25 to $0.50
geosat: folds 
J Burrow: folds 
J Burrow leaves the table
Alameda22: folds 
Sandertjeboy: folds 
timboaus: raises $1.10 to $1.60
MissStax: folds 
XXXRIOJAXXX: calls $1.10
*** FLOP *** [Qs 4c 8h]
timboaus: bets $2.40
XXXRIOJAXXX: raises $15.45 to $17.85 and is all-in
timboaus said, "aq?"
timboaus: folds 
Uncalled bet ($15.45) returned to XXXRIOJAXXX
XXXRIOJAXXX collected $7.85 from pot
XXXRIOJAXXX: doesn't show hand 
*** SUMMARY ***
Total pot $8.25 | Rake $0.40 
Board [Qs 4c 8h]
Seat 2: MissStax (big blind) folded before Flop
Seat 4: XXXRIOJAXXX collected ($7.85)
Seat 5: geosat folded before Flop (didn't bet)
Seat 6: J Burrow folded before Flop (didn't bet)
Seat 7: Alameda22 folded before Flop (didn't bet)
Seat 8: Sandertjeboy (button) folded before Flop (didn't bet)
Seat 9: timboaus (small blind) folded on the Flop



PokerStars Game #20102351458:  Hold'em No Limit ($0.10/$0.25) - 2008/09/02 20:06:44 ET
Table 'Pomona IV' 9-max Seat #9 is the button
Seat 2: MissStax ($24.30 in chips) 
Seat 3: TBNCO ($10 in chips) 
Seat 4: XXXRIOJAXXX ($23.30 in chips) 
Seat 5: geosat ($26.30 in chips) 
Seat 7: Alameda22 ($21.60 in chips) 
Seat 8: Sandertjeboy ($23.65 in chips) 
Seat 9: timboaus ($10 in chips) 
MissStax: posts small blind $0.10
TBNCO: posts big blind $0.25
*** HOLE CARDS ***
Dealt to Alameda22 [9h 7d]
XXXRIOJAXXX: folds 
geosat: folds 
Alameda22: folds 
Sandertjeboy: folds 
timboaus: raises $1.05 to $1.30
MissStax: folds 
TBNCO: folds 
Uncalled bet ($1.05) returned to timboaus
timboaus collected $0.60 from pot
timboaus: doesn't show hand 
*** SUMMARY ***
Total pot $0.60 | Rake $0 
Seat 2: MissStax (small blind) folded before Flop
Seat 3: TBNCO (big blind) folded before Flop
Seat 4: XXXRIOJAXXX folded before Flop (didn't bet)
Seat 5: geosat folded before Flop (didn't bet)
Seat 7: Alameda22 folded before Flop (didn't bet)
Seat 8: Sandertjeboy folded before Flop (didn't bet)
Seat 9: timboaus (button) collected ($0.60)



PokerStars Game #20102372933:  Hold'em No Limit ($0.10/$0.25) - 2008/09/02 20:07:43 ET
Table 'Pomona IV' 9-max Seat #2 is the button
Seat 2: MissStax ($24.20 in chips) 
Seat 3: TBNCO ($9.75 in chips) 
Seat 4: XXXRIOJAXXX ($23.30 in chips) 
Seat 5: geosat ($26.30 in chips) 
Seat 7: Alameda22 ($21.60 in chips) 
Seat 8: Sandertjeboy ($23.65 in chips) 
Seat 9: timboaus ($10.35 in chips) 
TBNCO: posts small blind $0.10
XXXRIOJAXXX: posts big blind $0.25
*** HOLE CARDS ***
Dealt to Alameda22 [6d 2h]
geosat: folds 
Alameda22: folds 
Sandertjeboy: calls $0.25
timboaus: folds 
MissStax: folds 
*ewenger* joins the table at seat #6 
TBNCO: folds 
XXXRIOJAXXX: checks 
*** FLOP *** [Ac Js 4h]
XXXRIOJAXXX: checks 
Sandertjeboy: checks 
*** TURN *** [Ac Js 4h] [5d]
XXXRIOJAXXX: bets $0.75
Sandertjeboy: folds 
Uncalled bet ($0.75) returned to XXXRIOJAXXX
XXXRIOJAXXX collected $0.60 from pot
XXXRIOJAXXX: doesn't show hand 
*** SUMMARY ***
Total pot $0.60 | Rake $0 
Board [Ac Js 4h 5d]
Seat 2: MissStax (button) folded before Flop (didn't bet)
Seat 3: TBNCO (small blind) folded before Flop
Seat 4: XXXRIOJAXXX (big blind) collected ($0.60)
Seat 5: geosat folded before Flop (didn't bet)
Seat 7: Alameda22 folded before Flop (didn't bet)
Seat 8: Sandertjeboy folded on the Turn
Seat 9: timboaus folded before Flop (didn't bet)



PokerStars Game #20102392757:  Hold'em No Limit ($0.10/$0.25) - 2008/09/02 20:08:37 ET
Table 'Pomona IV' 9-max Seat #3 is the button
Seat 2: MissStax ($24.20 in chips) 
Seat 3: TBNCO ($9.65 in chips) 
Seat 4: XXXRIOJAXXX ($23.65 in chips) 
Seat 5: geosat ($26.30 in chips) 
Seat 6: *ewenger* ($11.65 in chips) 
Seat 7: Alameda22 ($21.60 in chips) 
Seat 8: Sandertjeboy ($23.40 in chips) 
Seat 9: timboaus ($10.35 in chips) 
XXXRIOJAXXX: posts small blind $0.10
geosat: posts big blind $0.25
*ewenger*: posts big blind $0.25
*** HOLE CARDS ***
Dealt to Alameda22 [2h 7d]
*ewenger*: checks 
Alameda22: folds 
Sandertjeboy: folds 
timboaus: folds 
MissStax: folds 
TBNCO: calls $0.25
XXXRIOJAXXX: calls $0.15
geosat: checks 
*** FLOP *** [3s 4c 4d]
XXXRIOJAXXX: bets $1
geosat: folds 
*ewenger*: folds 
TBNCO: folds 
Uncalled bet ($1) returned to XXXRIOJAXXX
XXXRIOJAXXX collected $0.95 from pot
XXXRIOJAXXX: doesn't show hand 
*** SUMMARY ***
Total pot $1 | Rake $0.05 
Board [3s 4c 4d]
Seat 2: MissStax folded before Flop (didn't bet)
Seat 3: TBNCO (button) folded on the Flop
Seat 4: XXXRIOJAXXX (small blind) collected ($0.95)
Seat 5: geosat (big blind) folded on the Flop
Seat 6: *ewenger* folded on the Flop
Seat 7: Alameda22 folded before Flop (didn't bet)
Seat 8: Sandertjeboy folded before Flop (didn't bet)
Seat 9: timboaus folded before Flop (didn't bet)



PokerStars Game #20102415188:  Hold'em No Limit ($0.10/$0.25) - 2008/09/02 20:09:39 ET
Table 'Pomona IV' 9-max Seat #4 is the button
Seat 2: MissStax ($24.20 in chips) 
Seat 3: TBNCO ($9.40 in chips) 
Seat 4: XXXRIOJAXXX ($24.35 in chips) 
Seat 5: geosat ($26.05 in chips) 
Seat 6: *ewenger* ($11.40 in chips) 
Seat 7: Alameda22 ($21.60 in chips) 
Seat 8: Sandertjeboy ($23.40 in chips) 
Seat 9: timboaus ($10.35 in chips) 
geosat: posts small blind $0.10
*ewenger*: posts big blind $0.25
*** HOLE CARDS ***
Dealt to Alameda22 [9s 9d]
Alameda22: folds 
Sandertjeboy: raises $0.50 to $0.75
timboaus: raises $1.25 to $2
MissStax: folds 
TBNCO: folds 
XXXRIOJAXXX: folds 
geosat: folds 
*ewenger*: folds 
Sandertjeboy: calls $1.25
*** FLOP *** [3s 6s 2d]
Sandertjeboy: checks 
timboaus: bets $3
Sandertjeboy: folds 
Uncalled bet ($3) returned to timboaus
timboaus collected $4.15 from pot
timboaus: doesn't show hand 
*** SUMMARY ***
Total pot $4.35 | Rake $0.20 
Board [3s 6s 2d]
Seat 2: MissStax folded before Flop (didn't bet)
Seat 3: TBNCO folded before Flop (didn't bet)
Seat 4: XXXRIOJAXXX (button) folded before Flop (didn't bet)
Seat 5: geosat (small blind) folded before Flop
Seat 6: *ewenger* (big blind) folded before Flop
Seat 7: Alameda22 folded before Flop (didn't bet)
Seat 8: Sandertjeboy folded on the Flop
Seat 9: timboaus collected ($4.15)



PokerStars Game #20102440615:  Hold'em No Limit ($0.10/$0.25) - 2008/09/02 20:10:49 ET
Table 'Pomona IV' 9-max Seat #5 is the button
Seat 2: MissStax ($24.20 in chips) 
Seat 3: TBNCO ($9.40 in chips) 
Seat 4: XXXRIOJAXXX ($24.35 in chips) 
Seat 5: geosat ($25.95 in chips) 
Seat 6: *ewenger* ($11.15 in chips) 
Seat 7: Alameda22 ($21.60 in chips) 
Seat 8: Sandertjeboy ($25 in chips) 
Seat 9: timboaus ($12.50 in chips) 
*ewenger*: posts small blind $0.10
Alameda22: posts big blind $0.25
*** HOLE CARDS ***
Dealt to Alameda22 [4c 6d]
Sandertjeboy: folds 
timboaus: folds 
MissStax: folds 
TBNCO: folds 
XXXRIOJAXXX: folds 
geosat: folds 
*ewenger*: calls $0.15
Alameda22: checks 
*** FLOP *** [9h 9s Ah]
*ewenger*: checks 
Alameda22: checks 
*** TURN *** [9h 9s Ah] [Kh]
*ewenger*: checks 
Alameda22: checks 
*** RIVER *** [9h 9s Ah Kh] [4h]
*ewenger*: checks 
Alameda22: checks 
*** SHOW DOWN ***
*ewenger*: shows [6s 7h] (a flush, Ace high)
Alameda22: mucks hand 
*ewenger* collected $0.50 from pot
*** SUMMARY ***
Total pot $0.50 | Rake $0 
Board [9h 9s Ah Kh 4h]
Seat 2: MissStax folded before Flop (didn't bet)
Seat 3: TBNCO folded before Flop (didn't bet)
Seat 4: XXXRIOJAXXX folded before Flop (didn't bet)
Seat 5: geosat (button) folded before Flop (didn't bet)
Seat 6: *ewenger* (small blind) showed [6s 7h] and won ($0.50) with a flush, Ace high
Seat 7: Alameda22 (big blind) mucked [4c 6d]
Seat 8: Sandertjeboy folded before Flop (didn't bet)
Seat 9: timboaus folded before Flop (didn't bet)



PokerStars Game #20102470617:  Hold'em No Limit ($0.10/$0.25) - 2008/09/02 20:12:11 ET
Table 'Pomona IV' 9-max Seat #6 is the button
Seat 2: MissStax ($24.20 in chips) 
Seat 3: TBNCO ($9.40 in chips) 
Seat 4: XXXRIOJAXXX ($24.35 in chips) 
Seat 5: geosat ($25.95 in chips) 
Seat 6: *ewenger* ($11.40 in chips) 
Seat 7: Alameda22 ($21.35 in chips) 
Seat 8: Sandertjeboy ($25 in chips) 
Seat 9: timboaus ($12.50 in chips) 
Alameda22: posts small blind $0.10
Sandertjeboy: posts big blind $0.25
*** HOLE CARDS ***
Dealt to Alameda22 [Js Qs]
timboaus: folds 
MissStax: folds 
TBNCO: folds 
XXXRIOJAXXX: raises $1 to $1.25
geosat: folds 
*ewenger*: folds 
Alameda22: folds 
Sandertjeboy: folds 
Uncalled bet ($1) returned to XXXRIOJAXXX
XXXRIOJAXXX collected $0.60 from pot
XXXRIOJAXXX: doesn't show hand 
*** SUMMARY ***
Total pot $0.60 | Rake $0 
Seat 2: MissStax folded before Flop (didn't bet)
Seat 3: TBNCO folded before Flop (didn't bet)
Seat 4: XXXRIOJAXXX collected ($0.60)
Seat 5: geosat folded before Flop (didn't bet)
Seat 6: *ewenger* (button) folded before Flop (didn't bet)
Seat 7: Alameda22 (small blind) folded before Flop
Seat 8: Sandertjeboy (big blind) folded before Flop
Seat 9: timboaus folded before Flop (didn't bet)



PokerStars Game #20102488234:  Hold'em No Limit ($0.10/$0.25) - 2008/09/02 20:13:00 ET
Table 'Pomona IV' 9-max Seat #7 is the button
Seat 2: MissStax ($24.20 in chips) 
Seat 3: TBNCO ($9.40 in chips) 
Seat 4: XXXRIOJAXXX ($24.70 in chips) 
Seat 5: geosat ($25.95 in chips) 
Seat 6: *ewenger* ($11.40 in chips) 
Seat 7: Alameda22 ($21.25 in chips) 
Seat 8: Sandertjeboy ($24.75 in chips) 
Seat 9: timboaus ($12.50 in chips) 
Sandertjeboy: posts small blind $0.10
timboaus: posts big blind $0.25
*** HOLE CARDS ***
Dealt to Alameda22 [4s Jh]
MissStax: folds 
TBNCO: folds 
XXXRIOJAXXX: raises $0.25 to $0.50
geosat: calls $0.50
*ewenger*: folds 
Alameda22: folds 
Sandertjeboy: raises $0.75 to $1.25
timboaus: folds 
touchdownKC joins the table at seat #1 
XXXRIOJAXXX has timed out
XXXRIOJAXXX: folds 
XXXRIOJAXXX is sitting out
geosat: calls $0.75
*** FLOP *** [8c 9s 3d]
Sandertjeboy: bets $3.50
geosat: folds 
Uncalled bet ($3.50) returned to Sandertjeboy
Sandertjeboy collected $3.10 from pot
*** SUMMARY ***
Total pot $3.25 | Rake $0.15 
Board [8c 9s 3d]
Seat 2: MissStax folded before Flop (didn't bet)
Seat 3: TBNCO folded before Flop (didn't bet)
Seat 4: XXXRIOJAXXX folded before Flop
Seat 5: geosat folded on the Flop
Seat 6: *ewenger* folded before Flop (didn't bet)
Seat 7: Alameda22 (button) folded before Flop (didn't bet)
Seat 8: Sandertjeboy (small blind) collected ($3.10)
Seat 9: timboaus (big blind) folded before Flop



PokerStars Game #20102551125:  Hold'em No Limit ($0.10/$0.25) - 2008/09/02 20:15:53 ET
Table 'Pomona IV' 9-max Seat #8 is the button
Seat 1: touchdownKC ($15 in chips) 
Seat 2: MissStax ($24.20 in chips) 
Seat 3: TBNCO ($9.40 in chips) 
Seat 5: geosat ($24.70 in chips) 
Seat 6: *ewenger* ($11.40 in chips) 
Seat 7: Alameda22 ($21.25 in chips) 
Seat 8: Sandertjeboy ($26.60 in chips) 
Seat 9: timboaus ($12.25 in chips) 
timboaus: posts small blind $0.10
touchdownKC: posts big blind $0.25
*** HOLE CARDS ***
Dealt to Alameda22 [Jd 5h]
MissStax: folds 
TBNCO: folds 
geosat: folds 
*ewenger*: folds 
Alameda22: folds 
Sandertjeboy: raises $0.50 to $0.75
timboaus: raises $1.45 to $2.20
touchdownKC: folds 
Sandertjeboy: folds 
Uncalled bet ($1.45) returned to timboaus
timboaus collected $1.75 from pot
timboaus: doesn't show hand 
*** SUMMARY ***
Total pot $1.75 | Rake $0 
Seat 1: touchdownKC (big blind) folded before Flop
Seat 2: MissStax folded before Flop (didn't bet)
Seat 3: TBNCO folded before Flop (didn't bet)
Seat 5: geosat folded before Flop (didn't bet)
Seat 6: *ewenger* folded before Flop (didn't bet)
Seat 7: Alameda22 folded before Flop (didn't bet)
Seat 8: Sandertjeboy (button) folded before Flop
Seat 9: timboaus (small blind) collected ($1.75)



PokerStars Game #20102572302:  Hold'em No Limit ($0.10/$0.25) - 2008/09/02 20:16:49 ET
Table 'Pomona IV' 9-max Seat #9 is the button
Seat 1: touchdownKC ($14.75 in chips) 
Seat 2: MissStax ($24.20 in chips) 
Seat 3: TBNCO ($9.40 in chips) 
Seat 5: geosat ($25 in chips) 
Seat 6: *ewenger* ($11.40 in chips) 
Seat 7: Alameda22 ($21.25 in chips) 
Seat 8: Sandertjeboy ($25.85 in chips) 
Seat 9: timboaus ($13.25 in chips) 
touchdownKC: posts small blind $0.10
MissStax: posts big blind $0.25
*** HOLE CARDS ***
Dealt to Alameda22 [Qc Qs]
TBNCO: folds 
geosat: raises $0.75 to $1
*ewenger*: folds 
Alameda22: calls $1
Sandertjeboy: calls $1
timboaus: calls $1
touchdownKC: folds 
MissStax: folds 
*** FLOP *** [9d Th 4c]
geosat: bets $3.75
touchdownKC leaves the table
Alameda22: raises $6.25 to $10
Sandertjeboy: folds 
timboaus: folds 
geosat: raises $14 to $24 and is all-in
Alameda22: calls $10.25 and is all-in
Uncalled bet ($3.75) returned to geosat
*** TURN *** [9d Th 4c] [Js]
*** RIVER *** [9d Th 4c Js] [Ah]
*** SHOW DOWN ***
geosat: shows [Kh Kc] (a pair of Kings)
Alameda22: mucks hand 
geosat collected $42.65 from pot
*** SUMMARY ***
Total pot $44.85 | Rake $2.20 
Board [9d Th 4c Js Ah]
Seat 1: touchdownKC (small blind) folded before Flop
Seat 2: MissStax (big blind) folded before Flop
Seat 3: TBNCO folded before Flop (didn't bet)
Seat 5: geosat showed [Kh Kc] and won ($42.65) with a pair of Kings
Seat 6: *ewenger* folded before Flop (didn't bet)
Seat 7: Alameda22 mucked [Qc Qs]
Seat 8: Sandertjeboy folded on the Flop
Seat 9: timboaus (button) folded on the Flop



PokerStars Game #20102608925:  Hold'em No Limit ($0.10/$0.25) - 2008/09/02 20:18:28 ET
Table 'Pomona IV' 9-max Seat #2 is the button
Seat 2: MissStax ($23.95 in chips) 
Seat 3: TBNCO ($9.40 in chips) 
Seat 5: geosat ($46.40 in chips) 
Seat 6: *ewenger* ($11.40 in chips) 
Seat 7: Alameda22 ($5 in chips) 
Seat 8: Sandertjeboy ($24.85 in chips) 
Seat 9: timboaus ($12.25 in chips) 
TBNCO: posts small blind $0.10
geosat: posts big blind $0.25
*** HOLE CARDS ***
Dealt to Alameda22 [8d Td]
*ewenger*: folds 
Alameda22: folds 
Sandertjeboy: folds 
Bobby1776 joins the table at seat #1 
timboaus: folds 
MissStax: raises $0.50 to $0.75
TBNCO: calls $0.65
geosat: folds 
*** FLOP *** [Ts 8s Jd]
TBNCO: bets $0.75
MissStax: folds 
Uncalled bet ($0.75) returned to TBNCO
TBNCO collected $1.70 from pot
TBNCO: doesn't show hand 
*** SUMMARY ***
Total pot $1.75 | Rake $0.05 
Board [Ts 8s Jd]
Seat 2: MissStax (button) folded on the Flop
Seat 3: TBNCO (small blind) collected ($1.70)
Seat 5: geosat (big blind) folded before Flop
Seat 6: *ewenger* folded before Flop (didn't bet)
Seat 7: Alameda22 folded before Flop (didn't bet)
Seat 8: Sandertjeboy folded before Flop (didn't bet)
Seat 9: timboaus folded before Flop (didn't bet)



PokerStars Game #20102627384:  Hold'em No Limit ($0.10/$0.25) - 2008/09/02 20:19:18 ET
Table 'Pomona IV' 9-max Seat #3 is the button
Seat 1: Bobby1776 ($25 in chips) 
Seat 2: MissStax ($23.20 in chips) 
Seat 3: TBNCO ($10.35 in chips) 
Seat 5: geosat ($46.15 in chips) 
Seat 6: *ewenger* ($11.40 in chips) 
Seat 7: Alameda22 ($25 in chips) 
Seat 8: Sandertjeboy ($24.85 in chips) 
Seat 9: timboaus ($12.25 in chips) 
geosat: posts small blind $0.10
*ewenger*: posts big blind $0.25
Bobby1776: posts big blind $0.25
*** HOLE CARDS ***
Dealt to Alameda22 [6h 8d]
Alameda22: folds 
Sandertjeboy: folds 
timboaus: folds 
Bobby1776: checks 
MissStax: folds 
TBNCO: folds 
geosat: folds 
*ewenger*: checks 
*** FLOP *** [6c 8c 8s]
*ewenger*: checks 
Bobby1776: bets $0.50
*ewenger*: folds 
Uncalled bet ($0.50) returned to Bobby1776
Bobby1776 collected $0.60 from pot
Bobby1776: doesn't show hand 
*** SUMMARY ***
Total pot $0.60 | Rake $0 
Board [6c 8c 8s]
Seat 1: Bobby1776 collected ($0.60)
Seat 2: MissStax folded before Flop (didn't bet)
Seat 3: TBNCO (button) folded before Flop (didn't bet)
Seat 5: geosat (small blind) folded before Flop
Seat 6: *ewenger* (big blind) folded on the Flop
Seat 7: Alameda22 folded before Flop (didn't bet)
Seat 8: Sandertjeboy folded before Flop (didn't bet)
Seat 9: timboaus folded before Flop (didn't bet)



PokerStars Game #20102643304:  Hold'em No Limit ($0.10/$0.25) - 2008/09/02 20:20:01 ET
Table 'Pomona IV' 9-max Seat #5 is the button
Seat 1: Bobby1776 ($25.35 in chips) 
Seat 2: MissStax ($23.20 in chips) 
Seat 3: TBNCO ($10.35 in chips) 
Seat 5: geosat ($46.05 in chips) 
Seat 6: *ewenger* ($11.15 in chips) 
Seat 7: Alameda22 ($25 in chips) 
Seat 8: Sandertjeboy ($24.85 in chips) 
Seat 9: timboaus ($12.25 in chips) 
*ewenger*: posts small blind $0.10
Alameda22: posts big blind $0.25
*** HOLE CARDS ***
Dealt to Alameda22 [4h 8h]
Sandertjeboy: calls $0.25
timboaus: folds 
Bobby1776: folds 
MissStax: folds 
TBNCO: folds 
geosat: folds 
*ewenger*: folds 
*ewenger* is sitting out
Alameda22: checks 
*** FLOP *** [Jh 2c Ac]
Alameda22: checks 
Sandertjeboy: checks 
*** TURN *** [Jh 2c Ac] [4d]
*ewenger* has returned
Alameda22: checks 
Sandertjeboy: bets $0.50
Alameda22: folds 
Uncalled bet ($0.50) returned to Sandertjeboy
Sandertjeboy collected $0.60 from pot
*** SUMMARY ***
Total pot $0.60 | Rake $0 
Board [Jh 2c Ac 4d]
Seat 1: Bobby1776 folded before Flop (didn't bet)
Seat 2: MissStax folded before Flop (didn't bet)
Seat 3: TBNCO folded before Flop (didn't bet)
Seat 5: geosat (button) folded before Flop (didn't bet)
Seat 6: *ewenger* (small blind) folded before Flop
Seat 7: Alameda22 (big blind) folded on the Turn
Seat 8: Sandertjeboy collected ($0.60)
Seat 9: timboaus folded before Flop (didn't bet)



PokerStars Game #20102664210:  Hold'em No Limit ($0.10/$0.25) - 2008/09/02 20:20:56 ET
Table 'Pomona IV' 9-max Seat #6 is the button
Seat 1: Bobby1776 ($25.35 in chips) 
Seat 2: MissStax ($23.20 in chips) 
Seat 3: TBNCO ($10.35 in chips) 
Seat 5: geosat ($46.05 in chips) 
Seat 6: *ewenger* ($11.05 in chips) 
Seat 7: Alameda22 ($24.75 in chips) 
Seat 9: timboaus ($12.25 in chips) 
Alameda22: posts small blind $0.10
Sandertjeboy: is sitting out 
Sandertjeboy leaves the table
timboaus: posts big blind $0.25
*** HOLE CARDS ***
Dealt to Alameda22 [9h Ah]
Bobby1776: folds 
MissStax: folds 
TBNCO: folds 
geosat: folds 
*ewenger*: folds 
Alameda22: calls $0.15
timboaus: raises $0.95 to $1.20
Alameda22: folds 
Uncalled bet ($0.95) returned to timboaus
timboaus collected $0.50 from pot
timboaus: doesn't show hand 
*** SUMMARY ***
Total pot $0.50 | Rake $0 
Seat 1: Bobby1776 folded before Flop (didn't bet)
Seat 2: MissStax folded before Flop (didn't bet)
Seat 3: TBNCO folded before Flop (didn't bet)
Seat 5: geosat folded before Flop (didn't bet)
Seat 6: *ewenger* (button) folded before Flop (didn't bet)
Seat 7: Alameda22 (small blind) folded before Flop
Seat 9: timboaus (big blind) collected ($0.50)



PokerStars Game #20102680882:  Hold'em No Limit ($0.10/$0.25) - 2008/09/02 20:21:41 ET
Table 'Pomona IV' 9-max Seat #7 is the button
Seat 1: Bobby1776 ($25.35 in chips) 
Seat 2: MissStax ($23.20 in chips) 
Seat 3: TBNCO ($10.35 in chips) 
Seat 5: geosat ($46.05 in chips) 
Seat 6: *ewenger* ($11.05 in chips) 
Seat 7: Alameda22 ($24.50 in chips) 
Seat 9: timboaus ($12.50 in chips) 
timboaus: posts small blind $0.10
Bobby1776: posts big blind $0.25
*** HOLE CARDS ***
Dealt to Alameda22 [Qd Ks]
MissStax: calls $0.25
TBNCO: folds 
geosat: folds 
*ewenger*: folds 
Alameda22: folds 
timboaus: calls $0.15
Bobby1776: checks 
*** FLOP *** [2d 8s 5s]
timboaus: checks 
Bobby1776: bets $0.75
MissStax: raises $1.50 to $2.25
timboaus: folds 
Bobby1776: folds 
Uncalled bet ($1.50) returned to MissStax
MissStax collected $2.15 from pot
MissStax: doesn't show hand 
*** SUMMARY ***
Total pot $2.25 | Rake $0.10 
Board [2d 8s 5s]
Seat 1: Bobby1776 (big blind) folded on the Flop
Seat 2: MissStax collected ($2.15)
Seat 3: TBNCO folded before Flop (didn't bet)
Seat 5: geosat folded before Flop (didn't bet)
Seat 6: *ewenger* folded before Flop (didn't bet)
Seat 7: Alameda22 (button) folded before Flop (didn't bet)
Seat 9: timboaus (small blind) folded on the Flop



PokerStars Game #20102703152:  Hold'em No Limit ($0.10/$0.25) - 2008/09/02 20:22:41 ET
Table 'Pomona IV' 9-max Seat #9 is the button
Seat 1: Bobby1776 ($24.35 in chips) 
Seat 2: MissStax ($24.35 in chips) 
Seat 3: TBNCO ($10.35 in chips) 
Seat 5: geosat ($46.05 in chips) 
Seat 6: *ewenger* ($11.05 in chips) 
Seat 7: Alameda22 ($24.50 in chips) 
Seat 9: timboaus ($12.25 in chips) 
Bobby1776: posts small blind $0.10
MissStax: posts big blind $0.25
*** HOLE CARDS ***
Dealt to Alameda22 [3s 2c]
TBNCO: calls $0.25
geosat: folds 
*ewenger*: calls $0.25
Alameda22: folds 
timboaus: folds 
Bobby1776: calls $0.15
MissStax: checks 
*** FLOP *** [4h 2h 8s]
Bobby1776: bets $0.75
MissStax: folds 
TBNCO: calls $0.75
*ewenger*: folds 
*** TURN *** [4h 2h 8s] [9c]
Bobby1776: bets $2
TBNCO: folds 
Uncalled bet ($2) returned to Bobby1776
Bobby1776 collected $2.40 from pot
Bobby1776: doesn't show hand 
*** SUMMARY ***
Total pot $2.50 | Rake $0.10 
Board [4h 2h 8s 9c]
Seat 1: Bobby1776 (small blind) collected ($2.40)
Seat 2: MissStax (big blind) folded on the Flop
Seat 3: TBNCO folded on the Turn
Seat 5: geosat folded before Flop (didn't bet)
Seat 6: *ewenger* folded on the Flop
Seat 7: Alameda22 folded before Flop (didn't bet)
Seat 9: timboaus (button) folded before Flop (didn't bet)



PokerStars Game #20102736337:  Hold'em No Limit ($0.10/$0.25) - 2008/09/02 20:24:10 ET
Table 'Pomona IV' 9-max Seat #1 is the button
Seat 1: Bobby1776 ($25.75 in chips) 
Seat 2: MissStax ($24.10 in chips) 
Seat 3: TBNCO ($9.35 in chips) 
Seat 5: geosat ($46.05 in chips) 
Seat 6: *ewenger* ($10.80 in chips) 
Seat 7: Alameda22 ($24.50 in chips) 
Seat 9: timboaus ($12.25 in chips) 
MissStax: posts small blind $0.10
TBNCO: posts big blind $0.25
*** HOLE CARDS ***
Dealt to Alameda22 [3c Js]
geosat: folds 
Julik77 joins the table at seat #8 
*ewenger*: folds 
Alameda22: folds 
timboaus: folds 
Bobby1776: raises $0.50 to $0.75
MissStax: folds 
TBNCO: folds 
Uncalled bet ($0.50) returned to Bobby1776
Bobby1776 collected $0.60 from pot
Bobby1776: doesn't show hand 
*** SUMMARY ***
Total pot $0.60 | Rake $0 
Seat 1: Bobby1776 (button) collected ($0.60)
Seat 2: MissStax (small blind) folded before Flop
Seat 3: TBNCO (big blind) folded before Flop
Seat 5: geosat folded before Flop (didn't bet)
Seat 6: *ewenger* folded before Flop (didn't bet)
Seat 7: Alameda22 folded before Flop (didn't bet)
Seat 9: timboaus folded before Flop (didn't bet)



PokerStars Game #20102751117:  Hold'em No Limit ($0.10/$0.25) - 2008/09/02 20:24:50 ET
Table 'Pomona IV' 9-max Seat #2 is the button
Seat 1: Bobby1776 ($26.10 in chips) 
Seat 2: MissStax ($24 in chips) 
Seat 3: TBNCO ($9.10 in chips) 
Seat 5: geosat ($46.05 in chips) 
Seat 6: *ewenger* ($10.80 in chips) 
Seat 7: Alameda22 ($24.50 in chips) 
Seat 8: Julik77 ($25 in chips) 
Seat 9: timboaus ($12.25 in chips) 
TBNCO: posts small blind $0.10
geosat: posts big blind $0.25
Julik77: posts big blind $0.25
*** HOLE CARDS ***
Dealt to Alameda22 [Qs Jh]
*ewenger*: folds 
Alameda22: folds 
Julik77: checks 
timboaus: folds 
Bobby1776: raises $0.50 to $0.75
MissStax: folds 
TBNCO: folds 
geosat: folds 
Julik77: folds 
Uncalled bet ($0.50) returned to Bobby1776
Bobby1776 collected $0.85 from pot
Bobby1776: doesn't show hand 
*** SUMMARY ***
Total pot $0.85 | Rake $0 
Seat 1: Bobby1776 collected ($0.85)
Seat 2: MissStax (button) folded before Flop (didn't bet)
Seat 3: TBNCO (small blind) folded before Flop
Seat 5: geosat (big blind) folded before Flop
Seat 6: *ewenger* folded before Flop (didn't bet)
Seat 7: Alameda22 folded before Flop (didn't bet)
Seat 8: Julik77 folded before Flop
Seat 9: timboaus folded before Flop (didn't bet)



PokerStars Game #20102779638:  Hold'em No Limit ($0.10/$0.25) - 2008/09/02 20:26:08 ET
Table 'Pomona IV' 9-max Seat #3 is the button
Seat 1: Bobby1776 ($26.70 in chips) 
Seat 2: MissStax ($24 in chips) 
Seat 3: TBNCO ($9 in chips) 
Seat 5: geosat ($45.80 in chips) 
Seat 6: *ewenger* ($10.80 in chips) 
Seat 7: Alameda22 ($24.50 in chips) 
Seat 8: Julik77 ($24.75 in chips) 
Seat 9: timboaus ($12.25 in chips) 
geosat: posts small blind $0.10
*ewenger*: posts big blind $0.25
*** HOLE CARDS ***
Dealt to Alameda22 [7h 9h]
Alameda22: folds 
Julik77: folds 
timboaus: folds 
Bobby1776: raises $0.50 to $0.75
MissStax: folds 
TBNCO: folds 
geosat: folds 
*ewenger*: calls $0.50
*** FLOP *** [Th 4s 4c]
*ewenger*: bets $3.50
Bobby1776: folds 
Uncalled bet ($3.50) returned to *ewenger*
*ewenger* collected $1.55 from pot
*** SUMMARY ***
Total pot $1.60 | Rake $0.05 
Board [Th 4s 4c]
Seat 1: Bobby1776 folded on the Flop
Seat 2: MissStax folded before Flop (didn't bet)
Seat 3: TBNCO (button) folded before Flop (didn't bet)
Seat 5: geosat (small blind) folded before Flop
Seat 6: *ewenger* (big blind) collected ($1.55)
Seat 7: Alameda22 folded before Flop (didn't bet)
Seat 8: Julik77 folded before Flop (didn't bet)
Seat 9: timboaus folded before Flop (didn't bet)



PokerStars Game #20102802199:  Hold'em No Limit ($0.10/$0.25) - 2008/09/02 20:27:09 ET
Table 'Pomona IV' 9-max Seat #5 is the button
Seat 1: Bobby1776 ($25.95 in chips) 
Seat 2: MissStax ($24 in chips) 
Seat 3: TBNCO ($9 in chips) 
Seat 5: geosat ($45.70 in chips) 
Seat 6: *ewenger* ($11.60 in chips) 
Seat 7: Alameda22 ($24.50 in chips) 
Seat 8: Julik77 ($24.75 in chips) 
Seat 9: timboaus ($12.25 in chips) 
*ewenger*: posts small blind $0.10
Alameda22: posts big blind $0.25
*** HOLE CARDS ***
Dealt to Alameda22 [4d Qh]
Julik77: calls $0.25
timboaus: folds 
Bobby1776: folds 
MissStax: folds 
TBNCO: calls $0.25
geosat: folds 
*ewenger*: calls $0.15
Alameda22: checks 
*** FLOP *** [Tc 4h 2c]
*ewenger*: checks 
Alameda22: checks 
Julik77: checks 
TBNCO: checks 
*** TURN *** [Tc 4h 2c] [4c]
*ewenger*: checks 
Alameda22: bets $0.50
Julik77: folds 
TBNCO: folds 
*ewenger*: folds 
Uncalled bet ($0.50) returned to Alameda22
Alameda22 collected $0.95 from pot
Alameda22: doesn't show hand 
*** SUMMARY ***
Total pot $1 | Rake $0.05 
Board [Tc 4h 2c 4c]
Seat 1: Bobby1776 folded before Flop (didn't bet)
Seat 2: MissStax folded before Flop (didn't bet)
Seat 3: TBNCO folded on the Turn
Seat 5: geosat (button) folded before Flop (didn't bet)
Seat 6: *ewenger* (small blind) folded on the Turn
Seat 7: Alameda22 (big blind) collected ($0.95)
Seat 8: Julik77 folded on the Turn
Seat 9: timboaus folded before Flop (didn't bet)



PokerStars Game #20102834425:  Hold'em No Limit ($0.10/$0.25) - 2008/09/02 20:28:36 ET
Table 'Pomona IV' 9-max Seat #6 is the button
Seat 1: Bobby1776 ($25.95 in chips) 
Seat 2: MissStax ($24 in chips) 
Seat 3: TBNCO ($8.75 in chips) 
Seat 5: geosat ($45.70 in chips) 
Seat 6: *ewenger* ($11.35 in chips) 
Seat 7: Alameda22 ($25.20 in chips) 
Seat 8: Julik77 ($24.50 in chips) 
Seat 9: timboaus ($12.25 in chips) 
Alameda22: posts small blind $0.10
Julik77: posts big blind $0.25
*** HOLE CARDS ***
Dealt to Alameda22 [Ts 4s]
timboaus: folds 
Bobby1776: raises $0.50 to $0.75
MissStax: folds 
TBNCO: folds 
geosat: folds 
*ewenger*: folds 
Alameda22: folds 
Julik77: folds 
Uncalled bet ($0.50) returned to Bobby1776
Bobby1776 collected $0.60 from pot
Bobby1776: doesn't show hand 
*** SUMMARY ***
Total pot $0.60 | Rake $0 
Seat 1: Bobby1776 collected ($0.60)
Seat 2: MissStax folded before Flop (didn't bet)
Seat 3: TBNCO folded before Flop (didn't bet)
Seat 5: geosat folded before Flop (didn't bet)
Seat 6: *ewenger* (button) folded before Flop (didn't bet)
Seat 7: Alameda22 (small blind) folded before Flop
Seat 8: Julik77 (big blind) folded before Flop
Seat 9: timboaus folded before Flop (didn't bet)



PokerStars Game #20102853900:  Hold'em No Limit ($0.10/$0.25) - 2008/09/02 20:29:29 ET
Table 'Pomona IV' 9-max Seat #7 is the button
Seat 1: Bobby1776 ($26.30 in chips) 
Seat 2: MissStax ($24 in chips) 
Seat 3: TBNCO ($8.75 in chips) 
Seat 5: geosat ($45.70 in chips) 
Seat 6: *ewenger* ($11.35 in chips) 
Seat 7: Alameda22 ($25.10 in chips) 
Seat 8: Julik77 ($24.25 in chips) 
Seat 9: timboaus ($12.25 in chips) 
Julik77: posts small blind $0.10
timboaus: posts big blind $0.25
*** HOLE CARDS ***
Dealt to Alameda22 [Jd Kd]
Bobby1776: folds 
MissStax: folds 
TBNCO: folds 
geosat: folds 
*ewenger*: folds 
Alameda22: folds 
Julik77: folds 
Uncalled bet ($0.15) returned to timboaus
timboaus collected $0.20 from pot
timboaus: doesn't show hand 
*** SUMMARY ***
Total pot $0.20 | Rake $0 
Seat 1: Bobby1776 folded before Flop (didn't bet)
Seat 2: MissStax folded before Flop (didn't bet)
Seat 3: TBNCO folded before Flop (didn't bet)
Seat 5: geosat folded before Flop (didn't bet)
Seat 6: *ewenger* folded before Flop (didn't bet)
Seat 7: Alameda22 (button) folded before Flop (didn't bet)
Seat 8: Julik77 (small blind) folded before Flop
Seat 9: timboaus (big blind) collected ($0.20)



PokerStars Game #20102867716:  Hold'em No Limit ($0.10/$0.25) - 2008/09/02 20:30:07 ET
Table 'Pomona IV' 9-max Seat #8 is the button
Seat 1: Bobby1776 ($26.30 in chips) 
Seat 2: MissStax ($24 in chips) 
Seat 3: TBNCO ($8.75 in chips) 
Seat 5: geosat ($45.70 in chips) 
Seat 6: *ewenger* ($11.35 in chips) 
Seat 7: Alameda22 ($25.10 in chips) 
Seat 8: Julik77 ($24.15 in chips) 
Seat 9: timboaus ($12.35 in chips) 
timboaus: posts small blind $0.10
Bobby1776: posts big blind $0.25
*** HOLE CARDS ***
Dealt to Alameda22 [7c Js]
MissStax: folds 
TBNCO: folds 
geosat: folds 
*ewenger*: calls $0.25
Alameda22: folds 
Julik77: folds 
timboaus: folds 
Bobby1776: checks 
*** FLOP *** [2h 8c Qc]
Bobby1776: checks 
*ewenger*: bets $0.75
Bobby1776: calls $0.75
*** TURN *** [2h 8c Qc] [Ks]
Bobby1776: bets $1.50
*ewenger*: folds 
Uncalled bet ($1.50) returned to Bobby1776
Bobby1776 collected $2 from pot
Bobby1776: doesn't show hand 
*** SUMMARY ***
Total pot $2.10 | Rake $0.10 
Board [2h 8c Qc Ks]
Seat 1: Bobby1776 (big blind) collected ($2)
Seat 2: MissStax folded before Flop (didn't bet)
Seat 3: TBNCO folded before Flop (didn't bet)
Seat 5: geosat folded before Flop (didn't bet)
Seat 6: *ewenger* folded on the Turn
Seat 7: Alameda22 folded before Flop (didn't bet)
Seat 8: Julik77 (button) folded before Flop (didn't bet)
Seat 9: timboaus (small blind) folded before Flop



PokerStars Game #20102892283:  Hold'em No Limit ($0.10/$0.25) - 2008/09/02 20:31:10 ET
Table 'Pomona IV' 9-max Seat #9 is the button
Seat 1: Bobby1776 ($27.30 in chips) 
Seat 2: MissStax ($24 in chips) 
Seat 3: TBNCO ($8.75 in chips) 
Seat 5: geosat ($45.70 in chips) 
Seat 6: *ewenger* ($10.35 in chips) 
Seat 7: Alameda22 ($25.10 in chips) 
Seat 8: Julik77 ($24.15 in chips) 
Seat 9: timboaus ($12.25 in chips) 
Bobby1776: posts small blind $0.10
MissStax: posts big blind $0.25
*** HOLE CARDS ***
Dealt to Alameda22 [7s 2c]
TBNCO: calls $0.25
geosat: folds 
*ewenger*: folds 
Alameda22: folds 
Julik77: folds 
Julik77 leaves the table
timboaus: folds 
Bobby1776: folds 
MissStax: checks 
*** FLOP *** [Ac 8c 9d]
MissStax: checks 
TBNCO: checks 
*** TURN *** [Ac 8c 9d] [Ts]
MissStax: checks 
TBNCO: checks 
*** RIVER *** [Ac 8c 9d Ts] [7h]
MissStax: checks 
TBNCO: bets $1.25
MissStax: folds 
Uncalled bet ($1.25) returned to TBNCO
TBNCO collected $0.60 from pot
TBNCO: doesn't show hand 
*** SUMMARY ***
Total pot $0.60 | Rake $0 
Board [Ac 8c 9d Ts 7h]
Seat 1: Bobby1776 (small blind) folded before Flop
Seat 2: MissStax (big blind) folded on the River
Seat 3: TBNCO collected ($0.60)
Seat 5: geosat folded before Flop (didn't bet)
Seat 6: *ewenger* folded before Flop (didn't bet)
Seat 7: Alameda22 folded before Flop (didn't bet)
Seat 8: Julik77 folded before Flop (didn't bet)
Seat 9: timboaus (button) folded before Flop (didn't bet)



PokerStars Game #20102918048:  Hold'em No Limit ($0.10/$0.25) - 2008/09/02 20:32:19 ET
Table 'Pomona IV' 9-max Seat #1 is the button
Seat 1: Bobby1776 ($27.20 in chips) 
Seat 2: MissStax ($23.75 in chips) 
Seat 3: TBNCO ($9.10 in chips) 
Seat 5: geosat ($45.70 in chips) 
Seat 6: *ewenger* ($10.35 in chips) 
Seat 7: Alameda22 ($25.10 in chips) 
Seat 9: timboaus ($12.25 in chips) 
MissStax: posts small blind $0.10
TBNCO: posts big blind $0.25
*** HOLE CARDS ***
Dealt to Alameda22 [7c 3c]
geosat: folds 
*ewenger*: folds 
Alameda22: folds 
timboaus: folds 
Bobby1776: calls $0.25
MissStax: folds 
TBNCO: checks 
*** FLOP *** [6c Jh 8d]
TBNCO: checks 
Bobby1776: bets $0.50
TBNCO: folds 
Uncalled bet ($0.50) returned to Bobby1776
Bobby1776 collected $0.60 from pot
Bobby1776 is sitting out
Bobby1776: doesn't show hand 
*** SUMMARY ***
Total pot $0.60 | Rake $0 
Board [6c Jh 8d]
Seat 1: Bobby1776 (button) collected ($0.60)
Seat 2: MissStax (small blind) folded before Flop
Seat 3: TBNCO (big blind) folded on the Flop
Seat 5: geosat folded before Flop (didn't bet)
Seat 6: *ewenger* folded before Flop (didn't bet)
Seat 7: Alameda22 folded before Flop (didn't bet)
Seat 9: timboaus folded before Flop (didn't bet)



PokerStars Game #20102935220:  Hold'em No Limit ($0.10/$0.25) - 2008/09/02 20:33:03 ET
Table 'Pomona IV' 9-max Seat #2 is the button
Seat 2: MissStax ($23.65 in chips) 
Seat 3: TBNCO ($8.85 in chips) 
Seat 5: geosat ($45.70 in chips) 
Seat 6: *ewenger* ($10.35 in chips) 
Seat 7: Alameda22 ($25.10 in chips) 
Seat 9: timboaus ($12.25 in chips) 
TBNCO: posts small blind $0.10
geosat: posts big blind $0.25
*** HOLE CARDS ***
Dealt to Alameda22 [As 2c]
*ewenger*: calls $0.25
Alameda22: folds 
timboaus: folds 
MissStax: raises $1 to $1.25
TBNCO: folds 
geosat: folds 
*ewenger*: folds 
Uncalled bet ($1) returned to MissStax
MissStax collected $0.85 from pot
MissStax: doesn't show hand 
*** SUMMARY ***
Total pot $0.85 | Rake $0 
Seat 2: MissStax (button) collected ($0.85)
Seat 3: TBNCO (small blind) folded before Flop
Seat 5: geosat (big blind) folded before Flop
Seat 6: *ewenger* folded before Flop
Seat 7: Alameda22 folded before Flop (didn't bet)
Seat 9: timboaus folded before Flop (didn't bet)



PokerStars Game #20102958354:  Hold'em No Limit ($0.10/$0.25) - 2008/09/02 20:34:04 ET
Table 'Pomona IV' 9-max Seat #3 is the button
Seat 2: MissStax ($24.25 in chips) 
Seat 3: TBNCO ($8.75 in chips) 
Seat 5: geosat ($45.45 in chips) 
Seat 6: *ewenger* ($10.10 in chips) 
Seat 7: Alameda22 ($25.10 in chips) 
Seat 9: timboaus ($12.25 in chips) 
geosat: posts small blind $0.10
*ewenger*: posts big blind $0.25
*** HOLE CARDS ***
Dealt to Alameda22 [6s Kd]
Alameda22: folds 
timboaus: folds 
MissStax: raises $0.50 to $0.75
TBNCO: folds 
geosat: folds 
*ewenger*: folds 
Uncalled bet ($0.50) returned to MissStax
MissStax collected $0.60 from pot
MissStax: doesn't show hand 
*** SUMMARY ***
Total pot $0.60 | Rake $0 
Seat 2: MissStax collected ($0.60)
Seat 3: TBNCO (button) folded before Flop (didn't bet)
Seat 5: geosat (small blind) folded before Flop
Seat 6: *ewenger* (big blind) folded before Flop
Seat 7: Alameda22 folded before Flop (didn't bet)
Seat 9: timboaus folded before Flop (didn't bet)



PokerStars Game #20102969424:  Hold'em No Limit ($0.10/$0.25) - 2008/09/02 20:34:33 ET
Table 'Pomona IV' 9-max Seat #5 is the button
Seat 2: MissStax ($24.60 in chips) 
Seat 3: TBNCO ($8.75 in chips) 
Seat 5: geosat ($45.35 in chips) 
Seat 6: *ewenger* ($9.85 in chips) 
Seat 7: Alameda22 ($25.10 in chips) 
Seat 9: timboaus ($12.25 in chips) 
*ewenger*: posts small blind $0.10
Alameda22: posts big blind $0.25
*** HOLE CARDS ***
Dealt to Alameda22 [8h 9d]
timboaus: folds 
MissStax: folds 
TBNCO: folds 
geosat: raises $0.75 to $1
*ewenger*: folds 
Alameda22: folds 
Uncalled bet ($0.75) returned to geosat
DawsonS64 joins the table at seat #8 
geosat collected $0.60 from pot
geosat: doesn't show hand 
*** SUMMARY ***
Total pot $0.60 | Rake $0 
Seat 2: MissStax folded before Flop (didn't bet)
Seat 3: TBNCO folded before Flop (didn't bet)
Seat 5: geosat (button) collected ($0.60)
Seat 6: *ewenger* (small blind) folded before Flop
Seat 7: Alameda22 (big blind) folded before Flop
Seat 9: timboaus folded before Flop (didn't bet)



PokerStars Game #20102985127:  Hold'em No Limit ($0.10/$0.25) - 2008/09/02 20:35:14 ET
Table 'Pomona IV' 9-max Seat #6 is the button
Seat 2: MissStax ($24.60 in chips) 
Seat 3: TBNCO ($8.75 in chips) 
Seat 5: geosat ($45.70 in chips) 
Seat 6: *ewenger* ($9.75 in chips) 
Seat 7: Alameda22 ($24.85 in chips) 
Seat 8: DawsonS64 ($25 in chips) 
Seat 9: timboaus ($12.25 in chips) 
Alameda22: posts small blind $0.10
DawsonS64: posts big blind $0.25
*** HOLE CARDS ***
Dealt to Alameda22 [Jd 7h]
timboaus: folds 
MissStax: folds 
TBNCO: folds 
geosat: folds 
*ewenger*: folds 
Alameda22: folds 
Uncalled bet ($0.15) returned to DawsonS64
DawsonS64 collected $0.20 from pot
DawsonS64: doesn't show hand 
*** SUMMARY ***
Total pot $0.20 | Rake $0 
Seat 2: MissStax folded before Flop (didn't bet)
Seat 3: TBNCO folded before Flop (didn't bet)
Seat 5: geosat folded before Flop (didn't bet)
Seat 6: *ewenger* (button) folded before Flop (didn't bet)
Seat 7: Alameda22 (small blind) folded before Flop
Seat 8: DawsonS64 (big blind) collected ($0.20)
Seat 9: timboaus folded before Flop (didn't bet)



PokerStars Game #20103001133:  Hold'em No Limit ($0.10/$0.25) - 2008/09/02 20:35:56 ET
Table 'Pomona IV' 9-max Seat #7 is the button
Seat 2: MissStax ($24.60 in chips) 
Seat 3: TBNCO ($8.75 in chips) 
Seat 5: geosat ($45.70 in chips) 
Seat 6: *ewenger* ($9.75 in chips) 
Seat 7: Alameda22 ($24.75 in chips) 
Seat 8: DawsonS64 ($25.10 in chips) 
Seat 9: timboaus ($12.25 in chips) 
DawsonS64: posts small blind $0.10
timboaus: posts big blind $0.25
*** HOLE CARDS ***
Dealt to Alameda22 [2s 8s]
MissStax: folds 
TBNCO: calls $0.25
geosat: folds 
*ewenger*: folds 
Alameda22: folds 
DawsonS64: calls $0.15
timboaus: raises $0.95 to $1.20
TBNCO: calls $0.95
DawsonS64: folds 
*** FLOP *** [Ad 9h Kd]
timboaus: bets $3
TBNCO: raises $4.55 to $7.55 and is all-in
timboaus: calls $4.55
*** TURN *** [Ad 9h Kd] [6c]
*** RIVER *** [Ad 9h Kd 6c] [Jd]
*** SHOW DOWN ***
timboaus: shows [Jh As] (two pair, Aces and Jacks)
TBNCO: shows [9d Kc] (two pair, Kings and Nines)
timboaus collected $16.90 from pot
*ewenger* is disconnected 
*** SUMMARY ***
Total pot $17.75 | Rake $0.85 
Board [Ad 9h Kd 6c Jd]
Seat 2: MissStax folded before Flop (didn't bet)
Seat 3: TBNCO showed [9d Kc] and lost with two pair, Kings and Nines
Seat 5: geosat folded before Flop (didn't bet)
Seat 6: *ewenger* folded before Flop (didn't bet)
Seat 7: Alameda22 (button) folded before Flop (didn't bet)
Seat 8: DawsonS64 (small blind) folded before Flop
Seat 9: timboaus (big blind) showed [Jh As] and won ($16.90) with two pair, Aces and Jacks



PokerStars Game #20103030635:  Hold'em No Limit ($0.10/$0.25) - 2008/09/02 20:37:14 ET
Table 'Pomona IV' 9-max Seat #8 is the button
Seat 2: MissStax ($24.60 in chips) 
Seat 5: geosat ($45.70 in chips) 
Seat 6: *ewenger* ($9.75 in chips) 
Seat 7: Alameda22 ($24.75 in chips) 
Seat 8: DawsonS64 ($24.85 in chips) 
Seat 9: timboaus ($20.40 in chips) 
timboaus: posts small blind $0.10
MissStax: posts big blind $0.25
*** HOLE CARDS ***
Dealt to Alameda22 [4c 9s]
geosat: folds 
TBNCO said, "nice river"
*ewenger* is connected 
*ewenger*: raises $0.75 to $1
TBNCO has returned
Alameda22: folds 
DawsonS64: folds 
timboaus: folds 
MissStax: folds 
Uncalled bet ($0.75) returned to *ewenger*
*ewenger* collected $0.60 from pot
*ewenger*: doesn't show hand 
*** SUMMARY ***
Total pot $0.60 | Rake $0 
Seat 2: MissStax (big blind) folded before Flop
Seat 5: geosat folded before Flop (didn't bet)
Seat 6: *ewenger* collected ($0.60)
Seat 7: Alameda22 folded before Flop (didn't bet)
Seat 8: DawsonS64 (button) folded before Flop (didn't bet)
Seat 9: timboaus (small blind) folded before Flop



PokerStars Game #20103046773:  Hold'em No Limit ($0.10/$0.25) - 2008/09/02 20:37:56 ET
Table 'Pomona IV' 9-max Seat #9 is the button
Seat 2: MissStax ($24.35 in chips) 
Seat 3: TBNCO ($15 in chips) 
Seat 5: geosat ($45.70 in chips) 
Seat 6: *ewenger* ($10.10 in chips) 
Seat 7: Alameda22 ($24.75 in chips) 
Seat 8: DawsonS64 ($24.85 in chips) 
Seat 9: timboaus ($20.30 in chips) 
MissStax: posts small blind $0.10
TBNCO: posts big blind $0.25
*** HOLE CARDS ***
Dealt to Alameda22 [7c 3d]
geosat: folds 
*ewenger*: folds 
Alameda22: folds 
DawsonS64: folds 
timboaus: raises $1.05 to $1.30
MissStax: folds 
TBNCO: folds 
Uncalled bet ($1.05) returned to timboaus
timboaus collected $0.60 from pot
timboaus: doesn't show hand 
*** SUMMARY ***
Total pot $0.60 | Rake $0 
Seat 2: MissStax (small blind) folded before Flop
Seat 3: TBNCO (big blind) folded before Flop
Seat 5: geosat folded before Flop (didn't bet)
Seat 6: *ewenger* folded before Flop (didn't bet)
Seat 7: Alameda22 folded before Flop (didn't bet)
Seat 8: DawsonS64 folded before Flop (didn't bet)
Seat 9: timboaus (button) collected ($0.60)



PokerStars Game #20103061658:  Hold'em No Limit ($0.10/$0.25) - 2008/09/02 20:38:34 ET
Table 'Pomona IV' 9-max Seat #2 is the button
Seat 2: MissStax ($24.25 in chips) 
Seat 3: TBNCO ($14.75 in chips) 
Seat 5: geosat ($45.70 in chips) 
Seat 6: *ewenger* ($10.10 in chips) 
Seat 7: Alameda22 ($24.75 in chips) 
Seat 8: DawsonS64 ($24.85 in chips) 
Seat 9: timboaus ($20.65 in chips) 
TBNCO: posts small blind $0.10
geosat: posts big blind $0.25
*** HOLE CARDS ***
Dealt to Alameda22 [Qd Ah]
*ewenger*: folds 
Alameda22: raises $0.75 to $1
DawsonS64: folds 
timboaus: folds 
MissStax: folds 
MissStax is sitting out
TBNCO: raises $0.75 to $1.75
geosat: calls $1.50
Alameda22: calls $0.75
*** FLOP *** [4d 8c Ts]
TBNCO: checks 
geosat: checks 
Alameda22: bets $3.25
TBNCO: folds 
geosat: folds 
Uncalled bet ($3.25) returned to Alameda22
Alameda22 collected $5 from pot
Alameda22: doesn't show hand 
*** SUMMARY ***
Total pot $5.25 | Rake $0.25 
Board [4d 8c Ts]
Seat 2: MissStax (button) folded before Flop (didn't bet)
Seat 3: TBNCO (small blind) folded on the Flop
Seat 5: geosat (big blind) folded on the Flop
Seat 6: *ewenger* folded before Flop (didn't bet)
Seat 7: Alameda22 collected ($5)
Seat 8: DawsonS64 folded before Flop (didn't bet)
Seat 9: timboaus folded before Flop (didn't bet)



PokerStars Game #20103099820:  Hold'em No Limit ($0.10/$0.25) - 2008/09/02 20:40:13 ET
Table 'Pomona IV' 9-max Seat #3 is the button
Seat 3: TBNCO ($13 in chips) 
Seat 5: geosat ($43.95 in chips) 
Seat 6: *ewenger* ($10.10 in chips) 
Seat 7: Alameda22 ($28 in chips) 
Seat 8: DawsonS64 ($24.85 in chips) 
Seat 9: timboaus ($20.65 in chips) 
XXXRIOJAXXX was removed from the table for failing to post
geosat: posts small blind $0.10
*ewenger*: posts big blind $0.25
*** HOLE CARDS ***
Dealt to Alameda22 [Js 9s]
Alameda22: folds 
DawsonS64: calls $0.25
timboaus: raises $0.95 to $1.20
TBNCO: folds 
geosat: folds 
*ewenger*: folds 
DawsonS64: folds 
Uncalled bet ($0.95) returned to timboaus
timboaus collected $0.85 from pot
timboaus: doesn't show hand 
*** SUMMARY ***
Total pot $0.85 | Rake $0 
Seat 3: TBNCO (button) folded before Flop (didn't bet)
Seat 5: geosat (small blind) folded before Flop
Seat 6: *ewenger* (big blind) folded before Flop
Seat 7: Alameda22 folded before Flop (didn't bet)
Seat 8: DawsonS64 folded before Flop
Seat 9: timboaus collected ($0.85)



PokerStars Game #20103114070:  Hold'em No Limit ($0.10/$0.25) - 2008/09/02 20:40:50 ET
Table 'Pomona IV' 9-max Seat #5 is the button
Seat 3: TBNCO ($13 in chips) 
Seat 5: geosat ($43.85 in chips) 
Seat 6: *ewenger* ($9.85 in chips) 
Seat 7: Alameda22 ($28 in chips) 
Seat 8: DawsonS64 ($24.60 in chips) 
Seat 9: timboaus ($21.25 in chips) 
*ewenger*: posts small blind $0.10
Alameda22: posts big blind $0.25
*** HOLE CARDS ***
Dealt to Alameda22 [5c Td]
DawsonS64: folds 
timboaus: folds 
TBNCO: folds 
geosat: folds 
*ewenger*: folds 
Uncalled bet ($0.15) returned to Alameda22
Alameda22 collected $0.20 from pot
Alameda22: doesn't show hand 
*** SUMMARY ***
Total pot $0.20 | Rake $0 
Seat 3: TBNCO folded before Flop (didn't bet)
Seat 5: geosat (button) folded before Flop (didn't bet)
Seat 6: *ewenger* (small blind) folded before Flop
Seat 7: Alameda22 (big blind) collected ($0.20)
Seat 8: DawsonS64 folded before Flop (didn't bet)
Seat 9: timboaus folded before Flop (didn't bet)



PokerStars Game #20103126567:  Hold'em No Limit ($0.10/$0.25) - 2008/09/02 20:41:23 ET
Table 'Pomona IV' 9-max Seat #6 is the button
Seat 3: TBNCO ($13 in chips) 
Seat 5: geosat ($43.85 in chips) 
Seat 6: *ewenger* ($9.75 in chips) 
Seat 7: Alameda22 ($28.10 in chips) 
Seat 8: DawsonS64 ($24.60 in chips) 
Seat 9: timboaus ($21.25 in chips) 
Alameda22: posts small blind $0.10
DawsonS64: posts big blind $0.25
*** HOLE CARDS ***
Dealt to Alameda22 [4h Ac]
timboaus: folds 
TBNCO: folds 
geosat: raises $0.75 to $1
*ewenger*: folds 
Alameda22: folds 
DawsonS64: folds 
Uncalled bet ($0.75) returned to geosat
geosat collected $0.60 from pot
geosat: doesn't show hand 
*** SUMMARY ***
Total pot $0.60 | Rake $0 
Seat 3: TBNCO folded before Flop (didn't bet)
Seat 5: geosat collected ($0.60)
Seat 6: *ewenger* (button) folded before Flop (didn't bet)
Seat 7: Alameda22 (small blind) folded before Flop
Seat 8: DawsonS64 (big blind) folded before Flop
Seat 9: timboaus folded before Flop (didn't bet)



PokerStars Game #20103138038:  Hold'em No Limit ($0.10/$0.25) - 2008/09/02 20:41:53 ET
Table 'Pomona IV' 9-max Seat #7 is the button
Seat 3: TBNCO ($13 in chips) 
Seat 5: geosat ($44.20 in chips) 
Seat 6: *ewenger* ($9.75 in chips) 
Seat 7: Alameda22 ($28 in chips) 
Seat 8: DawsonS64 ($24.35 in chips) 
Seat 9: timboaus ($21.25 in chips) 
DawsonS64: posts small blind $0.10
timboaus: posts big blind $0.25
*** HOLE CARDS ***
Dealt to Alameda22 [3s Ah]
TBNCO: folds 
geosat: folds 
*ewenger*: folds 
Alameda22: folds 
DawsonS64: calls $0.15
MissStax has returned
timboaus: checks 
*** FLOP *** [Jd 7d 6c]
DawsonS64: bets $0.50
timboaus: folds 
Uncalled bet ($0.50) returned to DawsonS64
DawsonS64 collected $0.50 from pot
DawsonS64: doesn't show hand 
*** SUMMARY ***
Total pot $0.50 | Rake $0 
Board [Jd 7d 6c]
Seat 3: TBNCO folded before Flop (didn't bet)
Seat 5: geosat folded before Flop (didn't bet)
Seat 6: *ewenger* folded before Flop (didn't bet)
Seat 7: Alameda22 (button) folded before Flop (didn't bet)
Seat 8: DawsonS64 (small blind) collected ($0.50)
Seat 9: timboaus (big blind) folded on the Flop



PokerStars Game #20103154998:  Hold'em No Limit ($0.10/$0.25) - 2008/09/02 20:42:37 ET
Table 'Pomona IV' 9-max Seat #8 is the button
Seat 2: MissStax ($24.25 in chips) 
Seat 3: TBNCO ($13 in chips) 
Seat 5: geosat ($44.20 in chips) 
Seat 6: *ewenger* ($9.75 in chips) 
Seat 7: Alameda22 ($28 in chips) 
Seat 8: DawsonS64 ($24.60 in chips) 
Seat 9: timboaus ($21 in chips) 
timboaus: posts small blind $0.10
MissStax: posts big blind $0.25
*** HOLE CARDS ***
Dealt to Alameda22 [Th Jh]
TBNCO: folds 
geosat: folds 
Bobby1776 has returned
*ewenger*: folds 
Alameda22: raises $0.75 to $1
DawsonS64: folds 
pbdan01 joins the table at seat #4 
timboaus: folds 
MissStax: folds 
Uncalled bet ($0.75) returned to Alameda22
Alameda22 collected $0.60 from pot
Alameda22: doesn't show hand 
*** SUMMARY ***
Total pot $0.60 | Rake $0 
Seat 2: MissStax (big blind) folded before Flop
Seat 3: TBNCO folded before Flop (didn't bet)
Seat 5: geosat folded before Flop (didn't bet)
Seat 6: *ewenger* folded before Flop (didn't bet)
Seat 7: Alameda22 collected ($0.60)
Seat 8: DawsonS64 (button) folded before Flop (didn't bet)
Seat 9: timboaus (small blind) folded before Flop



PokerStars Game #20103171954:  Hold'em No Limit ($0.10/$0.25) - 2008/09/02 20:43:22 ET
Table 'Pomona IV' 9-max Seat #9 is the button
Seat 2: MissStax ($24 in chips) 
Seat 3: TBNCO ($13 in chips) 
Seat 4: pbdan01 ($15 in chips) 
Seat 5: geosat ($44.20 in chips) 
Seat 6: *ewenger* ($9.75 in chips) 
Seat 7: Alameda22 ($28.35 in chips) 
Seat 8: DawsonS64 ($24.60 in chips) 
Seat 9: timboaus ($20.90 in chips) 
Bobby1776 will be allowed to play after the button
MissStax: posts small blind $0.10
TBNCO: posts big blind $0.25
pbdan01: posts big blind $0.25
*** HOLE CARDS ***
Dealt to Alameda22 [6d Tc]
pbdan01: checks 
geosat: folds 
*ewenger*: folds 
Alameda22: folds 
DawsonS64: folds 
timboaus: folds 
MissStax: folds 
TBNCO: raises $0.25 to $0.50
pbdan01: calls $0.25
*** FLOP *** [Qc 2d Qd]
TBNCO: checks 
pbdan01: bets $0.50
TBNCO: calls $0.50
*** TURN *** [Qc 2d Qd] [8h]
TBNCO: checks 
pbdan01: bets $0.50
TBNCO: raises $0.50 to $1
pbdan01: folds 
Uncalled bet ($0.50) returned to TBNCO
TBNCO collected $2.95 from pot
TBNCO: doesn't show hand 
*** SUMMARY ***
Total pot $3.10 | Rake $0.15 
Board [Qc 2d Qd 8h]
Seat 2: MissStax (small blind) folded before Flop
Seat 3: TBNCO (big blind) collected ($2.95)
Seat 4: pbdan01 folded on the Turn
Seat 5: geosat folded before Flop (didn't bet)
Seat 6: *ewenger* folded before Flop (didn't bet)
Seat 7: Alameda22 folded before Flop (didn't bet)
Seat 8: DawsonS64 folded before Flop (didn't bet)
Seat 9: timboaus (button) folded before Flop (didn't bet)



PokerStars Game #20103208294:  Hold'em No Limit ($0.10/$0.25) - 2008/09/02 20:44:59 ET
Table 'Pomona IV' 9-max Seat #2 is the button
Seat 1: Bobby1776 ($27.55 in chips) 
Seat 2: MissStax ($23.90 in chips) 
Seat 3: TBNCO ($14.45 in chips) 
Seat 4: pbdan01 ($13.50 in chips) 
Seat 5: geosat ($44.20 in chips) 
Seat 6: *ewenger* ($9.75 in chips) 
Seat 7: Alameda22 ($28.35 in chips) 
Seat 8: DawsonS64 ($24.60 in chips) 
Seat 9: timboaus ($20.90 in chips) 
TBNCO: posts small blind $0.10
pbdan01: posts big blind $0.25
Bobby1776: posts small & big blinds $0.35
*** HOLE CARDS ***
Dealt to Alameda22 [7s 2d]
geosat: folds 
*ewenger*: folds 
Alameda22: folds 
DawsonS64: folds 
timboaus: folds 
Bobby1776: checks 
MissStax: raises $0.75 to $1
TBNCO: folds 
pbdan01: folds 
Bobby1776: calls $0.75
*** FLOP *** [Jd As 5h]
Bobby1776: checks 
MissStax: bets $1.50
Bobby1776: raises $2 to $3.50
MissStax: folds 
Uncalled bet ($2) returned to Bobby1776
Bobby1776 collected $5.20 from pot
Bobby1776: doesn't show hand 
*** SUMMARY ***
Total pot $5.45 | Rake $0.25 
Board [Jd As 5h]
Seat 1: Bobby1776 collected ($5.20)
Seat 2: MissStax (button) folded on the Flop
Seat 3: TBNCO (small blind) folded before Flop
Seat 4: pbdan01 (big blind) folded before Flop
Seat 5: geosat folded before Flop (didn't bet)
Seat 6: *ewenger* folded before Flop (didn't bet)
Seat 7: Alameda22 folded before Flop (didn't bet)
Seat 8: DawsonS64 folded before Flop (didn't bet)
Seat 9: timboaus folded before Flop (didn't bet)



PokerStars Game #20103246771:  Hold'em No Limit ($0.10/$0.25) - 2008/09/02 20:46:41 ET
Table 'Pomona IV' 9-max Seat #3 is the button
Seat 1: Bobby1776 ($30.15 in chips) 
Seat 2: MissStax ($21.40 in chips) 
Seat 3: TBNCO ($14.35 in chips) 
Seat 4: pbdan01 ($13.25 in chips) 
Seat 5: geosat ($44.20 in chips) 
Seat 6: *ewenger* ($9.75 in chips) 
Seat 7: Alameda22 ($28.35 in chips) 
Seat 8: DawsonS64 ($24.60 in chips) 
Seat 9: timboaus ($20.90 in chips) 
pbdan01: posts small blind $0.10
geosat: posts big blind $0.25
*** HOLE CARDS ***
Dealt to Alameda22 [Kh Qh]
*ewenger*: folds 
Alameda22: folds 
DawsonS64: folds 
timboaus: folds 
Bobby1776: raises $0.50 to $0.75
MissStax: folds 
TBNCO: calls $0.75
pbdan01: calls $0.65
geosat: folds 
*** FLOP *** [6c Ts 6s]
pbdan01: checks 
Bobby1776: bets $1.75
TBNCO: calls $1.75
pbdan01: folds 
*** TURN *** [6c Ts 6s] [7c]
Bobby1776: checks 
TBNCO: checks 
*** RIVER *** [6c Ts 6s 7c] [Jd]
Bobby1776: bets $3.50
TBNCO: raises $4.50 to $8
Bobby1776: folds 
Uncalled bet ($4.50) returned to TBNCO
TBNCO collected $12.40 from pot
TBNCO: doesn't show hand 
*** SUMMARY ***
Total pot $13 | Rake $0.60 
Board [6c Ts 6s 7c Jd]
Seat 1: Bobby1776 folded on the River
Seat 2: MissStax folded before Flop (didn't bet)
Seat 3: TBNCO (button) collected ($12.40)
Seat 4: pbdan01 (small blind) folded on the Flop
Seat 5: geosat (big blind) folded before Flop
Seat 6: *ewenger* folded before Flop (didn't bet)
Seat 7: Alameda22 folded before Flop (didn't bet)
Seat 8: DawsonS64 folded before Flop (didn't bet)
Seat 9: timboaus folded before Flop (didn't bet)



PokerStars Game #20103290372:  Hold'em No Limit ($0.10/$0.25) - 2008/09/02 20:48:37 ET
Table 'Pomona IV' 9-max Seat #4 is the button
Seat 1: Bobby1776 ($24.15 in chips) 
Seat 2: MissStax ($21.40 in chips) 
Seat 3: TBNCO ($20.75 in chips) 
Seat 4: pbdan01 ($12.50 in chips) 
Seat 5: geosat ($43.95 in chips) 
Seat 6: *ewenger* ($9.75 in chips) 
Seat 7: Alameda22 ($28.35 in chips) 
Seat 8: DawsonS64 ($24.60 in chips) 
Seat 9: timboaus ($20.90 in chips) 
geosat: posts small blind $0.10
*ewenger*: posts big blind $0.25
*** HOLE CARDS ***
Dealt to Alameda22 [2s As]
Alameda22: folds 
DawsonS64: calls $0.25
timboaus: folds 
Bobby1776: calls $0.25
MissStax: calls $0.25
TBNCO: calls $0.25
pbdan01: folds 
geosat: folds 
*ewenger*: checks 
*** FLOP *** [4s 8c 9c]
*ewenger*: checks 
DawsonS64: checks 
Bobby1776: bets $0.75
MissStax: folds 
TBNCO: folds 
*ewenger*: raises $3 to $3.75
DawsonS64: folds 
DawsonS64 is sitting out
Bobby1776: folds 
Uncalled bet ($3) returned to *ewenger*
*ewenger* collected $2.75 from pot
*** SUMMARY ***
Total pot $2.85 | Rake $0.10 
Board [4s 8c 9c]
Seat 1: Bobby1776 folded on the Flop
Seat 2: MissStax folded on the Flop
Seat 3: TBNCO folded on the Flop
Seat 4: pbdan01 (button) folded before Flop (didn't bet)
Seat 5: geosat (small blind) folded before Flop
Seat 6: *ewenger* (big blind) collected ($2.75)
Seat 7: Alameda22 folded before Flop (didn't bet)
Seat 8: DawsonS64 folded on the Flop
Seat 9: timboaus folded before Flop (didn't bet)



PokerStars Game #20103330338:  Hold'em No Limit ($0.10/$0.25) - 2008/09/02 20:50:23 ET
Table 'Pomona IV' 9-max Seat #5 is the button
Seat 1: Bobby1776 ($23.15 in chips) 
Seat 2: MissStax ($21.15 in chips) 
Seat 3: TBNCO ($20.50 in chips) 
Seat 4: pbdan01 ($12.50 in chips) 
Seat 5: geosat ($43.85 in chips) 
Seat 6: *ewenger* ($11.50 in chips) 
Seat 7: Alameda22 ($28.35 in chips) 
Seat 9: timboaus ($20.90 in chips) 
*ewenger*: posts small blind $0.10
Alameda22: posts big blind $0.25
*** HOLE CARDS ***
Dealt to Alameda22 [3c 6h]
timboaus: folds 
Bobby1776: raises $0.50 to $0.75
MissStax: folds 
TBNCO: calls $0.75
pbdan01: folds 
geosat: folds 
*ewenger*: folds 
Alameda22: folds 
*** FLOP *** [Ah 4s 2s]
Bobby1776: checks 
TBNCO: bets $0.75
Bobby1776: raises $1.50 to $2.25
TBNCO: calls $1.50
*** TURN *** [Ah 4s 2s] [Jc]
Bobby1776: bets $4
TBNCO: calls $4
*** RIVER *** [Ah 4s 2s Jc] [5d]
Bobby1776: checks 
TBNCO: checks 
*** SHOW DOWN ***
Bobby1776: shows [Qc 8c] (high card Ace)
TBNCO: shows [Tc Ad] (a pair of Aces)
TBNCO collected $13.65 from pot
*** SUMMARY ***
Total pot $14.35 | Rake $0.70 
Board [Ah 4s 2s Jc 5d]
Seat 1: Bobby1776 showed [Qc 8c] and lost with high card Ace
Seat 2: MissStax folded before Flop (didn't bet)
Seat 3: TBNCO showed [Tc Ad] and won ($13.65) with a pair of Aces
Seat 4: pbdan01 folded before Flop (didn't bet)
Seat 5: geosat (button) folded before Flop (didn't bet)
Seat 6: *ewenger* (small blind) folded before Flop
Seat 7: Alameda22 (big blind) folded before Flop
Seat 9: timboaus folded before Flop (didn't bet)



PokerStars Game #20103385273:  Hold'em No Limit ($0.10/$0.25) - 2008/09/02 20:52:49 ET
Table 'Pomona IV' 9-max Seat #6 is the button
Seat 1: Bobby1776 ($16.15 in chips) 
Seat 2: MissStax ($21.15 in chips) 
Seat 3: TBNCO ($27.15 in chips) 
Seat 4: pbdan01 ($12.50 in chips) 
Seat 5: geosat ($43.85 in chips) 
Seat 6: *ewenger* ($11.40 in chips) 
Seat 7: Alameda22 ($28.10 in chips) 
Seat 9: timboaus ($20.90 in chips) 
Alameda22: posts small blind $0.10
timboaus: posts big blind $0.25
*** HOLE CARDS ***
Dealt to Alameda22 [9d 6s]
Bobby1776: calls $0.25
MissStax: raises $1 to $1.25
TBNCO: folds 
pbdan01: folds 
geosat: folds 
*ewenger*: folds 
Alameda22: folds 
timboaus: folds 
Bobby1776: folds 
Uncalled bet ($1) returned to MissStax
MissStax collected $0.85 from pot
MissStax: doesn't show hand 
*** SUMMARY ***
Total pot $0.85 | Rake $0 
Seat 1: Bobby1776 folded before Flop
Seat 2: MissStax collected ($0.85)
Seat 3: TBNCO folded before Flop (didn't bet)
Seat 4: pbdan01 folded before Flop (didn't bet)
Seat 5: geosat folded before Flop (didn't bet)
Seat 6: *ewenger* (button) folded before Flop (didn't bet)
Seat 7: Alameda22 (small blind) folded before Flop
Seat 9: timboaus (big blind) folded before Flop



PokerStars Game #20103398974:  Hold'em No Limit ($0.10/$0.25) - 2008/09/02 20:53:26 ET
Table 'Pomona IV' 9-max Seat #7 is the button
Seat 1: Bobby1776 ($15.90 in chips) 
Seat 2: MissStax ($21.75 in chips) 
Seat 3: TBNCO ($27.15 in chips) 
Seat 4: pbdan01 ($12.50 in chips) 
Seat 5: geosat ($43.85 in chips) 
Seat 6: *ewenger* ($11.40 in chips) 
Seat 7: Alameda22 ($28 in chips) 
Seat 9: timboaus ($20.65 in chips) 
timboaus: posts small blind $0.10
Bobby1776: posts big blind $0.25
*** HOLE CARDS ***
Dealt to Alameda22 [Th Jc]
MissStax: folds 
TBNCO: folds 
pbdan01: calls $0.25
geosat: folds 
*ewenger*: folds 
Alameda22: folds 
timboaus: folds 
Bobby1776: checks 
*** FLOP *** [6d Jd Td]
Bobby1776: checks 
pbdan01: bets $1
Bobby1776: folds 
Uncalled bet ($1) returned to pbdan01
pbdan01 collected $0.60 from pot
pbdan01: doesn't show hand 
*** SUMMARY ***
Total pot $0.60 | Rake $0 
Board [6d Jd Td]
Seat 1: Bobby1776 (big blind) folded on the Flop
Seat 2: MissStax folded before Flop (didn't bet)
Seat 3: TBNCO folded before Flop (didn't bet)
Seat 4: pbdan01 collected ($0.60)
Seat 5: geosat folded before Flop (didn't bet)
Seat 6: *ewenger* folded before Flop (didn't bet)
Seat 7: Alameda22 (button) folded before Flop (didn't bet)
Seat 9: timboaus (small blind) folded before Flop



PokerStars Game #20103415698:  Hold'em No Limit ($0.10/$0.25) - 2008/09/02 20:54:12 ET
Table 'Pomona IV' 9-max Seat #9 is the button
Seat 1: Bobby1776 ($15.65 in chips) 
Seat 2: MissStax ($21.75 in chips) 
Seat 3: TBNCO ($27.15 in chips) 
Seat 4: pbdan01 ($12.85 in chips) 
Seat 5: geosat ($43.85 in chips) 
Seat 6: *ewenger* ($11.40 in chips) 
Seat 7: Alameda22 ($28 in chips) 
Seat 9: timboaus ($20.55 in chips) 
Bobby1776: posts small blind $0.10
MissStax: posts big blind $0.25
*** HOLE CARDS ***
Dealt to Alameda22 [Ad 7d]
TBNCO: folds 
pbdan01: calls $0.25
geosat: folds 
*ewenger*: folds 
Alameda22: folds 
timboaus: folds 
Bobby1776: calls $0.15
MissStax: checks 
*** FLOP *** [5d Ah 2d]
Bobby1776: checks 
DawsonS64 has returned
MissStax: bets $0.50
pbdan01: calls $0.50
Bobby1776: calls $0.50
*** TURN *** [5d Ah 2d] [3c]
Bobby1776: checks 
MissStax: checks 
pbdan01: checks 
*** RIVER *** [5d Ah 2d 3c] [5s]
Bobby1776: checks 
MissStax: checks 
pbdan01: checks 
*** SHOW DOWN ***
Bobby1776: shows [Jd Jh] (two pair, Jacks and Fives)
MissStax: mucks hand 
pbdan01: shows [7c As] (two pair, Aces and Fives)
pbdan01 collected $2.15 from pot
*** SUMMARY ***
Total pot $2.25 | Rake $0.10 
Board [5d Ah 2d 3c 5s]
Seat 1: Bobby1776 (small blind) showed [Jd Jh] and lost with two pair, Jacks and Fives
Seat 2: MissStax (big blind) mucked [Kd 6d]
Seat 3: TBNCO folded before Flop (didn't bet)
Seat 4: pbdan01 showed [7c As] and won ($2.15) with two pair, Aces and Fives
Seat 5: geosat folded before Flop (didn't bet)
Seat 6: *ewenger* folded before Flop (didn't bet)
Seat 7: Alameda22 folded before Flop (didn't bet)
Seat 9: timboaus (button) folded before Flop (didn't bet)



PokerStars Game #20103439574:  Hold'em No Limit ($0.10/$0.25) - 2008/09/02 20:55:17 ET
Table 'Pomona IV' 9-max Seat #1 is the button
Seat 1: Bobby1776 ($14.90 in chips) 
Seat 2: MissStax ($21 in chips) 
Seat 3: TBNCO ($27.15 in chips) 
Seat 4: pbdan01 ($14.25 in chips) 
Seat 5: geosat ($43.85 in chips) 
Seat 6: *ewenger* ($11.40 in chips) 
Seat 7: Alameda22 ($28 in chips) 
Seat 8: DawsonS64 ($24.35 in chips) 
Seat 9: timboaus ($20.55 in chips) 
MissStax: posts small blind $0.10
TBNCO: posts big blind $0.25
DawsonS64: posts small & big blinds $0.35
*** HOLE CARDS ***
Dealt to Alameda22 [5s Ts]
pbdan01: folds 
geosat: folds 
*ewenger*: folds 
Alameda22: folds 
DawsonS64: checks 
timboaus: calls $0.25
Bobby1776: calls $0.25
MissStax: calls $0.15
TBNCO: checks 
*** FLOP *** [6d Qd 4c]
MissStax: checks 
TBNCO: checks 
DawsonS64: checks 
timboaus: bets $2.25
Bobby1776: folds 
MissStax: folds 
TBNCO: folds 
DawsonS64: folds 
Uncalled bet ($2.25) returned to timboaus
timboaus collected $1.30 from pot
timboaus: doesn't show hand 
*** SUMMARY ***
Total pot $1.35 | Rake $0.05 
Board [6d Qd 4c]
Seat 1: Bobby1776 (button) folded on the Flop
Seat 2: MissStax (small blind) folded on the Flop
Seat 3: TBNCO (big blind) folded on the Flop
Seat 4: pbdan01 folded before Flop (didn't bet)
Seat 5: geosat folded before Flop (didn't bet)
Seat 6: *ewenger* folded before Flop (didn't bet)
Seat 7: Alameda22 folded before Flop (didn't bet)
Seat 8: DawsonS64 folded on the Flop
Seat 9: timboaus collected ($1.30)



PokerStars Game #20103470319:  Hold'em No Limit ($0.10/$0.25) - 2008/09/02 20:56:40 ET
Table 'Pomona IV' 9-max Seat #2 is the button
Seat 1: Bobby1776 ($14.65 in chips) 
Seat 2: MissStax ($20.75 in chips) 
Seat 3: TBNCO ($26.90 in chips) 
Seat 4: pbdan01 ($14.25 in chips) 
Seat 5: geosat ($43.85 in chips) 
Seat 6: *ewenger* ($11.40 in chips) 
Seat 7: Alameda22 ($28 in chips) 
Seat 8: DawsonS64 ($24 in chips) 
Seat 9: timboaus ($21.60 in chips) 
TBNCO: posts small blind $0.10
pbdan01: posts big blind $0.25
*** HOLE CARDS ***
Dealt to Alameda22 [8s 3d]
geosat: folds 
*ewenger*: folds 
Alameda22: folds 
DawsonS64: folds 
timboaus: folds 
Bobby1776: raises $0.50 to $0.75
MissStax: calls $0.75
TBNCO: calls $0.65
pbdan01: folds 
*** FLOP *** [Qh 4c 3s]
TBNCO: bets $0.75
Bobby1776: folds 
MissStax: folds 
Uncalled bet ($0.75) returned to TBNCO
TBNCO collected $2.40 from pot
TBNCO: doesn't show hand 
*** SUMMARY ***
Total pot $2.50 | Rake $0.10 
Board [Qh 4c 3s]
Seat 1: Bobby1776 folded on the Flop
Seat 2: MissStax (button) folded on the Flop
Seat 3: TBNCO (small blind) collected ($2.40)
Seat 4: pbdan01 (big blind) folded before Flop
Seat 5: geosat folded before Flop (didn't bet)
Seat 6: *ewenger* folded before Flop (didn't bet)
Seat 7: Alameda22 folded before Flop (didn't bet)
Seat 8: DawsonS64 folded before Flop (didn't bet)
Seat 9: timboaus folded before Flop (didn't bet)



PokerStars Game #20103501784:  Hold'em No Limit ($0.10/$0.25) - 2008/09/02 20:58:05 ET
Table 'Pomona IV' 9-max Seat #3 is the button
Seat 1: Bobby1776 ($13.90 in chips) 
Seat 2: MissStax ($20 in chips) 
Seat 3: TBNCO ($28.55 in chips) 
Seat 4: pbdan01 ($14 in chips) 
Seat 5: geosat ($43.85 in chips) 
Seat 6: *ewenger* ($11.40 in chips) 
Seat 7: Alameda22 ($28 in chips) 
Seat 8: DawsonS64 ($24 in chips) 
Seat 9: timboaus ($21.60 in chips) 
pbdan01: posts small blind $0.10
geosat: posts big blind $0.25
*** HOLE CARDS ***
Dealt to Alameda22 [2c 2d]
*ewenger*: folds 
Alameda22: folds 
DawsonS64: folds 
timboaus: folds 
Bobby1776: calls $0.25
MissStax: folds 
TBNCO: calls $0.25
pbdan01: calls $0.15
geosat: checks 
*** FLOP *** [9h 9d Td]
pbdan01: checks 
geosat: checks 
Bobby1776: checks 
TBNCO: checks 
*** TURN *** [9h 9d Td] [Ad]
pbdan01: checks 
geosat: checks 
Bobby1776: bets $0.75
TBNCO: calls $0.75
pbdan01: folds 
geosat: folds 
*** RIVER *** [9h 9d Td Ad] [4d]
Bobby1776: checks 
TBNCO: bets $2.25
Bobby1776: calls $2.25
*** SHOW DOWN ***
TBNCO: shows [Qd Kc] (a flush, Ace high)
Bobby1776: shows [4s 8d] (a flush, Ace high - lower cards)
TBNCO collected $6.70 from pot
*** SUMMARY ***
Total pot $7 | Rake $0.30 
Board [9h 9d Td Ad 4d]
Seat 1: Bobby1776 showed [4s 8d] and lost with a flush, Ace high
Seat 2: MissStax folded before Flop (didn't bet)
Seat 3: TBNCO (button) showed [Qd Kc] and won ($6.70) with a flush, Ace high
Seat 4: pbdan01 (small blind) folded on the Turn
Seat 5: geosat (big blind) folded on the Turn
Seat 6: *ewenger* folded before Flop (didn't bet)
Seat 7: Alameda22 folded before Flop (didn't bet)
Seat 8: DawsonS64 folded before Flop (didn't bet)
Seat 9: timboaus folded before Flop (didn't bet)



PokerStars Game #20103538970:  Hold'em No Limit ($0.10/$0.25) - 2008/09/02 20:59:45 ET
Table 'Pomona IV' 9-max Seat #4 is the button
Seat 1: Bobby1776 ($25 in chips) 
Seat 2: MissStax ($20 in chips) 
Seat 3: TBNCO ($32 in chips) 
Seat 4: pbdan01 ($13.75 in chips) 
Seat 5: geosat ($43.60 in chips) 
Seat 6: *ewenger* ($11.40 in chips) 
Seat 7: Alameda22 ($28 in chips) 
Seat 8: DawsonS64 ($24 in chips) 
Seat 9: timboaus ($21.60 in chips) 
geosat: posts small blind $0.10
*ewenger*: posts big blind $0.25
*** HOLE CARDS ***
Dealt to Alameda22 [8s 3d]
Alameda22: folds 
DawsonS64: folds 
timboaus: folds 
Bobby1776: raises $0.50 to $0.75
MissStax: calls $0.75
TBNCO: folds 
pbdan01: calls $0.75
geosat: folds 
*ewenger*: folds 
*** FLOP *** [7h Qd 6c]
Bobby1776: checks 
MissStax: checks 
pbdan01: checks 
*** TURN *** [7h Qd 6c] [6d]
Bobby1776: checks 
MissStax: bets $1
pbdan01: folds 
Bobby1776: folds 
Uncalled bet ($1) returned to MissStax
MissStax collected $2.50 from pot
MissStax: doesn't show hand 
TBNCO is sitting out
TBNCO has returned
*** SUMMARY ***
Total pot $2.60 | Rake $0.10 
Board [7h Qd 6c 6d]
Seat 1: Bobby1776 folded on the Turn
Seat 2: MissStax collected ($2.50)
Seat 3: TBNCO folded before Flop (didn't bet)
Seat 4: pbdan01 (button) folded on the Turn
Seat 5: geosat (small blind) folded before Flop
Seat 6: *ewenger* (big blind) folded before Flop
Seat 7: Alameda22 folded before Flop (didn't bet)
Seat 8: DawsonS64 folded before Flop (didn't bet)
Seat 9: timboaus folded before Flop (didn't bet)



PokerStars Game #20103563316:  Hold'em No Limit ($0.10/$0.25) - 2008/09/02 21:00:51 ET
Table 'Pomona IV' 9-max Seat #5 is the button
Seat 1: Bobby1776 ($24.25 in chips) 
Seat 2: MissStax ($21.75 in chips) 
Seat 3: TBNCO ($32 in chips) 
Seat 4: pbdan01 ($13 in chips) 
Seat 5: geosat ($43.50 in chips) 
Seat 6: *ewenger* ($11.15 in chips) 
Seat 7: Alameda22 ($28 in chips) 
Seat 8: DawsonS64 ($24 in chips) 
Seat 9: timboaus ($21.60 in chips) 
*ewenger*: posts small blind $0.10
Alameda22: posts big blind $0.25
*** HOLE CARDS ***
Dealt to Alameda22 [4s 5h]
DawsonS64: folds 
timboaus: folds 
Bobby1776: raises $0.50 to $0.75
MissStax: folds 
TBNCO: folds 
TBNCO is sitting out
pbdan01: folds 
geosat: folds 
*ewenger*: calls $0.65
Alameda22: folds 
*** FLOP *** [8d Jd 2c]
*ewenger*: bets $1
Bobby1776: calls $1
*** TURN *** [8d Jd 2c] [2s]
*ewenger*: bets $1.50
Bobby1776: calls $1.50
*** RIVER *** [8d Jd 2c 2s] [6c]
*ewenger*: bets $2
Bobby1776: folds 
Uncalled bet ($2) returned to *ewenger*
*ewenger* collected $6.45 from pot
*ewenger*: doesn't show hand 
*** SUMMARY ***
Total pot $6.75 | Rake $0.30 
Board [8d Jd 2c 2s 6c]
Seat 1: Bobby1776 folded on the River
Seat 2: MissStax folded before Flop (didn't bet)
Seat 3: TBNCO folded before Flop (didn't bet)
Seat 4: pbdan01 folded before Flop (didn't bet)
Seat 5: geosat (button) folded before Flop (didn't bet)
Seat 6: *ewenger* (small blind) collected ($6.45)
Seat 7: Alameda22 (big blind) folded before Flop
Seat 8: DawsonS64 folded before Flop (didn't bet)
Seat 9: timboaus folded before Flop (didn't bet)



PokerStars Game #20103597135:  Hold'em No Limit ($0.10/$0.25) - 2008/09/02 21:02:24 ET
Table 'Pomona IV' 9-max Seat #6 is the button
Seat 1: Bobby1776 ($21 in chips) 
Seat 2: MissStax ($21.75 in chips) 
Seat 4: pbdan01 ($13 in chips) 
Seat 5: geosat ($43.50 in chips) 
Seat 6: *ewenger* ($14.35 in chips) 
Seat 7: Alameda22 ($27.75 in chips) 
Seat 8: DawsonS64 ($24 in chips) 
Seat 9: timboaus ($21.60 in chips) 
Alameda22: posts small blind $0.10
DawsonS64: posts big blind $0.25
*** HOLE CARDS ***
Dealt to Alameda22 [Td 9d]
timboaus: folds 
Bobby1776: calls $0.25
MissStax: folds 
pbdan01: folds 
geosat: folds 
*ewenger*: calls $0.25
Alameda22: calls $0.15
DawsonS64: checks 
*** FLOP *** [7d 6s 6d]
Alameda22: checks 
DawsonS64: checks 
Bobby1776: bets $0.75
*ewenger*: folds 
Alameda22: calls $0.75
DawsonS64: folds 
*** TURN *** [7d 6s 6d] [2c]
Alameda22: checks 
Bobby1776: bets $2
Alameda22: folds 
Uncalled bet ($2) returned to Bobby1776
Bobby1776 collected $2.40 from pot
Bobby1776: doesn't show hand 
*** SUMMARY ***
Total pot $2.50 | Rake $0.10 
Board [7d 6s 6d 2c]
Seat 1: Bobby1776 collected ($2.40)
Seat 2: MissStax folded before Flop (didn't bet)
Seat 4: pbdan01 folded before Flop (didn't bet)
Seat 5: geosat folded before Flop (didn't bet)
Seat 6: *ewenger* (button) folded on the Flop
Seat 7: Alameda22 (small blind) folded on the Turn
Seat 8: DawsonS64 (big blind) folded on the Flop
Seat 9: timboaus folded before Flop (didn't bet)



PokerStars Game #20103654507:  Hold'em No Limit ($0.10/$0.25) - 2008/09/02 21:05:00 ET
Table 'Pomona IV' 9-max Seat #7 is the button
Seat 1: Bobby1776 ($22.40 in chips) 
Seat 2: MissStax ($21.75 in chips) 
Seat 4: pbdan01 ($13 in chips) 
Seat 5: geosat ($43.50 in chips) 
Seat 6: *ewenger* ($14.10 in chips) 
Seat 7: Alameda22 ($26.75 in chips) 
Seat 8: DawsonS64 ($23.75 in chips) 
Seat 9: timboaus ($21.60 in chips) 
DawsonS64: posts small blind $0.10
timboaus: posts big blind $0.25
*** HOLE CARDS ***
Dealt to Alameda22 [Th Ts]
Bobby1776: raises $0.50 to $0.75
MissStax: folds 
pbdan01: calls $0.75
geosat: folds 
TBNCO leaves the table
*ewenger*: folds 
Alameda22: calls $0.75
DawsonS64: folds 
timboaus: folds 
*** FLOP *** [8c 8h 7h]
Bobby1776: checks 
pbdan01: checks 
Alameda22: bets $1.75
Bobby1776: folds 
pbdan01: folds 
Uncalled bet ($1.75) returned to Alameda22
Alameda22 collected $2.50 from pot
Alameda22: doesn't show hand 
*** SUMMARY ***
Total pot $2.60 | Rake $0.10 
Board [8c 8h 7h]
Seat 1: Bobby1776 folded on the Flop
Seat 2: MissStax folded before Flop (didn't bet)
Seat 4: pbdan01 folded on the Flop
Seat 5: geosat folded before Flop (didn't bet)
Seat 6: *ewenger* folded before Flop (didn't bet)
Seat 7: Alameda22 (button) collected ($2.50)
Seat 8: DawsonS64 (small blind) folded before Flop
Seat 9: timboaus (big blind) folded before Flop



PokerStars Game #20103683031:  Hold'em No Limit ($0.10/$0.25) - 2008/09/02 21:06:19 ET
Table 'Pomona IV' 9-max Seat #8 is the button
Seat 1: Bobby1776 ($21.65 in chips) 
Seat 2: MissStax ($21.75 in chips) 
Seat 4: pbdan01 ($12.25 in chips) 
Seat 5: geosat ($43.50 in chips) 
Seat 6: *ewenger* ($14.10 in chips) 
Seat 7: Alameda22 ($28.50 in chips) 
Seat 8: DawsonS64 ($23.65 in chips) 
Seat 9: timboaus ($21.35 in chips) 
timboaus: posts small blind $0.10
Bobby1776: posts big blind $0.25
*** HOLE CARDS ***
Dealt to Alameda22 [7d 3d]
MissStax: folds 
pbdan01: folds 
geosat: folds 
pbdan01 leaves the table
*ewenger*: raises $1 to $1.25
Alameda22: folds 
DawsonS64: folds 
timboaus: folds 
Bobby1776: calls $1
*** FLOP *** [6d 9d 2c]
Bobby1776: checks 
*ewenger*: bets $2
Bobby1776: folds 
Uncalled bet ($2) returned to *ewenger*
*ewenger* collected $2.50 from pot
*ewenger*: doesn't show hand 
*** SUMMARY ***
Total pot $2.60 | Rake $0.10 
Board [6d 9d 2c]
Seat 1: Bobby1776 (big blind) folded on the Flop
Seat 2: MissStax folded before Flop (didn't bet)
Seat 4: pbdan01 folded before Flop (didn't bet)
Seat 5: geosat folded before Flop (didn't bet)
Seat 6: *ewenger* collected ($2.50)
Seat 7: Alameda22 folded before Flop (didn't bet)
Seat 8: DawsonS64 (button) folded before Flop (didn't bet)
Seat 9: timboaus (small blind) folded before Flop



PokerStars Game #20103701510:  Hold'em No Limit ($0.10/$0.25) - 2008/09/02 21:07:10 ET
Table 'Pomona IV' 9-max Seat #9 is the button
Seat 1: Bobby1776 ($20.40 in chips) 
Seat 2: MissStax ($21.75 in chips) 
Seat 5: geosat ($43.50 in chips) 
Seat 6: *ewenger* ($15.35 in chips) 
Seat 7: Alameda22 ($28.50 in chips) 
Seat 8: DawsonS64 ($23.65 in chips) 
Seat 9: timboaus ($21.25 in chips) 
Bobby1776: posts small blind $0.10
MissStax: posts big blind $0.25
*** HOLE CARDS ***
Dealt to Alameda22 [6c Ah]
geosat: folds 
gormayo joins the table at seat #3 
*ewenger*: folds 
Alameda22: folds 
DawsonS64 has timed out
DawsonS64: folds 
DawsonS64 is sitting out
DawsonS64 has returned
timboaus: folds 
Bobby1776: calls $0.15
MissStax: checks 
*** FLOP *** [6h 7h Ks]
Bobby1776: bets $0.50
MissStax: folds 
Uncalled bet ($0.50) returned to Bobby1776
Bobby1776 collected $0.50 from pot
Bobby1776: doesn't show hand 
*** SUMMARY ***
Total pot $0.50 | Rake $0 
Board [6h 7h Ks]
Seat 1: Bobby1776 (small blind) collected ($0.50)
Seat 2: MissStax (big blind) folded on the Flop
Seat 5: geosat folded before Flop (didn't bet)
Seat 6: *ewenger* folded before Flop (didn't bet)
Seat 7: Alameda22 folded before Flop (didn't bet)
Seat 8: DawsonS64 folded before Flop (didn't bet)
Seat 9: timboaus (button) folded before Flop (didn't bet)



PokerStars Game #20103725924:  Hold'em No Limit ($0.10/$0.25) - 2008/09/02 21:08:18 ET
Table 'Pomona IV' 9-max Seat #1 is the button
Seat 1: Bobby1776 ($20.65 in chips) 
Seat 2: MissStax ($21.50 in chips) 
Seat 3: gormayo ($17.40 in chips) 
Seat 5: geosat ($43.50 in chips) 
Seat 6: *ewenger* ($15.35 in chips) 
Seat 7: Alameda22 ($28.50 in chips) 
Seat 8: DawsonS64 ($23.65 in chips) 
Seat 9: timboaus ($21.25 in chips) 
MissStax: posts small blind $0.10
gormayo: posts big blind $0.25
*** HOLE CARDS ***
Dealt to Alameda22 [5h Qd]
geosat: folds 
*ewenger*: calls $0.25
Alameda22: folds 
DawsonS64: folds 
timboaus: folds 
Bobby1776: folds 
MissStax: folds 
gormayo: checks 
*** FLOP *** [4s Ts 2c]
gormayo: bets $0.50
*ewenger*: calls $0.50
*** TURN *** [4s Ts 2c] [Jh]
gormayo: checks 
*ewenger*: bets $1.75
gormayo: folds 
Uncalled bet ($1.75) returned to *ewenger*
*ewenger* collected $1.55 from pot
*** SUMMARY ***
Total pot $1.60 | Rake $0.05 
Board [4s Ts 2c Jh]
Seat 1: Bobby1776 (button) folded before Flop (didn't bet)
Seat 2: MissStax (small blind) folded before Flop
Seat 3: gormayo (big blind) folded on the Turn
Seat 5: geosat folded before Flop (didn't bet)
Seat 6: *ewenger* collected ($1.55)
Seat 7: Alameda22 folded before Flop (didn't bet)
Seat 8: DawsonS64 folded before Flop (didn't bet)
Seat 9: timboaus folded before Flop (didn't bet)



PokerStars Game #20103747596:  Hold'em No Limit ($0.10/$0.25) - 2008/09/02 21:09:16 ET
Table 'Pomona IV' 9-max Seat #2 is the button
Seat 1: Bobby1776 ($20.65 in chips) 
Seat 2: MissStax ($21.40 in chips) 
Seat 3: gormayo ($16.65 in chips) 
Seat 5: geosat ($43.50 in chips) 
Seat 6: *ewenger* ($16.15 in chips) 
Seat 7: Alameda22 ($28.50 in chips) 
Seat 8: DawsonS64 ($23.65 in chips) 
Seat 9: timboaus ($21.25 in chips) 
gormayo: posts small blind $0.10
geosat: posts big blind $0.25
*** HOLE CARDS ***
Dealt to Alameda22 [9d Jd]
*ewenger*: raises $0.75 to $1
Alameda22: folds 
DawsonS64: folds 
timboaus: folds 
Bobby1776: folds 
MissStax: folds 
gormayo: calls $0.90
geosat: folds 
*** FLOP *** [Ks 4h 2h]
gormayo: checks 
vparraga joins the table at seat #4 
*ewenger*: bets $1.25
gormayo: folds 
Uncalled bet ($1.25) returned to *ewenger*
*ewenger* collected $2.15 from pot
*ewenger*: doesn't show hand 
*** SUMMARY ***
Total pot $2.25 | Rake $0.10 
Board [Ks 4h 2h]
Seat 1: Bobby1776 folded before Flop (didn't bet)
Seat 2: MissStax (button) folded before Flop (didn't bet)
Seat 3: gormayo (small blind) folded on the Flop
Seat 5: geosat (big blind) folded before Flop
Seat 6: *ewenger* collected ($2.15)
Seat 7: Alameda22 folded before Flop (didn't bet)
Seat 8: DawsonS64 folded before Flop (didn't bet)
Seat 9: timboaus folded before Flop (didn't bet)



PokerStars Game #20103767509:  Hold'em No Limit ($0.10/$0.25) - 2008/09/02 21:10:09 ET
Table 'Pomona IV' 9-max Seat #3 is the button
Seat 1: Bobby1776 ($20.65 in chips) 
Seat 2: MissStax ($21.40 in chips) 
Seat 3: gormayo ($15.65 in chips) 
Seat 5: geosat ($43.25 in chips) 
Seat 6: *ewenger* ($17.30 in chips) 
Seat 7: Alameda22 ($28.50 in chips) 
Seat 8: DawsonS64 ($23.65 in chips) 
Seat 9: timboaus ($21.25 in chips) 
vparraga will be allowed to play after the button
geosat: posts small blind $0.10
*ewenger*: posts big blind $0.25
*** HOLE CARDS ***
Dealt to Alameda22 [Qc Kc]
Alameda22: folds 
DawsonS64: calls $0.25
timboaus: folds 
Bobby1776: calls $0.25
MissStax: folds 
gormayo: folds 
geosat: raises $1.50 to $1.75
*ewenger*: folds 
DawsonS64: folds 
Bobby1776: folds 
Uncalled bet ($1.50) returned to geosat
geosat collected $1 from pot
geosat: doesn't show hand 
*** SUMMARY ***
Total pot $1 | Rake $0 
Seat 1: Bobby1776 folded before Flop
Seat 2: MissStax folded before Flop (didn't bet)
Seat 3: gormayo (button) folded before Flop (didn't bet)
Seat 5: geosat (small blind) collected ($1)
Seat 6: *ewenger* (big blind) folded before Flop
Seat 7: Alameda22 folded before Flop (didn't bet)
Seat 8: DawsonS64 folded before Flop
Seat 9: timboaus folded before Flop (didn't bet)



PokerStars Game #20103787029:  Hold'em No Limit ($0.10/$0.25) - 2008/09/02 21:11:02 ET
Table 'Pomona IV' 9-max Seat #5 is the button
Seat 1: Bobby1776 ($20.40 in chips) 
Seat 2: MissStax ($21.40 in chips) 
Seat 3: gormayo ($15.65 in chips) 
Seat 4: vparraga ($5 in chips) 
Seat 5: geosat ($44 in chips) 
Seat 6: *ewenger* ($17.05 in chips) 
Seat 7: Alameda22 ($28.50 in chips) 
Seat 8: DawsonS64 ($23.40 in chips) 
Seat 9: timboaus ($21.25 in chips) 
*ewenger*: posts small blind $0.10
Alameda22: posts big blind $0.25
vparraga: posts big blind $0.25
*** HOLE CARDS ***
Dealt to Alameda22 [4h Kh]
DawsonS64: folds 
timboaus: folds 
Bobby1776: folds 
MissStax: calls $0.25
gormayo: folds 
vparraga: checks 
geosat: folds 
*ewenger*: folds 
Alameda22: checks 
*** FLOP *** [Kd Qc 9s]
Alameda22: checks 
MissStax: checks 
vparraga: checks 
*** TURN *** [Kd Qc 9s] [3s]
*ewenger* is sitting out
Alameda22: checks 
MissStax: checks 
vparraga: checks 
*** RIVER *** [Kd Qc 9s 3s] [Jh]
Alameda22: checks 
MissStax: checks 
vparraga: folds 
*** SHOW DOWN ***
Alameda22: shows [4h Kh] (a pair of Kings)
MissStax: mucks hand 
Alameda22 collected $0.85 from pot
*** SUMMARY ***
Total pot $0.85 | Rake $0 
Board [Kd Qc 9s 3s Jh]
Seat 1: Bobby1776 folded before Flop (didn't bet)
Seat 2: MissStax mucked [Js Ad]
Seat 3: gormayo folded before Flop (didn't bet)
Seat 4: vparraga folded on the River
Seat 5: geosat (button) folded before Flop (didn't bet)
Seat 6: *ewenger* (small blind) folded before Flop
Seat 7: Alameda22 (big blind) showed [4h Kh] and won ($0.85) with a pair of Kings
Seat 8: DawsonS64 folded before Flop (didn't bet)
Seat 9: timboaus folded before Flop (didn't bet)



PokerStars Game #20103827635:  Hold'em No Limit ($0.10/$0.25) - 2008/09/02 21:12:51 ET
Table 'Pomona IV' 9-max Seat #7 is the button
Seat 1: Bobby1776 ($20.40 in chips) 
Seat 2: MissStax ($21.15 in chips) 
Seat 3: gormayo ($15.65 in chips) 
Seat 4: vparraga ($4.75 in chips) 
Seat 5: geosat ($44 in chips) 
Seat 7: Alameda22 ($29.10 in chips) 
Seat 8: DawsonS64 ($23.40 in chips) 
Seat 9: timboaus ($21.25 in chips) 
DawsonS64: posts small blind $0.10
timboaus: posts big blind $0.25
*** HOLE CARDS ***
Dealt to Alameda22 [Td 6h]
Bobby1776: raises $0.50 to $0.75
MissStax: folds 
gormayo: folds 
vparraga: calls $0.75
geosat: folds 
Alameda22: folds 
DawsonS64: folds 
timboaus: folds 
*** FLOP *** [Ad Tc 4c]
Bobby1776: checks 
vparraga: checks 
*** TURN *** [Ad Tc 4c] [6c]
Bobby1776: bets $0.50
vparraga: calls $0.50
*** RIVER *** [Ad Tc 4c 6c] [4d]
Bobby1776: checks 
vparraga: checks 
*** SHOW DOWN ***
Bobby1776: shows [Qs Kh] (a pair of Fours)
vparraga: shows [8d 8s] (two pair, Eights and Fours)
vparraga collected $2.75 from pot
*** SUMMARY ***
Total pot $2.85 | Rake $0.10 
Board [Ad Tc 4c 6c 4d]
Seat 1: Bobby1776 showed [Qs Kh] and lost with a pair of Fours
Seat 2: MissStax folded before Flop (didn't bet)
Seat 3: gormayo folded before Flop (didn't bet)
Seat 4: vparraga showed [8d 8s] and won ($2.75) with two pair, Eights and Fours
Seat 5: geosat folded before Flop (didn't bet)
Seat 7: Alameda22 (button) folded before Flop (didn't bet)
Seat 8: DawsonS64 (small blind) folded before Flop
Seat 9: timboaus (big blind) folded before Flop



PokerStars Game #20103851964:  Hold'em No Limit ($0.10/$0.25) - 2008/09/02 21:13:57 ET
Table 'Pomona IV' 9-max Seat #8 is the button
Seat 1: Bobby1776 ($19.15 in chips) 
Seat 2: MissStax ($21.15 in chips) 
Seat 3: gormayo ($15.65 in chips) 
Seat 4: vparraga ($6.25 in chips) 
Seat 5: geosat ($44 in chips) 
Seat 7: Alameda22 ($29.10 in chips) 
Seat 8: DawsonS64 ($23.30 in chips) 
Seat 9: timboaus ($21 in chips) 
timboaus: posts small blind $0.10
Bobby1776: posts big blind $0.25
*** HOLE CARDS ***
Dealt to Alameda22 [2d 4c]
MissStax: folds 
MissStax is sitting out
gormayo: folds 
vparraga: calls $0.25
geosat: folds 
gormayo leaves the table
Alameda22: folds 
DawsonS64: folds 
timboaus: folds 
Bobby1776: checks 
*** FLOP *** [Td Ah 2c]
Bobby1776: checks 
vparraga: checks 
*** TURN *** [Td Ah 2c] [9h]
Bobby1776: checks 
vparraga: checks 
*** RIVER *** [Td Ah 2c 9h] [7s]
Bobby1776: bets $0.50
vparraga: folds 
Uncalled bet ($0.50) returned to Bobby1776
Bobby1776 collected $0.60 from pot
Bobby1776: doesn't show hand 
*** SUMMARY ***
Total pot $0.60 | Rake $0 
Board [Td Ah 2c 9h 7s]
Seat 1: Bobby1776 (big blind) collected ($0.60)
Seat 2: MissStax folded before Flop (didn't bet)
Seat 3: gormayo folded before Flop (didn't bet)
Seat 4: vparraga folded on the River
Seat 5: geosat folded before Flop (didn't bet)
Seat 7: Alameda22 folded before Flop (didn't bet)
Seat 8: DawsonS64 (button) folded before Flop (didn't bet)
Seat 9: timboaus (small blind) folded before Flop



PokerStars Game #20103870524:  Hold'em No Limit ($0.10/$0.25) - 2008/09/02 21:14:49 ET
Table 'Pomona IV' 9-max Seat #9 is the button
Seat 1: Bobby1776 ($19.50 in chips) 
Seat 4: vparraga ($6 in chips) 
Seat 5: geosat ($44 in chips) 
Seat 7: Alameda22 ($29.10 in chips) 
Seat 8: DawsonS64 ($23.30 in chips) 
Seat 9: timboaus ($20.90 in chips) 
Bobby1776: posts small blind $0.10
vparraga: posts big blind $0.25
*** HOLE CARDS ***
Dealt to Alameda22 [9s Kh]
geosat: folds 
Alameda22: folds 
DawsonS64: folds 
timboaus: folds 
Bobby1776: calls $0.15
vparraga: checks 
*** FLOP *** [Ah 7h Ks]
Brainstew88 joins the table at seat #3 
Bobby1776: checks 
vparraga: bets $0.25
Bobby1776: folds 
Uncalled bet ($0.25) returned to vparraga
vparraga collected $0.50 from pot
*** SUMMARY ***
Total pot $0.50 | Rake $0 
Board [Ah 7h Ks]
Seat 1: Bobby1776 (small blind) folded on the Flop
Seat 4: vparraga (big blind) collected ($0.50)
Seat 5: geosat folded before Flop (didn't bet)
Seat 7: Alameda22 folded before Flop (didn't bet)
Seat 8: DawsonS64 folded before Flop (didn't bet)
Seat 9: timboaus (button) folded before Flop (didn't bet)



PokerStars Game #20103881752:  Hold'em No Limit ($0.10/$0.25) - 2008/09/02 21:15:18 ET
Table 'Pomona IV' 9-max Seat #1 is the button
Seat 1: Bobby1776 ($19.25 in chips) 
Seat 4: vparraga ($6.25 in chips) 
Seat 5: geosat ($44 in chips) 
Seat 7: Alameda22 ($29.10 in chips) 
Seat 8: DawsonS64 ($23.30 in chips) 
Seat 9: timboaus ($20.90 in chips) 
Brainstew88 will be allowed to play after the button
vparraga: posts small blind $0.10
geosat: posts big blind $0.25
*** HOLE CARDS ***
Dealt to Alameda22 [3d As]
Alameda22: folds 
DawsonS64: folds 
timboaus: folds 
Bobby1776: raises $0.50 to $0.75
vparraga: folds 
geosat: raises $0.50 to $1.25
Bobby1776: calls $0.50
*** FLOP *** [4c 5d Jc]
geosat: bets $2
Bobby1776: folds 
Uncalled bet ($2) returned to geosat
geosat collected $2.50 from pot
geosat: doesn't show hand 
*** SUMMARY ***
Total pot $2.60 | Rake $0.10 
Board [4c 5d Jc]
Seat 1: Bobby1776 (button) folded on the Flop
Seat 4: vparraga (small blind) folded before Flop
Seat 5: geosat (big blind) collected ($2.50)
Seat 7: Alameda22 folded before Flop (didn't bet)
Seat 8: DawsonS64 folded before Flop (didn't bet)
Seat 9: timboaus folded before Flop (didn't bet)



PokerStars Game #20103900060:  Hold'em No Limit ($0.10/$0.25) - 2008/09/02 21:16:06 ET
Table 'Pomona IV' 9-max Seat #4 is the button
Seat 1: Bobby1776 ($18 in chips) 
Seat 3: Brainstew88 ($5 in chips) 
Seat 4: vparraga ($6.15 in chips) 
Seat 5: geosat ($45.25 in chips) 
Seat 7: Alameda22 ($29.10 in chips) 
Seat 8: DawsonS64 ($23.30 in chips) 
Seat 9: timboaus ($20.90 in chips) 
geosat: posts small blind $0.10
Alameda22: posts big blind $0.25
Brainstew88: posts big blind $0.25
*** HOLE CARDS ***
Dealt to Alameda22 [4c 3h]
DawsonS64: folds 
timboaus: folds 
Bobby1776: raises $0.50 to $0.75
Brainstew88: folds 
vparraga: folds 
geosat: folds 
Alameda22: folds 
Uncalled bet ($0.50) returned to Bobby1776
Bobby1776 collected $0.85 from pot
Bobby1776: doesn't show hand 
*** SUMMARY ***
Total pot $0.85 | Rake $0 
Seat 1: Bobby1776 collected ($0.85)
Seat 3: Brainstew88 folded before Flop
Seat 4: vparraga (button) folded before Flop (didn't bet)
Seat 5: geosat (small blind) folded before Flop
Seat 7: Alameda22 (big blind) folded before Flop
Seat 8: DawsonS64 folded before Flop (didn't bet)
Seat 9: timboaus folded before Flop (didn't bet)



PokerStars Game #20103920682:  Hold'em No Limit ($0.10/$0.25) - 2008/09/02 21:17:01 ET
Table 'Pomona IV' 9-max Seat #5 is the button
Seat 1: Bobby1776 ($18.60 in chips) 
Seat 3: Brainstew88 ($4.75 in chips) 
Seat 4: vparraga ($6.15 in chips) 
Seat 5: geosat ($45.15 in chips) 
Seat 7: Alameda22 ($28.85 in chips) 
Seat 8: DawsonS64 ($23.30 in chips) 
Seat 9: timboaus ($20.90 in chips) 
Alameda22: posts small blind $0.10
DawsonS64: posts big blind $0.25
*** HOLE CARDS ***
Dealt to Alameda22 [Ad 9h]
timboaus: folds 
Bobby1776: raises $0.50 to $0.75
Brainstew88: folds 
vparraga: calls $0.75
geosat: folds 
Alameda22: folds 
DawsonS64: folds 
*** FLOP *** [4s 8d 8h]
Bobby1776: checks 
vparraga: bets $0.25
Bobby1776: raises $0.50 to $0.75
vparraga: calls $0.50
*** TURN *** [4s 8d 8h] [7s]
Bobby1776: checks 
vparraga: checks 
*** RIVER *** [4s 8d 8h 7s] [Jd]
Bobby1776: checks 
vparraga: checks 
*** SHOW DOWN ***
Bobby1776: shows [Js Kd] (two pair, Jacks and Eights)
vparraga: mucks hand 
Bobby1776 collected $3.20 from pot
*** SUMMARY ***
Total pot $3.35 | Rake $0.15 
Board [4s 8d 8h 7s Jd]
Seat 1: Bobby1776 showed [Js Kd] and won ($3.20) with two pair, Jacks and Eights
Seat 3: Brainstew88 folded before Flop (didn't bet)
Seat 4: vparraga mucked [9c Kc]
Seat 5: geosat (button) folded before Flop (didn't bet)
Seat 7: Alameda22 (small blind) folded before Flop
Seat 8: DawsonS64 (big blind) folded before Flop
Seat 9: timboaus folded before Flop (didn't bet)



PokerStars Game #20103940634:  Hold'em No Limit ($0.10/$0.25) - 2008/09/02 21:17:53 ET
Table 'Pomona IV' 9-max Seat #7 is the button
Seat 1: Bobby1776 ($20.30 in chips) 
Seat 3: Brainstew88 ($4.75 in chips) 
Seat 4: vparraga ($4.65 in chips) 
Seat 5: geosat ($45.15 in chips) 
Seat 7: Alameda22 ($28.75 in chips) 
Seat 8: DawsonS64 ($23.05 in chips) 
Seat 9: timboaus ($20.90 in chips) 
DawsonS64: posts small blind $0.10
timboaus: posts big blind $0.25
*** HOLE CARDS ***
Dealt to Alameda22 [Td Kc]
Bobby1776: folds 
Brainstew88: folds 
vparraga: calls $0.25
geosat: folds 
Alameda22: folds 
DawsonS64: calls $0.15
timboaus: checks 
*** FLOP *** [6h Ks 8h]
DawsonS64: checks 
timboaus: bets $0.40
vparraga: folds 
DawsonS64: folds 
Uncalled bet ($0.40) returned to timboaus
timboaus collected $0.75 from pot
*ewenger* has returned
timboaus: doesn't show hand 
*** SUMMARY ***
Total pot $0.75 | Rake $0 
Board [6h Ks 8h]
Seat 1: Bobby1776 folded before Flop (didn't bet)
Seat 3: Brainstew88 folded before Flop (didn't bet)
Seat 4: vparraga folded on the Flop
Seat 5: geosat folded before Flop (didn't bet)
Seat 7: Alameda22 (button) folded before Flop (didn't bet)
Seat 8: DawsonS64 (small blind) folded on the Flop
Seat 9: timboaus (big blind) collected ($0.75)



PokerStars Game #20103960506:  Hold'em No Limit ($0.10/$0.25) - 2008/09/02 21:18:45 ET
Table 'Pomona IV' 9-max Seat #8 is the button
Seat 1: Bobby1776 ($20.30 in chips) 
Seat 3: Brainstew88 ($4.75 in chips) 
Seat 4: vparraga ($4.40 in chips) 
Seat 5: geosat ($45.15 in chips) 
Seat 6: *ewenger* ($16.95 in chips) 
Seat 7: Alameda22 ($28.75 in chips) 
Seat 8: DawsonS64 ($22.80 in chips) 
Seat 9: timboaus ($21.40 in chips) 
timboaus: posts small blind $0.10
Bobby1776: posts big blind $0.25
*ewenger*: posts small & big blinds $0.35
*** HOLE CARDS ***
Dealt to Alameda22 [2h 8s]
Brainstew88: folds 
vparraga: calls $0.25
geosat: folds 
*ewenger*: checks 
Alameda22: folds 
DawsonS64: folds 
timboaus: folds 
Bobby1776: checks 
*** FLOP *** [5c 7c 3d]
Bobby1776: checks 
vparraga: checks 
*ewenger*: bets $0.75
Bobby1776: calls $0.75
vparraga: folds 
*** TURN *** [5c 7c 3d] [6c]
Bobby1776: checks 
*ewenger*: bets $0.75
Bobby1776: folds 
Uncalled bet ($0.75) returned to *ewenger*
*ewenger* collected $2.35 from pot
*** SUMMARY ***
Total pot $2.45 | Rake $0.10 
Board [5c 7c 3d 6c]
Seat 1: Bobby1776 (big blind) folded on the Turn
Seat 3: Brainstew88 folded before Flop (didn't bet)
Seat 4: vparraga folded on the Flop
Seat 5: geosat folded before Flop (didn't bet)
Seat 6: *ewenger* collected ($2.35)
Seat 7: Alameda22 folded before Flop (didn't bet)
Seat 8: DawsonS64 (button) folded before Flop (didn't bet)
Seat 9: timboaus (small blind) folded before Flop



PokerStars Game #20103989840:  Hold'em No Limit ($0.10/$0.25) - 2008/09/02 21:20:03 ET
Table 'Pomona IV' 9-max Seat #9 is the button
Seat 1: Bobby1776 ($19.30 in chips) 
Seat 3: Brainstew88 ($4.75 in chips) 
Seat 4: vparraga ($4.15 in chips) 
Seat 5: geosat ($45.15 in chips) 
Seat 6: *ewenger* ($18.20 in chips) 
Seat 7: Alameda22 ($28.75 in chips) 
Seat 8: DawsonS64 ($22.80 in chips) 
Seat 9: timboaus ($21.30 in chips) 
Bobby1776: posts small blind $0.10
Brainstew88: posts big blind $0.25
*** HOLE CARDS ***
Dealt to Alameda22 [4s 8c]
vparraga: calls $0.25
geosat: folds 
*ewenger*: raises $1 to $1.25
Alameda22: folds 
DawsonS64: folds 
timboaus: folds 
Bobby1776: calls $1.15
Brainstew88: folds 
vparraga: folds 
*** FLOP *** [7c As Ah]
Bobby1776: checks 
*ewenger*: bets $2
Bobby1776: folds 
Uncalled bet ($2) returned to *ewenger*
*ewenger* collected $2.85 from pot
*** SUMMARY ***
Total pot $3 | Rake $0.15 
Board [7c As Ah]
Seat 1: Bobby1776 (small blind) folded on the Flop
Seat 3: Brainstew88 (big blind) folded before Flop
Seat 4: vparraga folded before Flop
Seat 5: geosat folded before Flop (didn't bet)
Seat 6: *ewenger* collected ($2.85)
Seat 7: Alameda22 folded before Flop (didn't bet)
Seat 8: DawsonS64 folded before Flop (didn't bet)
Seat 9: timboaus (button) folded before Flop (didn't bet)



PokerStars Game #20104014092:  Hold'em No Limit ($0.10/$0.25) - 2008/09/02 21:21:07 ET
Table 'Pomona IV' 9-max Seat #1 is the button
Seat 1: Bobby1776 ($18.05 in chips) 
Seat 3: Brainstew88 ($4.50 in chips) 
Seat 4: vparraga ($3.90 in chips) 
Seat 5: geosat ($45.15 in chips) 
Seat 6: *ewenger* ($19.80 in chips) 
Seat 7: Alameda22 ($28.75 in chips) 
Seat 8: DawsonS64 ($22.80 in chips) 
Seat 9: timboaus ($21.30 in chips) 
Brainstew88: posts small blind $0.10
vparraga: posts big blind $0.25
*** HOLE CARDS ***
Dealt to Alameda22 [Kd Qs]
geosat: folds 
*ewenger*: folds 
Alameda22: folds 
DawsonS64: folds 
timboaus: raises $0.95 to $1.20
Bobby1776: folds 
Brainstew88: folds 
vparraga: folds 
Uncalled bet ($0.95) returned to timboaus
timboaus collected $0.60 from pot
timboaus: doesn't show hand 
*** SUMMARY ***
Total pot $0.60 | Rake $0 
Seat 1: Bobby1776 (button) folded before Flop (didn't bet)
Seat 3: Brainstew88 (small blind) folded before Flop
Seat 4: vparraga (big blind) folded before Flop
Seat 5: geosat folded before Flop (didn't bet)
Seat 6: *ewenger* folded before Flop (didn't bet)
Seat 7: Alameda22 folded before Flop (didn't bet)
Seat 8: DawsonS64 folded before Flop (didn't bet)
Seat 9: timboaus collected ($0.60)



PokerStars Game #20104035422:  Hold'em No Limit ($0.10/$0.25) - 2008/09/02 21:22:04 ET
Table 'Pomona IV' 9-max Seat #3 is the button
Seat 1: Bobby1776 ($18.05 in chips) 
Seat 3: Brainstew88 ($4.40 in chips) 
Seat 4: vparraga ($3.65 in chips) 
Seat 5: geosat ($45.15 in chips) 
Seat 6: *ewenger* ($19.80 in chips) 
Seat 7: Alameda22 ($28.75 in chips) 
Seat 8: DawsonS64 ($22.80 in chips) 
Seat 9: timboaus ($21.65 in chips) 
vparraga: posts small blind $0.10
geosat: posts big blind $0.25
*** HOLE CARDS ***
Dealt to Alameda22 [As 5c]
*ewenger*: folds 
Alameda22: folds 
DawsonS64: folds 
timboaus: raises $0.85 to $1.10
MissStax has returned
Bobby1776: folds 
Brainstew88: folds 
vparraga: folds 
geosat: folds 
Uncalled bet ($0.85) returned to timboaus
timboaus collected $0.60 from pot
timboaus: doesn't show hand 
*** SUMMARY ***
Total pot $0.60 | Rake $0 
Seat 1: Bobby1776 folded before Flop (didn't bet)
Seat 3: Brainstew88 (button) folded before Flop (didn't bet)
Seat 4: vparraga (small blind) folded before Flop
Seat 5: geosat (big blind) folded before Flop
Seat 6: *ewenger* folded before Flop (didn't bet)
Seat 7: Alameda22 folded before Flop (didn't bet)
Seat 8: DawsonS64 folded before Flop (didn't bet)
Seat 9: timboaus collected ($0.60)



PokerStars Game #20104049178:  Hold'em No Limit ($0.10/$0.25) - 2008/09/02 21:22:41 ET
Table 'Pomona IV' 9-max Seat #4 is the button
Seat 1: Bobby1776 ($18.05 in chips) 
Seat 2: MissStax ($21.15 in chips) 
Seat 3: Brainstew88 ($4.40 in chips) 
Seat 4: vparraga ($3.55 in chips) 
Seat 5: geosat ($44.90 in chips) 
Seat 6: *ewenger* ($19.80 in chips) 
Seat 7: Alameda22 ($28.75 in chips) 
Seat 8: DawsonS64 ($22.80 in chips) 
Seat 9: timboaus ($22 in chips) 
geosat: posts small blind $0.10
*ewenger*: posts big blind $0.25
MissStax: posts small & big blinds $0.35
*** HOLE CARDS ***
Dealt to Alameda22 [7c Qc]
Alameda22: folds 
DawsonS64: folds 
timboaus: folds 
Bobby1776: folds 
MissStax: checks 
Brainstew88: folds 
vparraga: folds 
geosat: folds 
*ewenger*: checks 
*** FLOP *** [Ah Tc 8c]
*ewenger*: bets $0.75
MissStax: folds 
Uncalled bet ($0.75) returned to *ewenger*
*ewenger* collected $0.70 from pot
*** SUMMARY ***
Total pot $0.70 | Rake $0 
Board [Ah Tc 8c]
Seat 1: Bobby1776 folded before Flop (didn't bet)
Seat 2: MissStax folded on the Flop
Seat 3: Brainstew88 folded before Flop (didn't bet)
Seat 4: vparraga (button) folded before Flop (didn't bet)
Seat 5: geosat (small blind) folded before Flop
Seat 6: *ewenger* (big blind) collected ($0.70)
Seat 7: Alameda22 folded before Flop (didn't bet)
Seat 8: DawsonS64 folded before Flop (didn't bet)
Seat 9: timboaus folded before Flop (didn't bet)



PokerStars Game #20104070948:  Hold'em No Limit ($0.10/$0.25) - 2008/09/02 21:23:39 ET
Table 'Pomona IV' 9-max Seat #5 is the button
Seat 1: Bobby1776 ($18.05 in chips) 
Seat 2: MissStax ($20.80 in chips) 
Seat 3: Brainstew88 ($4.40 in chips) 
Seat 4: vparraga ($3.55 in chips) 
Seat 5: geosat ($44.80 in chips) 
Seat 6: *ewenger* ($20.25 in chips) 
Seat 7: Alameda22 ($28.75 in chips) 
Seat 8: DawsonS64 ($22.80 in chips) 
Seat 9: timboaus ($22 in chips) 
*ewenger*: posts small blind $0.10
Alameda22: posts big blind $0.25
*** HOLE CARDS ***
Dealt to Alameda22 [9h 5h]
DawsonS64: folds 
timboaus: folds 
Bobby1776: raises $0.50 to $0.75
MissStax: folds 
Brainstew88: folds 
vparraga: folds 
geosat: folds 
*ewenger*: folds 
Alameda22: folds 
Uncalled bet ($0.50) returned to Bobby1776
Bobby1776 collected $0.60 from pot
Bobby1776: doesn't show hand 
*** SUMMARY ***
Total pot $0.60 | Rake $0 
Seat 1: Bobby1776 collected ($0.60)
Seat 2: MissStax folded before Flop (didn't bet)
Seat 3: Brainstew88 folded before Flop (didn't bet)
Seat 4: vparraga folded before Flop (didn't bet)
Seat 5: geosat (button) folded before Flop (didn't bet)
Seat 6: *ewenger* (small blind) folded before Flop
Seat 7: Alameda22 (big blind) folded before Flop
Seat 8: DawsonS64 folded before Flop (didn't bet)
Seat 9: timboaus folded before Flop (didn't bet)



PokerStars Game #20104084586:  Hold'em No Limit ($0.10/$0.25) - 2008/09/02 21:24:15 ET
Table 'Pomona IV' 9-max Seat #6 is the button
Seat 1: Bobby1776 ($18.40 in chips) 
Seat 2: MissStax ($20.80 in chips) 
Seat 3: Brainstew88 ($4.40 in chips) 
Seat 4: vparraga ($3.55 in chips) 
Seat 5: geosat ($44.80 in chips) 
Seat 6: *ewenger* ($20.15 in chips) 
Seat 7: Alameda22 ($28.50 in chips) 
Seat 8: DawsonS64 ($22.80 in chips) 
Seat 9: timboaus ($22 in chips) 
Alameda22: posts small blind $0.10
DawsonS64: posts big blind $0.25
*** HOLE CARDS ***
Dealt to Alameda22 [6h 3c]
timboaus: folds 
Bobby1776: raises $0.50 to $0.75
MissStax: folds 
Brainstew88: folds 
vparraga: calls $0.75
geosat: folds 
*ewenger*: calls $0.75
Alameda22: folds 
DawsonS64: folds 
*** FLOP *** [6c Kc 8h]
Bobby1776: bets $2
vparraga: calls $2
*ewenger*: calls $2
*** TURN *** [6c Kc 8h] [3h]
Bobby1776: checks 
vparraga: checks 
*ewenger*: checks 
*** RIVER *** [6c Kc 8h 3h] [2h]
Bobby1776: checks 
vparraga: checks 
*ewenger*: checks 
*** SHOW DOWN ***
Bobby1776: shows [Jd Tc] (high card King)
vparraga: mucks hand 
*ewenger*: shows [Ac 7c] (high card Ace)
*ewenger* collected $8.20 from pot
*** SUMMARY ***
Total pot $8.60 | Rake $0.40 
Board [6c Kc 8h 3h 2h]
Seat 1: Bobby1776 showed [Jd Tc] and lost with high card King
Seat 2: MissStax folded before Flop (didn't bet)
Seat 3: Brainstew88 folded before Flop (didn't bet)
Seat 4: vparraga mucked [Th 9c]
Seat 5: geosat folded before Flop (didn't bet)
Seat 6: *ewenger* (button) showed [Ac 7c] and won ($8.20) with high card Ace
Seat 7: Alameda22 (small blind) folded before Flop
Seat 8: DawsonS64 (big blind) folded before Flop
Seat 9: timboaus folded before Flop (didn't bet)



PokerStars Game #20104112061:  Hold'em No Limit ($0.10/$0.25) - 2008/09/02 21:25:28 ET
Table 'Pomona IV' 9-max Seat #7 is the button
Seat 1: Bobby1776 ($15.65 in chips) 
Seat 2: MissStax ($20.80 in chips) 
Seat 3: Brainstew88 ($4.40 in chips) 
Seat 4: vparraga ($0.80 in chips) 
Seat 5: geosat ($44.80 in chips) 
Seat 6: *ewenger* ($25.60 in chips) 
Seat 7: Alameda22 ($28.40 in chips) 
Seat 8: DawsonS64 ($22.55 in chips) 
Seat 9: timboaus ($22 in chips) 
DawsonS64: posts small blind $0.10
timboaus: posts big blind $0.25
*** HOLE CARDS ***
Dealt to Alameda22 [Qd Th]
Bobby1776: folds 
MissStax: folds 
Brainstew88: calls $0.25
vparraga: calls $0.25
geosat: folds 
*ewenger*: folds 
Alameda22: folds 
DawsonS64: calls $0.15
timboaus: checks 
*** FLOP *** [Js 6d 3s]
DawsonS64: checks 
timboaus: checks 
Brainstew88: checks 
vparraga: bets $0.25
DawsonS64: calls $0.25
timboaus: folds 
Brainstew88: folds 
*** TURN *** [Js 6d 3s] [9h]
DawsonS64: checks 
vparraga: bets $0.25
DawsonS64: folds 
Uncalled bet ($0.25) returned to vparraga
vparraga collected $1.45 from pot
vparraga: doesn't show hand 
*** SUMMARY ***
Total pot $1.50 | Rake $0.05 
Board [Js 6d 3s 9h]
Seat 1: Bobby1776 folded before Flop (didn't bet)
Seat 2: MissStax folded before Flop (didn't bet)
Seat 3: Brainstew88 folded on the Flop
Seat 4: vparraga collected ($1.45)
Seat 5: geosat folded before Flop (didn't bet)
Seat 6: *ewenger* folded before Flop (didn't bet)
Seat 7: Alameda22 (button) folded before Flop (didn't bet)
Seat 8: DawsonS64 (small blind) folded on the Turn
Seat 9: timboaus (big blind) folded on the Flop



PokerStars Game #20104141472:  Hold'em No Limit ($0.10/$0.25) - 2008/09/02 21:26:47 ET
Table 'Pomona IV' 9-max Seat #8 is the button
Seat 1: Bobby1776 ($15.65 in chips) 
Seat 2: MissStax ($20.80 in chips) 
Seat 3: Brainstew88 ($4.15 in chips) 
Seat 4: vparraga ($1.75 in chips) 
Seat 5: geosat ($44.80 in chips) 
Seat 6: *ewenger* ($25.60 in chips) 
Seat 7: Alameda22 ($28.40 in chips) 
Seat 8: DawsonS64 ($22.05 in chips) 
Seat 9: timboaus ($21.75 in chips) 
timboaus: posts small blind $0.10
Bobby1776: posts big blind $0.25
*** HOLE CARDS ***
Dealt to Alameda22 [2s 7s]
MissStax: folds 
Brainstew88: folds 
vparraga: folds 
geosat: calls $0.25
*ewenger*: folds 
Alameda22: folds 
DawsonS64: folds 
DawsonS64 leaves the table
timboaus: folds 
Bobby1776: checks 
*** FLOP *** [Ah Jc 6c]
Bobby1776: bets $0.50
geosat: calls $0.50
*** TURN *** [Ah Jc 6c] [5c]
Bobby1776: checks 
geosat: checks 
*** RIVER *** [Ah Jc 6c 5c] [8d]
Bobby1776: checks 
geosat: bets $1.25
Bobby1776: calls $1.25
*** SHOW DOWN ***
geosat: shows [8h 8c] (three of a kind, Eights)
Bobby1776: mucks hand 
geosat collected $3.90 from pot
Bobby1776 said, "lol"
*** SUMMARY ***
Total pot $4.10 | Rake $0.20 
Board [Ah Jc 6c 5c 8d]
Seat 1: Bobby1776 (big blind) mucked [7h Ad]
Seat 2: MissStax folded before Flop (didn't bet)
Seat 3: Brainstew88 folded before Flop (didn't bet)
Seat 4: vparraga folded before Flop (didn't bet)
Seat 5: geosat showed [8h 8c] and won ($3.90) with three of a kind, Eights
Seat 6: *ewenger* folded before Flop (didn't bet)
Seat 7: Alameda22 folded before Flop (didn't bet)
Seat 8: DawsonS64 (button) folded before Flop (didn't bet)
Seat 9: timboaus (small blind) folded before Flop



PokerStars Game #20104167128:  Hold'em No Limit ($0.10/$0.25) - 2008/09/02 21:27:55 ET
Table 'Pomona IV' 9-max Seat #9 is the button
Seat 1: Bobby1776 ($13.65 in chips) 
Seat 2: MissStax ($20.80 in chips) 
Seat 3: Brainstew88 ($4.15 in chips) 
Seat 4: vparraga ($1.75 in chips) 
Seat 5: geosat ($46.70 in chips) 
Seat 6: *ewenger* ($25.60 in chips) 
Seat 7: Alameda22 ($28.40 in chips) 
Seat 9: timboaus ($21.65 in chips) 
Bobby1776: posts small blind $0.10
MissStax: posts big blind $0.25
*** HOLE CARDS ***
Dealt to Alameda22 [9d Ks]
Brainstew88: folds 
vparraga: calls $0.25
geosat: folds 
*ewenger*: folds 
Alameda22: folds 
timboaus: folds 
Bobby1776: calls $0.15
MissStax: checks 
*** FLOP *** [9h 4d Jc]
Bobby1776: checks 
MissStax: checks 
vparraga: bets $0.25
Bobby1776: calls $0.25
MissStax: folds 
*** TURN *** [9h 4d Jc] [Qc]
Bobby1776: checks 
vparraga: bets $0.25
Bobby1776: calls $0.25
*** RIVER *** [9h 4d Jc Qc] [Ac]
Bobby1776: checks 
vparraga: checks 
*** SHOW DOWN ***
Bobby1776: shows [3s 9c] (a pair of Nines)
vparraga: shows [Js Tc] (a pair of Jacks)
vparraga collected $1.70 from pot
*** SUMMARY ***
Total pot $1.75 | Rake $0.05 
Board [9h 4d Jc Qc Ac]
Seat 1: Bobby1776 (small blind) showed [3s 9c] and lost with a pair of Nines
Seat 2: MissStax (big blind) folded on the Flop
Seat 3: Brainstew88 folded before Flop (didn't bet)
Seat 4: vparraga showed [Js Tc] and won ($1.70) with a pair of Jacks
Seat 5: geosat folded before Flop (didn't bet)
Seat 6: *ewenger* folded before Flop (didn't bet)
Seat 7: Alameda22 folded before Flop (didn't bet)
Seat 9: timboaus (button) folded before Flop (didn't bet)



PokerStars Game #20104185739:  Hold'em No Limit ($0.10/$0.25) - 2008/09/02 21:28:45 ET
Table 'Pomona IV' 9-max Seat #1 is the button
Seat 1: Bobby1776 ($12.90 in chips) 
Seat 2: MissStax ($20.55 in chips) 
Seat 3: Brainstew88 ($4.15 in chips) 
Seat 4: vparraga ($2.70 in chips) 
Seat 5: geosat ($46.70 in chips) 
Seat 6: *ewenger* ($25.60 in chips) 
Seat 7: Alameda22 ($28.40 in chips) 
Seat 9: timboaus ($21.65 in chips) 
MissStax: posts small blind $0.10
Brainstew88: posts big blind $0.25
*** HOLE CARDS ***
Dealt to Alameda22 [9c 4h]
vparraga: calls $0.25
geosat: folds 
*ewenger*: raises $1 to $1.25
Alameda22: folds 
timboaus: calls $1.25
Bobby1776: folds 
MissStax: folds 
Brainstew88: folds 
vparraga: folds 
*** FLOP *** [Th Td 5d]
jasons0147 joins the table at seat #8 
*ewenger*: checks 
timboaus: checks 
*** TURN *** [Th Td 5d] [5h]
*ewenger*: bets $1
timboaus: raises $2 to $3
*ewenger*: folds 
Uncalled bet ($2) returned to timboaus
timboaus collected $4.90 from pot
*** SUMMARY ***
Total pot $5.10 | Rake $0.20 
Board [Th Td 5d 5h]
Seat 1: Bobby1776 (button) folded before Flop (didn't bet)
Seat 2: MissStax (small blind) folded before Flop
Seat 3: Brainstew88 (big blind) folded before Flop
Seat 4: vparraga folded before Flop
Seat 5: geosat folded before Flop (didn't bet)
Seat 6: *ewenger* folded on the Turn
Seat 7: Alameda22 folded before Flop (didn't bet)
Seat 9: timboaus collected ($4.90)



PokerStars Game #20104209322:  Hold'em No Limit ($0.10/$0.25) - 2008/09/02 21:29:49 ET
Table 'Pomona IV' 9-max Seat #2 is the button
Seat 1: Bobby1776 ($12.90 in chips) 
Seat 2: MissStax ($20.45 in chips) 
Seat 3: Brainstew88 ($3.90 in chips) 
Seat 4: vparraga ($2.45 in chips) 
Seat 5: geosat ($46.70 in chips) 
Seat 6: *ewenger* ($23.35 in chips) 
Seat 7: Alameda22 ($28.40 in chips) 
Seat 9: timboaus ($24.30 in chips) 
Brainstew88: posts small blind $0.10
vparraga: posts big blind $0.25
jasons0147: sits out 
*** HOLE CARDS ***
Dealt to Alameda22 [Jc 9s]
geosat: folds 
geosat leaves the table
*ewenger*: raises $1 to $1.25
Alameda22: folds 
timboaus: folds 
Bobby1776: calls $1.25
MissStax: folds 
Brainstew88: folds 
Lemarquis1 joins the table at seat #5 
vparraga: calls $1
*** FLOP *** [Ks Ad 3s]
vparraga: checks 
*ewenger*: bets $1.25
Bobby1776: folds 
vparraga: calls $1.20 and is all-in
Uncalled bet ($0.05) returned to *ewenger*
*** TURN *** [Ks Ad 3s] [5c]
*** RIVER *** [Ks Ad 3s 5c] [6d]
*** SHOW DOWN ***
vparraga: shows [5d 4d] (a pair of Fives)
*ewenger*: shows [Qs Qh] (a pair of Queens)
*ewenger* collected $5.95 from pot
*** SUMMARY ***
Total pot $6.25 | Rake $0.30 
Board [Ks Ad 3s 5c 6d]
Seat 1: Bobby1776 folded on the Flop
Seat 2: MissStax (button) folded before Flop (didn't bet)
Seat 3: Brainstew88 (small blind) folded before Flop
Seat 4: vparraga (big blind) showed [5d 4d] and lost with a pair of Fives
Seat 5: geosat folded before Flop (didn't bet)
Seat 6: *ewenger* showed [Qs Qh] and won ($5.95) with a pair of Queens
Seat 7: Alameda22 folded before Flop (didn't bet)
Seat 9: timboaus folded before Flop (didn't bet)



PokerStars Game #20104234271:  Hold'em No Limit ($0.10/$0.25) - 2008/09/02 21:30:55 ET
Table 'Pomona IV' 9-max Seat #3 is the button
Seat 1: Bobby1776 ($11.65 in chips) 
Seat 2: MissStax ($20.45 in chips) 
Seat 3: Brainstew88 ($3.80 in chips) 
Seat 4: vparraga ($5 in chips) 
Seat 5: Lemarquis1 ($22 in chips) 
Seat 6: *ewenger* ($26.85 in chips) 
Seat 7: Alameda22 ($28.40 in chips) 
Seat 9: timboaus ($24.30 in chips) 
vparraga: posts small blind $0.10
Lemarquis1: posts big blind $0.25
jasons0147: sits out 
*** HOLE CARDS ***
Dealt to Alameda22 [Js Th]
*ewenger*: folds 
Alameda22: folds 
timboaus: raises $0.85 to $1.10
Bobby1776: calls $1.10
MissStax: folds 
Brainstew88: folds 
vparraga: folds 
Lemarquis1: folds 
*** FLOP *** [3d Ac Ah]
timboaus: checks 
Bobby1776: checks 
*** TURN *** [3d Ac Ah] [6d]
timboaus: bets $2
Bobby1776: folds 
Uncalled bet ($2) returned to timboaus
timboaus collected $2.45 from pot
timboaus: doesn't show hand 
*** SUMMARY ***
Total pot $2.55 | Rake $0.10 
Board [3d Ac Ah 6d]
Seat 1: Bobby1776 folded on the Turn
Seat 2: MissStax folded before Flop (didn't bet)
Seat 3: Brainstew88 (button) folded before Flop (didn't bet)
Seat 4: vparraga (small blind) folded before Flop
Seat 5: Lemarquis1 (big blind) folded before Flop
Seat 6: *ewenger* folded before Flop (didn't bet)
Seat 7: Alameda22 folded before Flop (didn't bet)
Seat 9: timboaus collected ($2.45)



PokerStars Game #20104254030:  Hold'em No Limit ($0.10/$0.25) - 2008/09/02 21:31:48 ET
Table 'Pomona IV' 9-max Seat #4 is the button
Seat 1: Bobby1776 ($10.55 in chips) 
Seat 2: MissStax ($20.45 in chips) 
Seat 3: Brainstew88 ($3.80 in chips) 
Seat 4: vparraga ($4.90 in chips) 
Seat 5: Lemarquis1 ($21.75 in chips) 
Seat 6: *ewenger* ($26.85 in chips) 
Seat 7: Alameda22 ($28.40 in chips) 
Seat 9: timboaus ($25.65 in chips) 
Lemarquis1: posts small blind $0.10
*ewenger*: posts big blind $0.25
jasons0147: sits out 
*** HOLE CARDS ***
Dealt to Alameda22 [4s 2h]
Alameda22: folds 
timboaus: folds 
Bobby1776: folds 
MissStax: raises $0.75 to $1
Brainstew88: folds 
vparraga: calls $1
Lemarquis1: folds 
*ewenger*: calls $0.75
*** FLOP *** [4h Ac Ah]
*ewenger*: checks 
MissStax: bets $1.25
vparraga: folds 
*ewenger*: folds 
Uncalled bet ($1.25) returned to MissStax
MissStax collected $2.95 from pot
MissStax: doesn't show hand 
*** SUMMARY ***
Total pot $3.10 | Rake $0.15 
Board [4h Ac Ah]
Seat 1: Bobby1776 folded before Flop (didn't bet)
Seat 2: MissStax collected ($2.95)
Seat 3: Brainstew88 folded before Flop (didn't bet)
Seat 4: vparraga (button) folded on the Flop
Seat 5: Lemarquis1 (small blind) folded before Flop
Seat 6: *ewenger* (big blind) folded on the Flop
Seat 7: Alameda22 folded before Flop (didn't bet)
Seat 9: timboaus folded before Flop (didn't bet)



PokerStars Game #20104275258:  Hold'em No Limit ($0.10/$0.25) - 2008/09/02 21:32:46 ET
Table 'Pomona IV' 9-max Seat #5 is the button
Seat 1: Bobby1776 ($25 in chips) 
Seat 2: MissStax ($22.40 in chips) 
Seat 3: Brainstew88 ($3.80 in chips) 
Seat 4: vparraga ($3.90 in chips) 
Seat 5: Lemarquis1 ($21.65 in chips) 
Seat 6: *ewenger* ($25.85 in chips) 
Seat 7: Alameda22 ($28.40 in chips) 
Seat 9: timboaus ($25.65 in chips) 
*ewenger*: posts small blind $0.10
Alameda22: posts big blind $0.25
jasons0147: sits out 
*** HOLE CARDS ***
Dealt to Alameda22 [Ks Kh]
timboaus: folds 
Bobby1776: calls $0.25
MissStax: calls $0.25
Brainstew88: folds 
vparraga: raises $0.25 to $0.50
Lemarquis1: folds 
*ewenger*: folds 
Alameda22: raises $1.50 to $2
Bobby1776: folds 
MissStax: folds 
vparraga: calls $1.50
*** FLOP *** [Kc Td 7d]
Alameda22: bets $3
vparraga: calls $1.90 and is all-in
Uncalled bet ($1.10) returned to Alameda22
*** TURN *** [Kc Td 7d] [6s]
*** RIVER *** [Kc Td 7d 6s] [3h]
*** SHOW DOWN ***
Alameda22: shows [Ks Kh] (three of a kind, Kings)
vparraga: mucks hand 
Alameda22 collected $8 from pot
*** SUMMARY ***
Total pot $8.40 | Rake $0.40 
Board [Kc Td 7d 6s 3h]
Seat 1: Bobby1776 folded before Flop
Seat 2: MissStax folded before Flop
Seat 3: Brainstew88 folded before Flop (didn't bet)
Seat 4: vparraga mucked [9s 9h]
Seat 5: Lemarquis1 (button) folded before Flop (didn't bet)
Seat 6: *ewenger* (small blind) folded before Flop
Seat 7: Alameda22 (big blind) showed [Ks Kh] and won ($8) with three of a kind, Kings
Seat 9: timboaus folded before Flop (didn't bet)



PokerStars Game #20104296289:  Hold'em No Limit ($0.10/$0.25) - 2008/09/02 21:33:43 ET
Table 'Pomona IV' 9-max Seat #6 is the button
Seat 1: Bobby1776 ($24.75 in chips) 
Seat 2: MissStax ($22.15 in chips) 
Seat 3: Brainstew88 ($3.80 in chips) 
Seat 4: vparraga ($5 in chips) 
Seat 5: Lemarquis1 ($21.65 in chips) 
Seat 6: *ewenger* ($25.75 in chips) 
Seat 7: Alameda22 ($32.50 in chips) 
Seat 8: jasons0147 ($25 in chips) 
Seat 9: timboaus ($25.65 in chips) 
Alameda22: posts small blind $0.10
jasons0147: posts big blind $0.25
*** HOLE CARDS ***
Dealt to Alameda22 [4h 6d]
timboaus: folds 
Bobby1776: calls $0.25
MissStax: calls $0.25
Brainstew88: folds 
vparraga: calls $0.25
Lemarquis1: calls $0.25
*ewenger*: folds 
Alameda22: folds 
jasons0147: checks 
*** FLOP *** [Th 7c 6h]
jasons0147: checks 
Bobby1776: checks 
MissStax: checks 
vparraga: checks 
Lemarquis1: checks 
*** TURN *** [Th 7c 6h] [3s]
jasons0147: bets $1.50
Bobby1776: folds 
MissStax: folds 
vparraga: calls $1.50
Lemarquis1: folds 
*** RIVER *** [Th 7c 6h 3s] [9d]
jasons0147: checks 
vparraga: checks 
*** SHOW DOWN ***
jasons0147: shows [3h 3c] (three of a kind, Threes)
vparraga: mucks hand 
jasons0147 collected $4.15 from pot
*** SUMMARY ***
Total pot $4.35 | Rake $0.20 
Board [Th 7c 6h 3s 9d]
Seat 1: Bobby1776 folded on the Turn
Seat 2: MissStax folded on the Turn
Seat 3: Brainstew88 folded before Flop (didn't bet)
Seat 4: vparraga mucked [4s Ts]
Seat 5: Lemarquis1 folded on the Turn
Seat 6: *ewenger* (button) folded before Flop (didn't bet)
Seat 7: Alameda22 (small blind) folded before Flop
Seat 8: jasons0147 (big blind) showed [3h 3c] and won ($4.15) with three of a kind, Threes
Seat 9: timboaus folded before Flop (didn't bet)



PokerStars Game #20104324461:  Hold'em No Limit ($0.10/$0.25) - 2008/09/02 21:34:58 ET
Table 'Pomona IV' 9-max Seat #7 is the button
Seat 1: Bobby1776 ($24.50 in chips) 
Seat 2: MissStax ($21.90 in chips) 
Seat 3: Brainstew88 ($3.80 in chips) 
Seat 4: vparraga ($3.25 in chips) 
Seat 5: Lemarquis1 ($21.40 in chips) 
Seat 6: *ewenger* ($25.75 in chips) 
Seat 7: Alameda22 ($32.40 in chips) 
Seat 8: jasons0147 ($27.40 in chips) 
Seat 9: timboaus ($25.65 in chips) 
jasons0147: posts small blind $0.10
timboaus: posts big blind $0.25
*** HOLE CARDS ***
Dealt to Alameda22 [Qh 2d]
Bobby1776: raises $0.50 to $0.75
MissStax: folds 
Brainstew88: folds 
vparraga: folds 
Lemarquis1: folds 
*ewenger*: folds 
Alameda22: folds 
jasons0147: folds 
timboaus: folds 
Uncalled bet ($0.50) returned to Bobby1776
Bobby1776 collected $0.60 from pot
Bobby1776: doesn't show hand 
*** SUMMARY ***
Total pot $0.60 | Rake $0 
Seat 1: Bobby1776 collected ($0.60)
Seat 2: MissStax folded before Flop (didn't bet)
Seat 3: Brainstew88 folded before Flop (didn't bet)
Seat 4: vparraga folded before Flop (didn't bet)
Seat 5: Lemarquis1 folded before Flop (didn't bet)
Seat 6: *ewenger* folded before Flop (didn't bet)
Seat 7: Alameda22 (button) folded before Flop (didn't bet)
Seat 8: jasons0147 (small blind) folded before Flop
Seat 9: timboaus (big blind) folded before Flop



PokerStars Game #20104338842:  Hold'em No Limit ($0.10/$0.25) - 2008/09/02 21:35:37 ET
Table 'Pomona IV' 9-max Seat #8 is the button
Seat 1: Bobby1776 ($24.85 in chips) 
Seat 2: MissStax ($21.90 in chips) 
Seat 3: Brainstew88 ($3.80 in chips) 
Seat 4: vparraga ($3.25 in chips) 
Seat 5: Lemarquis1 ($21.40 in chips) 
Seat 6: *ewenger* ($25.75 in chips) 
Seat 7: Alameda22 ($32.40 in chips) 
Seat 8: jasons0147 ($27.30 in chips) 
Seat 9: timboaus ($25.40 in chips) 
timboaus: posts small blind $0.10
Bobby1776: posts big blind $0.25
*** HOLE CARDS ***
Dealt to Alameda22 [Th 3s]
MissStax: folds 
Brainstew88: folds 
vparraga: folds 
vparraga leaves the table
Lemarquis1: folds 
*ewenger*: calls $0.25
Alameda22: folds 
jasons0147: folds 
timboaus: folds 
Bobby1776: checks 
*** FLOP *** [Kc Ks Qd]
Bobby1776: checks 
*ewenger*: bets $0.50
Bobby1776: folds 
Uncalled bet ($0.50) returned to *ewenger*
*ewenger* collected $0.60 from pot
*** SUMMARY ***
Total pot $0.60 | Rake $0 
Board [Kc Ks Qd]
Seat 1: Bobby1776 (big blind) folded on the Flop
Seat 2: MissStax folded before Flop (didn't bet)
Seat 3: Brainstew88 folded before Flop (didn't bet)
Seat 4: vparraga folded before Flop (didn't bet)
Seat 5: Lemarquis1 folded before Flop (didn't bet)
Seat 6: *ewenger* collected ($0.60)
Seat 7: Alameda22 folded before Flop (didn't bet)
Seat 8: jasons0147 (button) folded before Flop (didn't bet)
Seat 9: timboaus (small blind) folded before Flop



PokerStars Game #20104355376:  Hold'em No Limit ($0.10/$0.25) - 2008/09/02 21:36:22 ET
Table 'Pomona IV' 9-max Seat #9 is the button
Seat 1: Bobby1776 ($24.60 in chips) 
Seat 2: MissStax ($21.90 in chips) 
Seat 3: Brainstew88 ($3.80 in chips) 
Seat 5: Lemarquis1 ($21.40 in chips) 
Seat 6: *ewenger* ($26.10 in chips) 
Seat 7: Alameda22 ($32.40 in chips) 
Seat 8: jasons0147 ($27.30 in chips) 
Seat 9: timboaus ($25.30 in chips) 
Bobby1776: posts small blind $0.10
MissStax: posts big blind $0.25
*** HOLE CARDS ***
Dealt to Alameda22 [5h Tc]
Brainstew88: folds 
Lemarquis1: folds 
*ewenger*: raises $0.75 to $1
Alameda22: folds 
jasons0147: folds 
timboaus: folds 
Bobby1776: calls $0.90
MissStax: folds 
*** FLOP *** [9s 2d 2h]
Bobby1776: bets $1.25
*ewenger*: calls $1.25
*** TURN *** [9s 2d 2h] [Jd]
Bobby1776: checks 
*ewenger*: checks 
*** RIVER *** [9s 2d 2h Jd] [6s]
Bobby1776: checks 
*ewenger*: checks 
*** SHOW DOWN ***
Bobby1776: shows [8s 8h] (two pair, Eights and Deuces)
*ewenger*: mucks hand 
Bobby1776 collected $4.55 from pot
*** SUMMARY ***
Total pot $4.75 | Rake $0.20 
Board [9s 2d 2h Jd 6s]
Seat 1: Bobby1776 (small blind) showed [8s 8h] and won ($4.55) with two pair, Eights and Deuces
Seat 2: MissStax (big blind) folded before Flop
Seat 3: Brainstew88 folded before Flop (didn't bet)
Seat 5: Lemarquis1 folded before Flop (didn't bet)
Seat 6: *ewenger* mucked [Qd As]
Seat 7: Alameda22 folded before Flop (didn't bet)
Seat 8: jasons0147 folded before Flop (didn't bet)
Seat 9: timboaus (button) folded before Flop (didn't bet)



PokerStars Game #20104387432:  Hold'em No Limit ($0.10/$0.25) - 2008/09/02 21:37:49 ET
Table 'Pomona IV' 9-max Seat #1 is the button
Seat 1: Bobby1776 ($26.90 in chips) 
Seat 2: MissStax ($21.65 in chips) 
Seat 3: Brainstew88 ($3.80 in chips) 
Seat 5: Lemarquis1 ($21.40 in chips) 
Seat 6: *ewenger* ($23.85 in chips) 
Seat 7: Alameda22 ($32.40 in chips) 
Seat 8: jasons0147 ($27.30 in chips) 
Seat 9: timboaus ($25.30 in chips) 
MissStax: posts small blind $0.10
Brainstew88: posts big blind $0.25
*** HOLE CARDS ***
Dealt to Alameda22 [Jc 6c]
Lemarquis1: folds 
*ewenger*: folds 
Alameda22: folds 
jasons0147: raises $0.50 to $0.75
timboaus: folds 
Bobby1776: calls $0.75
MissStax: folds 
Brainstew88: raises $0.50 to $1.25
jasons0147: folds 
Bobby1776: calls $0.50
*** FLOP *** [Qc Td 3c]
Brainstew88: bets $0.75
Bobby1776: raises $24.90 to $25.65 and is all-in
Brainstew88: calls $1.80 and is all-in
Uncalled bet ($23.10) returned to Bobby1776
*** TURN *** [Qc Td 3c] [6s]
*** RIVER *** [Qc Td 3c 6s] [Js]
*** SHOW DOWN ***
Brainstew88: shows [Ks Kh] (a pair of Kings)
Bobby1776: mucks hand 
Brainstew88 collected $8.05 from pot
*** SUMMARY ***
Total pot $8.45 | Rake $0.40 
Board [Qc Td 3c 6s Js]
Seat 1: Bobby1776 (button) mucked [7d Qs]
Seat 2: MissStax (small blind) folded before Flop
Seat 3: Brainstew88 (big blind) showed [Ks Kh] and won ($8.05) with a pair of Kings
Seat 5: Lemarquis1 folded before Flop (didn't bet)
Seat 6: *ewenger* folded before Flop (didn't bet)
Seat 7: Alameda22 folded before Flop (didn't bet)
Seat 8: jasons0147 folded before Flop
Seat 9: timboaus folded before Flop (didn't bet)



PokerStars Game #20104419611:  Hold'em No Limit ($0.10/$0.25) - 2008/09/02 21:39:15 ET
Table 'Pomona IV' 9-max Seat #2 is the button
Seat 1: Bobby1776 ($23.10 in chips) 
Seat 2: MissStax ($21.55 in chips) 
Seat 3: Brainstew88 ($8.05 in chips) 
Seat 5: Lemarquis1 ($21.40 in chips) 
Seat 6: *ewenger* ($23.85 in chips) 
Seat 7: Alameda22 ($32.40 in chips) 
Seat 8: jasons0147 ($26.55 in chips) 
Seat 9: timboaus ($25.30 in chips) 
Brainstew88: posts small blind $0.10
Lemarquis1: posts big blind $0.25
*** HOLE CARDS ***
Dealt to Alameda22 [7c Jc]
*ewenger*: folds 
Alameda22: folds 
Barracuda B joins the table at seat #4 
jasons0147: folds 
timboaus: folds 
Bobby1776: calls $0.25
MissStax: folds 
Brainstew88: calls $0.15
Lemarquis1: checks 
*** FLOP *** [2d Td 8s]
Brainstew88: bets $0.50
Lemarquis1: calls $0.50
Bobby1776: folds 
*** TURN *** [2d Td 8s] [Qh]
Brainstew88: bets $1
Lemarquis1: calls $1
*** RIVER *** [2d Td 8s Qh] [2h]
Brainstew88: bets $2
Lemarquis1: folds 
Uncalled bet ($2) returned to Brainstew88
Brainstew88 collected $3.60 from pot
Brainstew88: doesn't show hand 
*** SUMMARY ***
Total pot $3.75 | Rake $0.15 
Board [2d Td 8s Qh 2h]
Seat 1: Bobby1776 folded on the Flop
Seat 2: MissStax (button) folded before Flop (didn't bet)
Seat 3: Brainstew88 (small blind) collected ($3.60)
Seat 5: Lemarquis1 (big blind) folded on the River
Seat 6: *ewenger* folded before Flop (didn't bet)
Seat 7: Alameda22 folded before Flop (didn't bet)
Seat 8: jasons0147 folded before Flop (didn't bet)
Seat 9: timboaus folded before Flop (didn't bet)



PokerStars Game #20104444603:  Hold'em No Limit ($0.10/$0.25) - 2008/09/02 21:40:23 ET
Table 'Pomona IV' 9-max Seat #3 is the button
Seat 1: Bobby1776 ($22.85 in chips) 
Seat 2: MissStax ($21.55 in chips) 
Seat 3: Brainstew88 ($9.90 in chips) 
Seat 5: Lemarquis1 ($19.65 in chips) 
Seat 6: *ewenger* ($23.85 in chips) 
Seat 7: Alameda22 ($32.40 in chips) 
Seat 8: jasons0147 ($26.55 in chips) 
Seat 9: timboaus ($25.30 in chips) 
Barracuda B will be allowed to play after the button
Lemarquis1: posts small blind $0.10
*ewenger*: posts big blind $0.25
*** HOLE CARDS ***
Dealt to Alameda22 [Qh 2h]
Alameda22: folds 
jasons0147: folds 
timboaus: folds 
Bobby1776: calls $0.25
MissStax: folds 
Brainstew88: calls $0.25
Lemarquis1: folds 
*ewenger*: checks 
*** FLOP *** [5d 4s 9s]
*ewenger*: bets $0.50
Bobby1776: folds 
Brainstew88: calls $0.50
*** TURN *** [5d 4s 9s] [2c]
*ewenger*: bets $0.50
Brainstew88: calls $0.50
*** RIVER *** [5d 4s 9s 2c] [4c]
*ewenger*: bets $2.25
Brainstew88: folds 
Uncalled bet ($2.25) returned to *ewenger*
*ewenger* collected $2.75 from pot
*** SUMMARY ***
Total pot $2.85 | Rake $0.10 
Board [5d 4s 9s 2c 4c]
Seat 1: Bobby1776 folded on the Flop
Seat 2: MissStax folded before Flop (didn't bet)
Seat 3: Brainstew88 (button) folded on the River
Seat 5: Lemarquis1 (small blind) folded before Flop
Seat 6: *ewenger* (big blind) collected ($2.75)
Seat 7: Alameda22 folded before Flop (didn't bet)
Seat 8: jasons0147 folded before Flop (didn't bet)
Seat 9: timboaus folded before Flop (didn't bet)



PokerStars Game #20104487219:  Hold'em No Limit ($0.10/$0.25) - 2008/09/02 21:42:18 ET
Table 'Pomona IV' 9-max Seat #5 is the button
Seat 1: Bobby1776 ($22.60 in chips) 
Seat 2: MissStax ($21.55 in chips) 
Seat 3: Brainstew88 ($8.65 in chips) 
Seat 4: Barracuda B ($15 in chips) 
Seat 5: Lemarquis1 ($19.55 in chips) 
Seat 6: *ewenger* ($25.35 in chips) 
Seat 7: Alameda22 ($32.40 in chips) 
Seat 8: jasons0147 ($26.55 in chips) 
Seat 9: timboaus ($25.30 in chips) 
*ewenger*: posts small blind $0.10
Alameda22: posts big blind $0.25
Barracuda B: posts big blind $0.25
*** HOLE CARDS ***
Dealt to Alameda22 [6d 4h]
jasons0147: raises $1 to $1.25
timboaus: folds 
Bobby1776: folds 
MissStax: folds 
Brainstew88: folds 
Barracuda B: calls $1
Lemarquis1: folds 
*ewenger*: folds 
Alameda22: folds 
*** FLOP *** [Qd 6h 7h]
jasons0147: bets $2.25
Barracuda B: folds 
Uncalled bet ($2.25) returned to jasons0147
jasons0147 collected $2.75 from pot
jasons0147: doesn't show hand 
*** SUMMARY ***
Total pot $2.85 | Rake $0.10 
Board [Qd 6h 7h]
Seat 1: Bobby1776 folded before Flop (didn't bet)
Seat 2: MissStax folded before Flop (didn't bet)
Seat 3: Brainstew88 folded before Flop (didn't bet)
Seat 4: Barracuda B folded on the Flop
Seat 5: Lemarquis1 (button) folded before Flop (didn't bet)
Seat 6: *ewenger* (small blind) folded before Flop
Seat 7: Alameda22 (big blind) folded before Flop
Seat 8: jasons0147 collected ($2.75)
Seat 9: timboaus folded before Flop (didn't bet)



PokerStars Game #20104515807:  Hold'em No Limit ($0.10/$0.25) - 2008/09/02 21:43:36 ET
Table 'Pomona IV' 9-max Seat #6 is the button
Seat 1: Bobby1776 ($22.60 in chips) 
Seat 2: MissStax ($21.55 in chips) 
Seat 3: Brainstew88 ($8.65 in chips) 
Seat 4: Barracuda B ($13.75 in chips) 
Seat 5: Lemarquis1 ($19.55 in chips) 
Seat 6: *ewenger* ($25.25 in chips) 
Seat 7: Alameda22 ($32.15 in chips) 
Seat 8: jasons0147 ($28.05 in chips) 
Seat 9: timboaus ($25.30 in chips) 
Alameda22: posts small blind $0.10
jasons0147: posts big blind $0.25
*** HOLE CARDS ***
Dealt to Alameda22 [2d 6s]
timboaus: folds 
Bobby1776: raises $0.50 to $0.75
MissStax: folds 
Brainstew88: folds 
Barracuda B: calls $0.75
Lemarquis1: folds 
*ewenger*: folds 
Alameda22: folds 
jasons0147: folds 
*** FLOP *** [9s 3c 7d]
Bobby1776: bets $1.75
Barracuda B: calls $1.75
*** TURN *** [9s 3c 7d] [5h]
Bobby1776: bets $3
Barracuda B: calls $3
*** RIVER *** [9s 3c 7d 5h] [Ac]
Bobby1776: checks 
Barracuda B: checks 
*** SHOW DOWN ***
Bobby1776: shows [Ad Ks] (a pair of Aces)
Barracuda B: mucks hand 
Barracuda B is sitting out
Bobby1776 collected $10.80 from pot
*** SUMMARY ***
Total pot $11.35 | Rake $0.55 
Board [9s 3c 7d 5h Ac]
Seat 1: Bobby1776 showed [Ad Ks] and won ($10.80) with a pair of Aces
Seat 2: MissStax folded before Flop (didn't bet)
Seat 3: Brainstew88 folded before Flop (didn't bet)
Seat 4: Barracuda B mucked [7h 6d]
Seat 5: Lemarquis1 folded before Flop (didn't bet)
Seat 6: *ewenger* (button) folded before Flop (didn't bet)
Seat 7: Alameda22 (small blind) folded before Flop
Seat 8: jasons0147 (big blind) folded before Flop
Seat 9: timboaus folded before Flop (didn't bet)



PokerStars Game #20104538630:  Hold'em No Limit ($0.10/$0.25) - 2008/09/02 21:44:39 ET
Table 'Pomona IV' 9-max Seat #7 is the button
Seat 1: Bobby1776 ($27.90 in chips) 
Seat 2: MissStax ($21.55 in chips) 
Seat 3: Brainstew88 ($8.65 in chips) 
Seat 5: Lemarquis1 ($19.55 in chips) 
Seat 6: *ewenger* ($25.25 in chips) 
Seat 7: Alameda22 ($32.05 in chips) 
Seat 8: jasons0147 ($27.80 in chips) 
jasons0147: posts small blind $0.10
timboaus: is sitting out 
Bobby1776: posts big blind $0.25
*** HOLE CARDS ***
Dealt to Alameda22 [Jh 7d]
timboaus leaves the table
MissStax: folds 
Brainstew88: calls $0.25
Lemarquis1: folds 
*ewenger*: calls $0.25
Alameda22: folds 
jasons0147: folds 
Bobby1776: checks 
*** FLOP *** [5s Jc 2h]
Bobby1776: checks 
Brainstew88: bets $0.50
*ewenger*: folds 
Bobby1776: calls $0.50
*** TURN *** [5s Jc 2h] [9c]
Bobby1776: checks 
Brainstew88: bets $1
Bobby1776: folds 
Uncalled bet ($1) returned to Brainstew88
Brainstew88 collected $1.80 from pot
Brainstew88: doesn't show hand 
*** SUMMARY ***
Total pot $1.85 | Rake $0.05 
Board [5s Jc 2h 9c]
Seat 1: Bobby1776 (big blind) folded on the Turn
Seat 2: MissStax folded before Flop (didn't bet)
Seat 3: Brainstew88 collected ($1.80)
Seat 5: Lemarquis1 folded before Flop (didn't bet)
Seat 6: *ewenger* folded on the Flop
Seat 7: Alameda22 (button) folded before Flop (didn't bet)
Seat 8: jasons0147 (small blind) folded before Flop



PokerStars Game #20104558088:  Hold'em No Limit ($0.10/$0.25) - 2008/09/02 21:45:31 ET
Table 'Pomona IV' 9-max Seat #8 is the button
Seat 1: Bobby1776 ($27.15 in chips) 
Seat 2: MissStax ($21.55 in chips) 
Seat 3: Brainstew88 ($9.70 in chips) 
Seat 5: Lemarquis1 ($19.55 in chips) 
Seat 6: *ewenger* ($25 in chips) 
Seat 7: Alameda22 ($32.05 in chips) 
Seat 8: jasons0147 ($27.70 in chips) 
Bobby1776: posts small blind $0.10
MissStax: posts big blind $0.25
*** HOLE CARDS ***
Dealt to Alameda22 [7d 6d]
Brainstew88: calls $0.25
Lemarquis1: folds 
*ewenger*: folds 
Barracuda B has returned
Alameda22: folds 
jasons0147: folds 
jasons0147 is sitting out
Bobby1776: calls $0.15
MissStax: checks 
*** FLOP *** [Ac 9h Tc]
Bobby1776: checks 
MissStax: checks 
Brainstew88: checks 
*** TURN *** [Ac 9h Tc] [4c]
Bobby1776: checks 
MissStax: checks 
Brainstew88: bets $0.50
Bobby1776: folds 
MissStax: folds 
Uncalled bet ($0.50) returned to Brainstew88
Brainstew88 collected $0.75 from pot
Brainstew88: doesn't show hand 
*** SUMMARY ***
Total pot $0.75 | Rake $0 
Board [Ac 9h Tc 4c]
Seat 1: Bobby1776 (small blind) folded on the Turn
Seat 2: MissStax (big blind) folded on the Turn
Seat 3: Brainstew88 collected ($0.75)
Seat 5: Lemarquis1 folded before Flop (didn't bet)
Seat 6: *ewenger* folded before Flop (didn't bet)
Seat 7: Alameda22 folded before Flop (didn't bet)
Seat 8: jasons0147 (button) folded before Flop (didn't bet)



PokerStars Game #20104581747:  Hold'em No Limit ($0.10/$0.25) - 2008/09/02 21:46:35 ET
Table 'Pomona IV' 9-max Seat #1 is the button
Seat 1: Bobby1776 ($26.90 in chips) 
Seat 2: MissStax ($21.30 in chips) 
Seat 3: Brainstew88 ($10.20 in chips) 
Seat 4: Barracuda B ($8.25 in chips) 
Seat 5: Lemarquis1 ($19.55 in chips) 
Seat 6: *ewenger* ($25 in chips) 
Seat 7: Alameda22 ($32.05 in chips) 
MissStax: posts small blind $0.10
Brainstew88: posts big blind $0.25
*** HOLE CARDS ***
Dealt to Alameda22 [2d 2s]
Barracuda B: calls $0.25
Lemarquis1: folds 
*ewenger*: calls $0.25
Alameda22: folds 
Bobby1776: calls $0.25
MissStax: folds 
Brainstew88: checks 
*** FLOP *** [8c 9h Th]
Brainstew88: checks 
Barracuda B: bets $0.25
*ewenger*: raises $1.75 to $2
Bobby1776: folds 
Brainstew88: folds 
Barracuda B: calls $1.75
*** TURN *** [8c 9h Th] [2h]
Barracuda B: bets $1
*ewenger*: calls $1
*** RIVER *** [8c 9h Th 2h] [Qh]
Barracuda B: bets $1.50
LAultima666 joins the table at seat #9 
*ewenger*: folds 
Uncalled bet ($1.50) returned to Barracuda B
Barracuda B collected $6.80 from pot
Barracuda B: shows [Js 8h] (a flush, Queen high)
*** SUMMARY ***
Total pot $7.10 | Rake $0.30 
Board [8c 9h Th 2h Qh]
Seat 1: Bobby1776 (button) folded on the Flop
Seat 2: MissStax (small blind) folded before Flop
Seat 3: Brainstew88 (big blind) folded on the Flop
Seat 4: Barracuda B collected ($6.80)
Seat 5: Lemarquis1 folded before Flop (didn't bet)
Seat 6: *ewenger* folded on the River
Seat 7: Alameda22 folded before Flop (didn't bet)



PokerStars Game #20104612556:  Hold'em No Limit ($0.10/$0.25) - 2008/09/02 21:47:57 ET
Table 'Pomona IV' 9-max Seat #2 is the button
Seat 1: Bobby1776 ($26.65 in chips) 
Seat 2: MissStax ($21.20 in chips) 
Seat 3: Brainstew88 ($9.95 in chips) 
Seat 4: Barracuda B ($11.80 in chips) 
Seat 5: Lemarquis1 ($19.55 in chips) 
Seat 6: *ewenger* ($21.75 in chips) 
Seat 7: Alameda22 ($32.05 in chips) 
Seat 9: LAultima666 ($5 in chips) 
Brainstew88: posts small blind $0.10
Barracuda B: posts big blind $0.25
LAultima666: posts big blind $0.25
*** HOLE CARDS ***
Dealt to Alameda22 [2c 3c]
Lemarquis1: folds 
*ewenger*: folds 
Alameda22: folds 
LAultima666: checks 
Bobby1776: calls $0.25
MissStax: calls $0.25
Brainstew88: calls $0.15
Barracuda B: checks 
*** FLOP *** [Jd 9d 7d]
Brainstew88: checks 
Barracuda B: checks 
LAultima666: bets $0.50
Bobby1776: folds 
MissStax: folds 
Brainstew88: calls $0.50
Barracuda B: calls $0.50
*** TURN *** [Jd 9d 7d] [5c]
Brainstew88: checks 
Barracuda B: checks 
LAultima666: bets $4.25 and is all-in
Brainstew88: folds 
Barracuda B: folds 
Uncalled bet ($4.25) returned to LAultima666
LAultima666 collected $2.65 from pot
LAultima666: doesn't show hand 
*** SUMMARY ***
Total pot $2.75 | Rake $0.10 
Board [Jd 9d 7d 5c]
Seat 1: Bobby1776 folded on the Flop
Seat 2: MissStax (button) folded on the Flop
Seat 3: Brainstew88 (small blind) folded on the Turn
Seat 4: Barracuda B (big blind) folded on the Turn
Seat 5: Lemarquis1 folded before Flop (didn't bet)
Seat 6: *ewenger* folded before Flop (didn't bet)
Seat 7: Alameda22 folded before Flop (didn't bet)
Seat 9: LAultima666 collected ($2.65)



PokerStars Game #20104644989:  Hold'em No Limit ($0.10/$0.25) - 2008/09/02 21:49:23 ET
Table 'Pomona IV' 9-max Seat #3 is the button
Seat 1: Bobby1776 ($26.40 in chips) 
Seat 2: MissStax ($20.95 in chips) 
Seat 3: Brainstew88 ($9.20 in chips) 
Seat 4: Barracuda B ($11.05 in chips) 
Seat 5: Lemarquis1 ($19.55 in chips) 
Seat 6: *ewenger* ($21.75 in chips) 
Seat 7: Alameda22 ($32.05 in chips) 
Seat 9: LAultima666 ($6.90 in chips) 
Barracuda B: posts small blind $0.10
Lemarquis1: posts big blind $0.25
*** HOLE CARDS ***
Dealt to Alameda22 [5c 8s]
*ewenger*: calls $0.25
Alameda22: folds 
LAultima666: raises $0.75 to $1
Bobby1776: folds 
MissStax: folds 
Brainstew88: folds 
Barracuda B: calls $0.90
Lemarquis1: calls $0.75
*ewenger*: calls $0.75
*** FLOP *** [Js 7h Jc]
Barracuda B: checks 
Lemarquis1: bets $3
*ewenger*: folds 
LAultima666: folds 
Barracuda B: folds 
Uncalled bet ($3) returned to Lemarquis1
Lemarquis1 collected $3.80 from pot
Lemarquis1: doesn't show hand 
*** SUMMARY ***
Total pot $4 | Rake $0.20 
Board [Js 7h Jc]
Seat 1: Bobby1776 folded before Flop (didn't bet)
Seat 2: MissStax folded before Flop (didn't bet)
Seat 3: Brainstew88 (button) folded before Flop (didn't bet)
Seat 4: Barracuda B (small blind) folded on the Flop
Seat 5: Lemarquis1 (big blind) collected ($3.80)
Seat 6: *ewenger* folded on the Flop
Seat 7: Alameda22 folded before Flop (didn't bet)
Seat 9: LAultima666 folded on the Flop



PokerStars Game #20104669842:  Hold'em No Limit ($0.10/$0.25) - 2008/09/02 21:50:29 ET
Table 'Pomona IV' 9-max Seat #4 is the button
Seat 1: Bobby1776 ($26.40 in chips) 
Seat 2: MissStax ($20.95 in chips) 
Seat 3: Brainstew88 ($9.20 in chips) 
Seat 4: Barracuda B ($10.05 in chips) 
Seat 5: Lemarquis1 ($22.35 in chips) 
Seat 6: *ewenger* ($20.75 in chips) 
Seat 7: Alameda22 ($32.05 in chips) 
Seat 9: LAultima666 ($5.90 in chips) 
Lemarquis1: posts small blind $0.10
*ewenger*: posts big blind $0.25
*** HOLE CARDS ***
Dealt to Alameda22 [Jc Th]
Alameda22: folds 
LAultima666: calls $0.25
Bobby1776: calls $0.25
MissStax: raises $1.25 to $1.50
Brainstew88: folds 
Barracuda B: folds 
jasons0147 leaves the table
Lemarquis1 has timed out
Lemarquis1: folds 
Lemarquis1 is sitting out
Lemarquis1 has returned
*ewenger*: calls $1.25
LAultima666: folds 
Bobby1776: folds 
*** FLOP *** [Qs Jd 7h]
*ewenger*: bets $1.25
MissStax: calls $1.25
*** TURN *** [Qs Jd 7h] [Js]
*ewenger*: bets $1.25
MissStax: calls $1.25
*** RIVER *** [Qs Jd 7h Js] [Kh]
*ewenger*: bets $2
MissStax: raises $14.95 to $16.95 and is all-in
*ewenger*: calls $14.75 and is all-in
Uncalled bet ($0.20) returned to MissStax
*** SHOW DOWN ***
MissStax: shows [Qc Qd] (a full house, Queens full of Jacks)
*ewenger*: mucks hand 
MissStax collected $40.05 from pot
*ewenger* leaves the table
*** SUMMARY ***
Total pot $42.10 | Rake $2.05 
Board [Qs Jd 7h Js Kh]
Seat 1: Bobby1776 folded before Flop
Seat 2: MissStax showed [Qc Qd] and won ($40.05) with a full house, Queens full of Jacks
Seat 3: Brainstew88 folded before Flop (didn't bet)
Seat 4: Barracuda B (button) folded before Flop (didn't bet)
Seat 5: Lemarquis1 (small blind) folded before Flop
Seat 6: *ewenger* (big blind) mucked [As Ks]
Seat 7: Alameda22 folded before Flop (didn't bet)
Seat 9: LAultima666 folded before Flop



PokerStars Game #20104725295:  Hold'em No Limit ($0.10/$0.25) - 2008/09/02 21:52:58 ET
Table 'Pomona IV' 9-max Seat #5 is the button
Seat 1: Bobby1776 ($26.15 in chips) 
Seat 2: MissStax ($40.25 in chips) 
Seat 3: Brainstew88 ($9.20 in chips) 
Seat 4: Barracuda B ($10.05 in chips) 
Seat 5: Lemarquis1 ($22.25 in chips) 
Seat 7: Alameda22 ($32.05 in chips) 
Seat 9: LAultima666 ($5.65 in chips) 
Alameda22: posts small blind $0.10
LAultima666: posts big blind $0.25
*** HOLE CARDS ***
Dealt to Alameda22 [6h Jd]
Bobby1776: folds 
MissStax: folds 
Brainstew88: folds 
Barracuda B: calls $0.25
Lemarquis1: folds 
Alameda22: folds 
LAultima666: checks 
*** FLOP *** [Ah 3h Js]
LAultima666: checks 
Barracuda B: checks 
*** TURN *** [Ah 3h Js] [3s]
LAultima666: checks 
Barracuda B: bets $0.25
LAultima666: calls $0.25
*** RIVER *** [Ah 3h Js 3s] [Ac]
LAultima666: checks 
Barracuda B: bets $1
LAultima666: folds 
Uncalled bet ($1) returned to Barracuda B
Barracuda B collected $1.05 from pot
*** SUMMARY ***
Total pot $1.10 | Rake $0.05 
Board [Ah 3h Js 3s Ac]
Seat 1: Bobby1776 folded before Flop (didn't bet)
Seat 2: MissStax folded before Flop (didn't bet)
Seat 3: Brainstew88 folded before Flop (didn't bet)
Seat 4: Barracuda B collected ($1.05)
Seat 5: Lemarquis1 (button) folded before Flop (didn't bet)
Seat 7: Alameda22 (small blind) folded before Flop
Seat 9: LAultima666 (big blind) folded on the River



PokerStars Game #20104751105:  Hold'em No Limit ($0.10/$0.25) - 2008/09/02 21:54:08 ET
Table 'Pomona IV' 9-max Seat #7 is the button
Seat 1: Bobby1776 ($26.15 in chips) 
Seat 2: MissStax ($40.25 in chips) 
Seat 3: Brainstew88 ($9.20 in chips) 
Seat 4: Barracuda B ($10.60 in chips) 
Seat 5: Lemarquis1 ($22.25 in chips) 
Seat 7: Alameda22 ($31.95 in chips) 
Seat 9: LAultima666 ($5.15 in chips) 
LAultima666: posts small blind $0.10
Bobby1776: posts big blind $0.25
*** HOLE CARDS ***
Dealt to Alameda22 [Js 4c]
MissStax: folds 
Brainstew88: folds 
Barracuda B: raises $0.75 to $1
Lemarquis1: folds 
Alameda22: folds 
LAultima666: folds 
Bobby1776: calls $0.75
*** FLOP *** [8c Jd 9c]
Bobby1776: checks 
Barracuda B: bets $1
Bobby1776: folds 
Uncalled bet ($1) returned to Barracuda B
Barracuda B collected $2 from pot
*** SUMMARY ***
Total pot $2.10 | Rake $0.10 
Board [8c Jd 9c]
Seat 1: Bobby1776 (big blind) folded on the Flop
Seat 2: MissStax folded before Flop (didn't bet)
Seat 3: Brainstew88 folded before Flop (didn't bet)
Seat 4: Barracuda B collected ($2)
Seat 5: Lemarquis1 folded before Flop (didn't bet)
Seat 7: Alameda22 (button) folded before Flop (didn't bet)
Seat 9: LAultima666 (small blind) folded before Flop



PokerStars Game #20104767188:  Hold'em No Limit ($0.10/$0.25) - 2008/09/02 21:54:53 ET
Table 'Pomona IV' 9-max Seat #9 is the button
Seat 1: Bobby1776 ($25.15 in chips) 
Seat 2: MissStax ($40.25 in chips) 
Seat 3: Brainstew88 ($9.20 in chips) 
Seat 4: Barracuda B ($11.60 in chips) 
Seat 5: Lemarquis1 ($22.25 in chips) 
Seat 7: Alameda22 ($31.95 in chips) 
Seat 9: LAultima666 ($5.05 in chips) 
Bobby1776: posts small blind $0.10
MissStax: posts big blind $0.25
*** HOLE CARDS ***
Dealt to Alameda22 [Ad Qc]
Brainstew88: calls $0.25
Barracuda B: raises $0.25 to $0.50
Lemarquis1: folds 
Alameda22: folds 
LAultima666: calls $0.50
Bobby1776: calls $0.40
MissStax: calls $0.25
Brainstew88: calls $0.25
*** FLOP *** [Ks 4s 6c]
Bobby1776: checks 
MissStax: checks 
Brainstew88: checks 
Sugar-Horst joins the table at seat #8 
Barracuda B: bets $1
LAultima666: calls $1
Bobby1776: folds 
MissStax: folds 
Brainstew88: folds 
*** TURN *** [Ks 4s 6c] [5h]
Barracuda B: bets $1
LAultima666: raises $2.55 to $3.55 and is all-in
aintitkewl joins the table at seat #6 
Barracuda B: calls $2.55
*** RIVER *** [Ks 4s 6c 5h] [4c]
*** SHOW DOWN ***
Barracuda B: shows [3s 5s] (two pair, Fives and Fours)
LAultima666: shows [Th Kd] (two pair, Kings and Fours)
LAultima666 collected $11.05 from pot
*** SUMMARY ***
Total pot $11.60 | Rake $0.55 
Board [Ks 4s 6c 5h 4c]
Seat 1: Bobby1776 (small blind) folded on the Flop
Seat 2: MissStax (big blind) folded on the Flop
Seat 3: Brainstew88 folded on the Flop
Seat 4: Barracuda B showed [3s 5s] and lost with two pair, Fives and Fours
Seat 5: Lemarquis1 folded before Flop (didn't bet)
Seat 7: Alameda22 folded before Flop (didn't bet)
Seat 9: LAultima666 (button) showed [Th Kd] and won ($11.05) with two pair, Kings and Fours



PokerStars Game #20104798317:  Hold'em No Limit ($0.10/$0.25) - 2008/09/02 21:56:17 ET
Table 'Pomona IV' 9-max Seat #1 is the button
Seat 1: Bobby1776 ($24.65 in chips) 
Seat 2: MissStax ($39.75 in chips) 
Seat 3: Brainstew88 ($8.70 in chips) 
Seat 4: Barracuda B ($6.55 in chips) 
Seat 5: Lemarquis1 ($22.25 in chips) 
Seat 7: Alameda22 ($31.95 in chips) 
Seat 8: Sugar-Horst ($15 in chips) 
Seat 9: LAultima666 ($11.05 in chips) 
MissStax: posts small blind $0.10
Brainstew88: posts big blind $0.25
aintitkewl: sits out 
Sugar-Horst: posts big blind $0.25
*** HOLE CARDS ***
Dealt to Alameda22 [4h 2c]
Barracuda B: calls $0.25
Lemarquis1: folds 
Alameda22: folds 
Sugar-Horst: checks 
LAultima666: folds 
Bobby1776: raises $1 to $1.25
MissStax: folds 
Brainstew88: folds 
Barracuda B: calls $1
Sugar-Horst: folds 
*** FLOP *** [7h Ts 3s]
Barracuda B: checks 
Bobby1776: bets $3
Barracuda B: folds 
Uncalled bet ($3) returned to Bobby1776
Bobby1776 collected $2.95 from pot
Bobby1776: doesn't show hand 
*** SUMMARY ***
Total pot $3.10 | Rake $0.15 
Board [7h Ts 3s]
Seat 1: Bobby1776 (button) collected ($2.95)
Seat 2: MissStax (small blind) folded before Flop
Seat 3: Brainstew88 (big blind) folded before Flop
Seat 4: Barracuda B folded on the Flop
Seat 5: Lemarquis1 folded before Flop (didn't bet)
Seat 7: Alameda22 folded before Flop (didn't bet)
Seat 8: Sugar-Horst folded before Flop
Seat 9: LAultima666 folded before Flop (didn't bet)



PokerStars Game #20104822316:  Hold'em No Limit ($0.10/$0.25) - 2008/09/02 21:57:22 ET
Table 'Pomona IV' 9-max Seat #2 is the button
Seat 1: Bobby1776 ($26.35 in chips) 
Seat 2: MissStax ($39.65 in chips) 
Seat 3: Brainstew88 ($8.45 in chips) 
Seat 4: Barracuda B ($5.30 in chips) 
Seat 5: Lemarquis1 ($22.25 in chips) 
Seat 7: Alameda22 ($31.95 in chips) 
Seat 8: Sugar-Horst ($14.75 in chips) 
Seat 9: LAultima666 ($11.05 in chips) 
Brainstew88: posts small blind $0.10
Barracuda B: posts big blind $0.25
aintitkewl: sits out 
*** HOLE CARDS ***
Dealt to Alameda22 [3h Tc]
Lemarquis1: folds 
Alameda22: folds 
Sugar-Horst: raises $0.50 to $0.75
LAultima666: folds 
Bobby1776: folds 
MissStax: folds 
Brainstew88: calls $0.65
Barracuda B: calls $0.50
*** FLOP *** [3c 8h 4d]
Brainstew88: bets $0.25
Barracuda B: calls $0.25
Sugar-Horst: raises $1 to $1.25
Brainstew88: folds 
Barracuda B: folds 
Uncalled bet ($1) returned to Sugar-Horst
Sugar-Horst collected $2.90 from pot
Sugar-Horst: doesn't show hand 
*** SUMMARY ***
Total pot $3 | Rake $0.10 
Board [3c 8h 4d]
Seat 1: Bobby1776 folded before Flop (didn't bet)
Seat 2: MissStax (button) folded before Flop (didn't bet)
Seat 3: Brainstew88 (small blind) folded on the Flop
Seat 4: Barracuda B (big blind) folded on the Flop
Seat 5: Lemarquis1 folded before Flop (didn't bet)
Seat 7: Alameda22 folded before Flop (didn't bet)
Seat 8: Sugar-Horst collected ($2.90)
Seat 9: LAultima666 folded before Flop (didn't bet)



PokerStars Game #20104858192:  Hold'em No Limit ($0.10/$0.25) - 2008/09/02 21:59:02 ET
Table 'Pomona IV' 9-max Seat #3 is the button
Seat 1: Bobby1776 ($26.35 in chips) 
Seat 2: MissStax ($39.65 in chips) 
Seat 3: Brainstew88 ($7.45 in chips) 
Seat 4: Barracuda B ($4.30 in chips) 
Seat 5: Lemarquis1 ($22.25 in chips) 
Seat 7: Alameda22 ($31.95 in chips) 
Seat 8: Sugar-Horst ($16.65 in chips) 
Seat 9: LAultima666 ($11.05 in chips) 
Barracuda B: posts small blind $0.10
Lemarquis1: posts big blind $0.25
aintitkewl: sits out 
*** HOLE CARDS ***
Dealt to Alameda22 [4s Jc]
Alameda22: folds 
Sugar-Horst: calls $0.25
LAultima666: folds 
Bobby1776: folds 
MissStax: folds 
Brainstew88: folds 
Barracuda B: raises $0.25 to $0.50
Lemarquis1: folds 
Sugar-Horst: calls $0.25
*** FLOP *** [7h 2s Qh]
Barracuda B: checks 
Sugar-Horst: bets $0.75
Barracuda B: calls $0.75
*** TURN *** [7h 2s Qh] [3c]
Barracuda B: checks 
Sugar-Horst: bets $1.25
Barracuda B: folds 
Uncalled bet ($1.25) returned to Sugar-Horst
Sugar-Horst collected $2.65 from pot
Sugar-Horst: doesn't show hand 
*** SUMMARY ***
Total pot $2.75 | Rake $0.10 
Board [7h 2s Qh 3c]
Seat 1: Bobby1776 folded before Flop (didn't bet)
Seat 2: MissStax folded before Flop (didn't bet)
Seat 3: Brainstew88 (button) folded before Flop (didn't bet)
Seat 4: Barracuda B (small blind) folded on the Turn
Seat 5: Lemarquis1 (big blind) folded before Flop
Seat 7: Alameda22 folded before Flop (didn't bet)
Seat 8: Sugar-Horst collected ($2.65)
Seat 9: LAultima666 folded before Flop (didn't bet)



PokerStars Game #20104897855:  Hold'em No Limit ($0.10/$0.25) - 2008/09/02 22:00:48 ET
Table 'Pomona IV' 9-max Seat #4 is the button
Seat 1: Bobby1776 ($26.35 in chips) 
Seat 2: MissStax ($39.65 in chips) 
Seat 3: Brainstew88 ($7.45 in chips) 
Seat 4: Barracuda B ($3.05 in chips) 
Seat 5: Lemarquis1 ($22 in chips) 
Seat 6: aintitkewl ($25 in chips) 
Seat 7: Alameda22 ($31.95 in chips) 
Seat 8: Sugar-Horst ($18.05 in chips) 
Seat 9: LAultima666 ($11.05 in chips) 
Lemarquis1: posts small blind $0.10
aintitkewl: posts big blind $0.25
*** HOLE CARDS ***
Dealt to Alameda22 [7s 3s]
Alameda22: folds 
Sugar-Horst: folds 
LAultima666: calls $0.25
Bobby1776: raises $0.50 to $0.75
MissStax: folds 
Brainstew88: folds 
Barracuda B: folds 
Lemarquis1: folds 
aintitkewl: calls $0.50
LAultima666: calls $0.50
*** FLOP *** [Qd 2c 7c]
aintitkewl: checks 
LAultima666: checks 
Bobby1776: bets $1.75
aintitkewl: folds 
LAultima666: folds 
Uncalled bet ($1.75) returned to Bobby1776
Bobby1776 collected $2.25 from pot
Bobby1776: doesn't show hand 
*** SUMMARY ***
Total pot $2.35 | Rake $0.10 
Board [Qd 2c 7c]
Seat 1: Bobby1776 collected ($2.25)
Seat 2: MissStax folded before Flop (didn't bet)
Seat 3: Brainstew88 folded before Flop (didn't bet)
Seat 4: Barracuda B (button) folded before Flop (didn't bet)
Seat 5: Lemarquis1 (small blind) folded before Flop
Seat 6: aintitkewl (big blind) folded on the Flop
Seat 7: Alameda22 folded before Flop (didn't bet)
Seat 8: Sugar-Horst folded before Flop (didn't bet)
Seat 9: LAultima666 folded on the Flop



PokerStars Game #20104925041:  Hold'em No Limit ($0.10/$0.25) - 2008/09/02 22:02:02 ET
Table 'Pomona IV' 9-max Seat #5 is the button
Seat 1: Bobby1776 ($27.85 in chips) 
Seat 2: MissStax ($39.65 in chips) 
Seat 3: Brainstew88 ($7.45 in chips) 
Seat 4: Barracuda B ($3.05 in chips) 
Seat 5: Lemarquis1 ($21.90 in chips) 
Seat 6: aintitkewl ($24.25 in chips) 
Seat 7: Alameda22 ($31.95 in chips) 
Seat 8: Sugar-Horst ($18.05 in chips) 
Seat 9: LAultima666 ($10.30 in chips) 
aintitkewl: posts small blind $0.10
Alameda22: posts big blind $0.25
*** HOLE CARDS ***
Dealt to Alameda22 [Ts Ks]
Sugar-Horst: folds 
LAultima666: folds 
Bobby1776: raises $0.50 to $0.75
MissStax: folds 
Brainstew88: folds 
Barracuda B: folds 
Lemarquis1: folds 
aintitkewl: folds 
Alameda22: folds 
Uncalled bet ($0.50) returned to Bobby1776
Bobby1776 collected $0.60 from pot
Bobby1776: doesn't show hand 
*** SUMMARY ***
Total pot $0.60 | Rake $0 
Seat 1: Bobby1776 collected ($0.60)
Seat 2: MissStax folded before Flop (didn't bet)
Seat 3: Brainstew88 folded before Flop (didn't bet)
Seat 4: Barracuda B folded before Flop (didn't bet)
Seat 5: Lemarquis1 (button) folded before Flop (didn't bet)
Seat 6: aintitkewl (small blind) folded before Flop
Seat 7: Alameda22 (big blind) folded before Flop
Seat 8: Sugar-Horst folded before Flop (didn't bet)
Seat 9: LAultima666 folded before Flop (didn't bet)



PokerStars Game #20104938309:  Hold'em No Limit ($0.10/$0.25) - 2008/09/02 22:02:38 ET
Table 'Pomona IV' 9-max Seat #6 is the button
Seat 1: Bobby1776 ($28.20 in chips) 
Seat 2: MissStax ($39.65 in chips) 
Seat 3: Brainstew88 ($7.45 in chips) 
Seat 4: Barracuda B ($3.05 in chips) 
Seat 5: Lemarquis1 ($21.90 in chips) 
Seat 6: aintitkewl ($24.15 in chips) 
Seat 7: Alameda22 ($31.70 in chips) 
Seat 8: Sugar-Horst ($18.05 in chips) 
Seat 9: LAultima666 ($10.30 in chips) 
Alameda22: posts small blind $0.10
Sugar-Horst: posts big blind $0.25
*** HOLE CARDS ***
Dealt to Alameda22 [5d 9c]
LAultima666: folds 
Bobby1776: calls $0.25
MissStax: folds 
Brainstew88: folds 
Barracuda B: folds 
Lemarquis1: raises $1 to $1.25
aintitkewl: folds 
Alameda22: folds 
Sugar-Horst: calls $1
Bobby1776: calls $1
*** FLOP *** [Ts 6h 8s]
Sugar-Horst: checks 
Bobby1776: checks 
Lemarquis1: checks 
*** TURN *** [Ts 6h 8s] [5h]
Sugar-Horst: bets $1.25
Bobby1776: calls $1.25
Lemarquis1: folds 
*** RIVER *** [Ts 6h 8s 5h] [As]
Sugar-Horst: checks 
Bobby1776: checks 
*** SHOW DOWN ***
Sugar-Horst: shows [Qh Ac] (a pair of Aces)
Bobby1776: mucks hand 
Sugar-Horst collected $6.05 from pot
*** SUMMARY ***
Total pot $6.35 | Rake $0.30 
Board [Ts 6h 8s 5h As]
Seat 1: Bobby1776 mucked [Qd Js]
Seat 2: MissStax folded before Flop (didn't bet)
Seat 3: Brainstew88 folded before Flop (didn't bet)
Seat 4: Barracuda B folded before Flop (didn't bet)
Seat 5: Lemarquis1 folded on the Turn
Seat 6: aintitkewl (button) folded before Flop (didn't bet)
Seat 7: Alameda22 (small blind) folded before Flop
Seat 8: Sugar-Horst (big blind) showed [Qh Ac] and won ($6.05) with a pair of Aces
Seat 9: LAultima666 folded before Flop (didn't bet)



PokerStars Game #20104972558:  Hold'em No Limit ($0.10/$0.25) - 2008/09/02 22:04:09 ET
Table 'Pomona IV' 9-max Seat #7 is the button
Seat 1: Bobby1776 ($25.70 in chips) 
Seat 2: MissStax ($39.65 in chips) 
Seat 3: Brainstew88 ($7.45 in chips) 
Seat 4: Barracuda B ($3.05 in chips) 
Seat 5: Lemarquis1 ($20.65 in chips) 
Seat 6: aintitkewl ($24.15 in chips) 
Seat 7: Alameda22 ($31.60 in chips) 
Seat 8: Sugar-Horst ($21.60 in chips) 
Seat 9: LAultima666 ($10.30 in chips) 
Sugar-Horst: posts small blind $0.10
LAultima666: posts big blind $0.25
*** HOLE CARDS ***
Dealt to Alameda22 [5s 2h]
Bobby1776: raises $0.50 to $0.75
MissStax: folds 
Brainstew88: folds 
Barracuda B: calls $0.75
Lemarquis1: folds 
aintitkewl: folds 
Alameda22: folds 
Sugar-Horst: folds 
LAultima666: raises $1.75 to $2.50
Bobby1776: folds 
Barracuda B: raises $0.55 to $3.05 and is all-in
LAultima666: calls $0.55
*** FLOP *** [Jd 2d 3d]
*** TURN *** [Jd 2d 3d] [3c]
*** RIVER *** [Jd 2d 3d 3c] [Jh]
*** SHOW DOWN ***
LAultima666: shows [Kd Kc] (two pair, Kings and Jacks)
Barracuda B: shows [9s Js] (a full house, Jacks full of Threes)
Barracuda B collected $6.65 from pot
*** SUMMARY ***
Total pot $6.95 | Rake $0.30 
Board [Jd 2d 3d 3c Jh]
Seat 1: Bobby1776 folded before Flop
Seat 2: MissStax folded before Flop (didn't bet)
Seat 3: Brainstew88 folded before Flop (didn't bet)
Seat 4: Barracuda B showed [9s Js] and won ($6.65) with a full house, Jacks full of Threes
Seat 5: Lemarquis1 folded before Flop (didn't bet)
Seat 6: aintitkewl folded before Flop (didn't bet)
Seat 7: Alameda22 (button) folded before Flop (didn't bet)
Seat 8: Sugar-Horst (small blind) folded before Flop
Seat 9: LAultima666 (big blind) showed [Kd Kc] and lost with two pair, Kings and Jacks



PokerStars Game #20105005148:  Hold'em No Limit ($0.10/$0.25) - 2008/09/02 22:05:37 ET
Table 'Pomona IV' 9-max Seat #8 is the button
Seat 1: Bobby1776 ($24.95 in chips) 
Seat 2: MissStax ($39.65 in chips) 
Seat 3: Brainstew88 ($7.45 in chips) 
Seat 4: Barracuda B ($6.65 in chips) 
Seat 5: Lemarquis1 ($20.65 in chips) 
Seat 6: aintitkewl ($24.15 in chips) 
Seat 7: Alameda22 ($31.60 in chips) 
Seat 8: Sugar-Horst ($21.50 in chips) 
Seat 9: LAultima666 ($7.25 in chips) 
LAultima666: posts small blind $0.10
Bobby1776: posts big blind $0.25
*** HOLE CARDS ***
Dealt to Alameda22 [4s Jc]
MissStax: folds 
Brainstew88: folds 
Barracuda B: calls $0.25
Lemarquis1: calls $0.25
aintitkewl: folds 
Alameda22: folds 
Sugar-Horst: folds 
LAultima666: calls $0.15
Bobby1776: checks 
*** FLOP *** [Jd 2d As]
LAultima666: checks 
Bobby1776: bets $0.75
Barracuda B: folds 
Lemarquis1: folds 
LAultima666: folds 
Uncalled bet ($0.75) returned to Bobby1776
Bobby1776 collected $0.95 from pot
Bobby1776: doesn't show hand 
*** SUMMARY ***
Total pot $1 | Rake $0.05 
Board [Jd 2d As]
Seat 1: Bobby1776 (big blind) collected ($0.95)
Seat 2: MissStax folded before Flop (didn't bet)
Seat 3: Brainstew88 folded before Flop (didn't bet)
Seat 4: Barracuda B folded on the Flop
Seat 5: Lemarquis1 folded on the Flop
Seat 6: aintitkewl folded before Flop (didn't bet)
Seat 7: Alameda22 folded before Flop (didn't bet)
Seat 8: Sugar-Horst (button) folded before Flop (didn't bet)
Seat 9: LAultima666 (small blind) folded on the Flop



PokerStars Game #20105034023:  Hold'em No Limit ($0.10/$0.25) - 2008/09/02 22:06:55 ET
Table 'Pomona IV' 9-max Seat #9 is the button
Seat 1: Bobby1776 ($25.65 in chips) 
Seat 2: MissStax ($39.65 in chips) 
Seat 3: Brainstew88 ($7.45 in chips) 
Seat 4: Barracuda B ($6.40 in chips) 
Seat 5: Lemarquis1 ($20.40 in chips) 
Seat 6: aintitkewl ($24.15 in chips) 
Seat 7: Alameda22 ($31.60 in chips) 
Seat 8: Sugar-Horst ($21.50 in chips) 
Seat 9: LAultima666 ($7 in chips) 
Bobby1776: posts small blind $0.10
MissStax: posts big blind $0.25
*** HOLE CARDS ***
Dealt to Alameda22 [Ad Qs]
Brainstew88: folds 
Barracuda B: folds 
Lemarquis1: folds 
aintitkewl: folds 
Alameda22: raises $0.75 to $1
Sugar-Horst: folds 
LAultima666: calls $1
Bobby1776: folds 
MissStax: folds 
*** FLOP *** [5h Jd 6s]
Alameda22: checks 
LAultima666: checks 
*** TURN *** [5h Jd 6s] [8d]
Alameda22: checks 
LAultima666: checks 
*** RIVER *** [5h Jd 6s 8d] [8c]
Alameda22: checks 
LAultima666: bets $1.25
Alameda22: folds 
Uncalled bet ($1.25) returned to LAultima666
LAultima666 collected $2.25 from pot
LAultima666: doesn't show hand 
*** SUMMARY ***
Total pot $2.35 | Rake $0.10 
Board [5h Jd 6s 8d 8c]
Seat 1: Bobby1776 (small blind) folded before Flop
Seat 2: MissStax (big blind) folded before Flop
Seat 3: Brainstew88 folded before Flop (didn't bet)
Seat 4: Barracuda B folded before Flop (didn't bet)
Seat 5: Lemarquis1 folded before Flop (didn't bet)
Seat 6: aintitkewl folded before Flop (didn't bet)
Seat 7: Alameda22 folded on the River
Seat 8: Sugar-Horst folded before Flop (didn't bet)
Seat 9: LAultima666 (button) collected ($2.25)



PokerStars Game #20105069046:  Hold'em No Limit ($0.10/$0.25) - 2008/09/02 22:08:29 ET
Table 'Pomona IV' 9-max Seat #1 is the button
Seat 1: Bobby1776 ($25.55 in chips) 
Seat 2: MissStax ($39.40 in chips) 
Seat 3: Brainstew88 ($7.45 in chips) 
Seat 4: Barracuda B ($6.40 in chips) 
Seat 5: Lemarquis1 ($20.40 in chips) 
Seat 6: aintitkewl ($24.15 in chips) 
Seat 7: Alameda22 ($30.60 in chips) 
Seat 8: Sugar-Horst ($21.50 in chips) 
Seat 9: LAultima666 ($8.25 in chips) 
MissStax: posts small blind $0.10
Brainstew88: posts big blind $0.25
*** HOLE CARDS ***
Dealt to Alameda22 [Jh Ac]
Barracuda B: raises $0.25 to $0.50
Lemarquis1: folds 
aintitkewl: folds 
Alameda22: folds 
Sugar-Horst: calls $0.50
LAultima666: folds 
Bobby1776: calls $0.50
MissStax: calls $0.40
Brainstew88: calls $0.25
*** FLOP *** [7c Td 8d]
MissStax: checks 
Brainstew88: checks 
Barracuda B: bets $1
Sugar-Horst: calls $1
Bobby1776: calls $1
MissStax: folds 
Brainstew88: folds 
*** TURN *** [7c Td 8d] [6c]
Barracuda B: bets $1
Sugar-Horst: raises $1 to $2
Bobby1776: raises $2 to $4
Barracuda B: folds 
Sugar-Horst: folds 
Uncalled bet ($2) returned to Bobby1776
Bobby1776 collected $10 from pot
Bobby1776: doesn't show hand 
Bobby1776 said, "wow"
*** SUMMARY ***
Total pot $10.50 | Rake $0.50 
Board [7c Td 8d 6c]
Seat 1: Bobby1776 (button) collected ($10)
Seat 2: MissStax (small blind) folded on the Flop
Seat 3: Brainstew88 (big blind) folded on the Flop
Seat 4: Barracuda B folded on the Turn
Seat 5: Lemarquis1 folded before Flop (didn't bet)
Seat 6: aintitkewl folded before Flop (didn't bet)
Seat 7: Alameda22 folded before Flop (didn't bet)
Seat 8: Sugar-Horst folded on the Turn
Seat 9: LAultima666 folded before Flop (didn't bet)



PokerStars Game #20105112924:  Hold'em No Limit ($0.10/$0.25) - 2008/09/02 22:10:28 ET
Table 'Pomona IV' 9-max Seat #2 is the button
Seat 1: Bobby1776 ($32.05 in chips) 
Seat 2: MissStax ($38.90 in chips) 
Seat 3: Brainstew88 ($6.95 in chips) 
Seat 4: Barracuda B ($3.90 in chips) 
Seat 5: Lemarquis1 ($20.40 in chips) 
Seat 6: aintitkewl ($24.15 in chips) 
Seat 7: Alameda22 ($30.60 in chips) 
Seat 8: Sugar-Horst ($18 in chips) 
Seat 9: LAultima666 ($8.25 in chips) 
Brainstew88: posts small blind $0.10
Bobby1776 said, "I was the only one with a 9?"
Barracuda B: posts big blind $0.25
*** HOLE CARDS ***
Dealt to Alameda22 [2d 4c]
Lemarquis1: raises $0.75 to $1
aintitkewl: folds 
Alameda22: folds 
Sugar-Horst: folds 
LAultima666: folds 
Bobby1776: calls $1
MissStax: folds 
Brainstew88: calls $0.90
Barracuda B: calls $0.75
*** FLOP *** [As 6c 7c]
Brainstew88: checks 
Barracuda B: checks 
Lemarquis1: checks 
Bobby1776: bets $1.50
Brainstew88: calls $1.50
Barracuda B: raises $1.40 to $2.90 and is all-in
Lemarquis1: folds 
Bobby1776: calls $1.40
Brainstew88: calls $1.40
*** TURN *** [As 6c 7c] [Kc]
Brainstew88: checks 
Bobby1776: checks 
*** RIVER *** [As 6c 7c Kc] [9c]
Brainstew88: checks 
Bobby1776: checks 
*** SHOW DOWN ***
Brainstew88: shows [Ah 2s] (a pair of Aces)
Barracuda B: shows [6d Qc] (a flush, King high)
Brainstew88 is sitting out
Bobby1776: shows [9s 9h] (three of a kind, Nines)
Barracuda B collected $12.10 from pot
*** SUMMARY ***
Total pot $12.70 | Rake $0.60 
Board [As 6c 7c Kc 9c]
Seat 1: Bobby1776 showed [9s 9h] and lost with three of a kind, Nines
Seat 2: MissStax (button) folded before Flop (didn't bet)
Seat 3: Brainstew88 (small blind) showed [Ah 2s] and lost with a pair of Aces
Seat 4: Barracuda B (big blind) showed [6d Qc] and won ($12.10) with a flush, King high
Seat 5: Lemarquis1 folded on the Flop
Seat 6: aintitkewl folded before Flop (didn't bet)
Seat 7: Alameda22 folded before Flop (didn't bet)
Seat 8: Sugar-Horst folded before Flop (didn't bet)
Seat 9: LAultima666 folded before Flop (didn't bet)



PokerStars Game #20105148086:  Hold'em No Limit ($0.10/$0.25) - 2008/09/02 22:12:03 ET
Table 'Pomona IV' 9-max Seat #4 is the button
Seat 1: Bobby1776 ($28.15 in chips) 
Seat 2: MissStax ($38.90 in chips) 
Seat 4: Barracuda B ($12.10 in chips) 
Seat 5: Lemarquis1 ($19.40 in chips) 
Seat 6: aintitkewl ($24.15 in chips) 
Seat 7: Alameda22 ($30.60 in chips) 
Seat 8: Sugar-Horst ($18 in chips) 
Seat 9: LAultima666 ($8.25 in chips) 
Lemarquis1: posts small blind $0.10
aintitkewl: posts big blind $0.25
*** HOLE CARDS ***
Dealt to Alameda22 [Td As]
Bobby1776 said, "such a lucj fn idiot"
Brainstew88 has returned
Alameda22: folds 
Sugar-Horst: calls $0.25
LAultima666: folds 
Bobby1776: folds 
MissStax: folds 
Barracuda B: calls $0.25
Lemarquis1: calls $0.15
aintitkewl: checks 
*** FLOP *** [Js 6c 2h]
Lemarquis1: bets $0.75
aintitkewl: folds 
Sugar-Horst: folds 
Barracuda B: folds 
Uncalled bet ($0.75) returned to Lemarquis1
Sugar-Horst is sitting out
Lemarquis1 collected $0.95 from pot
Lemarquis1: doesn't show hand 
*** SUMMARY ***
Total pot $1 | Rake $0.05 
Board [Js 6c 2h]
Seat 1: Bobby1776 folded before Flop (didn't bet)
Seat 2: MissStax folded before Flop (didn't bet)
Seat 4: Barracuda B (button) folded on the Flop
Seat 5: Lemarquis1 (small blind) collected ($0.95)
Seat 6: aintitkewl (big blind) folded on the Flop
Seat 7: Alameda22 folded before Flop (didn't bet)
Seat 8: Sugar-Horst folded on the Flop
Seat 9: LAultima666 folded before Flop (didn't bet)



PokerStars Game #20105170913:  Hold'em No Limit ($0.10/$0.25) - 2008/09/02 22:13:05 ET
Table 'Pomona IV' 9-max Seat #5 is the button
Seat 1: Bobby1776 ($28.15 in chips) 
Seat 2: MissStax ($38.90 in chips) 
Seat 3: Brainstew88 ($3.05 in chips) 
Seat 4: Barracuda B ($11.85 in chips) 
Seat 5: Lemarquis1 ($20.10 in chips) 
Seat 6: aintitkewl ($23.90 in chips) 
Seat 7: Alameda22 ($30.60 in chips) 
Seat 9: LAultima666 ($8.25 in chips) 
aintitkewl: posts small blind $0.10
Alameda22: posts big blind $0.25
*** HOLE CARDS ***
Dealt to Alameda22 [8s Js]
LAultima666: folds 
Bobby1776: calls $0.25
MissStax: folds 
Brainstew88: raises $0.25 to $0.50
Barracuda B: calls $0.50
Lemarquis1: folds 
aintitkewl: folds 
Alameda22: folds 
Bobby1776: calls $0.25
*** FLOP *** [Th Ts 6s]
Sugar-Horst has returned
Bobby1776: checks 
Brainstew88: bets $0.50
Barracuda B: raises $0.50 to $1
Bobby1776: folds 
Brainstew88: calls $0.50
*** TURN *** [Th Ts 6s] [Ks]
Brainstew88: bets $0.50
Barracuda B: raises $0.50 to $1
Brainstew88: raises $0.50 to $1.50
Barracuda B: calls $0.50
*** RIVER *** [Th Ts 6s Ks] [4s]
Brainstew88: bets $0.05 and is all-in
Barracuda B: calls $0.05
*** SHOW DOWN ***
Brainstew88: shows [Ah Qs] (a flush, King high)
Barracuda B: mucks hand 
Brainstew88 collected $6.65 from pot
*** SUMMARY ***
Total pot $6.95 | Rake $0.30 
Board [Th Ts 6s Ks 4s]
Seat 1: Bobby1776 folded on the Flop
Seat 2: MissStax folded before Flop (didn't bet)
Seat 3: Brainstew88 showed [Ah Qs] and won ($6.65) with a flush, King high
Seat 4: Barracuda B mucked [2d 6d]
Seat 5: Lemarquis1 (button) folded before Flop (didn't bet)
Seat 6: aintitkewl (small blind) folded before Flop
Seat 7: Alameda22 (big blind) folded before Flop
Seat 9: LAultima666 folded before Flop (didn't bet)



PokerStars Game #20105203082:  Hold'em No Limit ($0.10/$0.25) - 2008/09/02 22:14:32 ET
Table 'Pomona IV' 9-max Seat #6 is the button
Seat 1: Bobby1776 ($27.65 in chips) 
Seat 2: MissStax ($38.90 in chips) 
Seat 3: Brainstew88 ($6.65 in chips) 
Seat 4: Barracuda B ($8.80 in chips) 
Seat 5: Lemarquis1 ($20.10 in chips) 
Seat 6: aintitkewl ($23.80 in chips) 
Seat 7: Alameda22 ($30.35 in chips) 
Seat 9: LAultima666 ($8.25 in chips) 
Alameda22: posts small blind $0.10
Sugar-Horst: is sitting out 
LAultima666: posts big blind $0.25
*** HOLE CARDS ***
Dealt to Alameda22 [7s Ad]
Bobby1776: raises $0.50 to $0.75
MissStax: folds 
Brainstew88: calls $0.75
Barracuda B: folds 
Lemarquis1: calls $0.75
aintitkewl: folds 
Sugar-Horst leaves the table
Alameda22: folds 
LAultima666: raises $2 to $2.75
Bobby1776: folds 
Brainstew88: folds 
Lemarquis1: folds 
Uncalled bet ($2) returned to LAultima666
Bobby1776 said, "nice steal"
LAultima666 collected $3.10 from pot
LAultima666: doesn't show hand 
*** SUMMARY ***
Total pot $3.10 | Rake $0 
Seat 1: Bobby1776 folded before Flop
Seat 2: MissStax folded before Flop (didn't bet)
Seat 3: Brainstew88 folded before Flop
Seat 4: Barracuda B folded before Flop (didn't bet)
Seat 5: Lemarquis1 folded before Flop
Seat 6: aintitkewl (button) folded before Flop (didn't bet)
Seat 7: Alameda22 (small blind) folded before Flop
Seat 9: LAultima666 (big blind) collected ($3.10)



PokerStars Game #20105231093:  Hold'em No Limit ($0.10/$0.25) - 2008/09/02 22:15:49 ET
Table 'Pomona IV' 9-max Seat #7 is the button
Seat 1: Bobby1776 ($26.90 in chips) 
Seat 2: MissStax ($38.90 in chips) 
Seat 3: Brainstew88 ($5.90 in chips) 
Seat 4: Barracuda B ($8.80 in chips) 
Seat 5: Lemarquis1 ($19.35 in chips) 
Seat 6: aintitkewl ($25 in chips) 
Seat 7: Alameda22 ($30.25 in chips) 
Seat 9: LAultima666 ($10.60 in chips) 
LAultima666: posts small blind $0.10
Bobby1776: posts big blind $0.25
*** HOLE CARDS ***
Dealt to Alameda22 [4d 7d]
MissStax: folds 
Brainstew88: calls $0.25
Barracuda B: calls $0.25
Lemarquis1: folds 
aintitkewl: folds 
Alameda22: folds 
LAultima666: calls $0.15
Bobby1776: checks 
*** FLOP *** [3d Td 2h]
LAultima666: checks 
PokerStud_A8 joins the table at seat #8 
Bobby1776: checks 
Brainstew88: checks 
Barracuda B: bets $4.50
LAultima666: folds 
Lemarquis1 leaves the table
Bobby1776 said, "got the two??"
Bobby1776: folds 
Brainstew88: folds 
Uncalled bet ($4.50) returned to Barracuda B
Barracuda B collected $0.95 from pot
*** SUMMARY ***
Total pot $1 | Rake $0.05 
Board [3d Td 2h]
Seat 1: Bobby1776 (big blind) folded on the Flop
Seat 2: MissStax folded before Flop (didn't bet)
Seat 3: Brainstew88 folded on the Flop
Seat 4: Barracuda B collected ($0.95)
Seat 5: Lemarquis1 folded before Flop (didn't bet)
Seat 6: aintitkewl folded before Flop (didn't bet)
Seat 7: Alameda22 (button) folded before Flop (didn't bet)
Seat 9: LAultima666 (small blind) folded on the Flop



PokerStars Game #20105260121:  Hold'em No Limit ($0.10/$0.25) - 2008/09/02 22:17:09 ET
Table 'Pomona IV' 9-max Seat #9 is the button
Seat 1: Bobby1776 ($26.65 in chips) 
Seat 2: MissStax ($38.90 in chips) 
Seat 3: Brainstew88 ($5.65 in chips) 
Seat 4: Barracuda B ($9.50 in chips) 
Seat 6: aintitkewl ($25 in chips) 
Seat 7: Alameda22 ($30.25 in chips) 
Seat 9: LAultima666 ($10.35 in chips) 
Bobby1776: posts small blind $0.10
MissStax: posts big blind $0.25
PokerStud_A8: sits out 
*** HOLE CARDS ***
Dealt to Alameda22 [9h 3h]
Brainstew88: calls $0.25
Barracuda B: raises $0.75 to $1
aintitkewl: folds 
Alameda22: folds 
LAultima666: folds 
Bobby1776: folds 
MissStax: folds 
Brainstew88: calls $0.75
*** FLOP *** [7c 4d 3s]
Brainstew88: bets $0.25
Barracuda B: raises $4.50 to $4.75
Brainstew88: folds 
Uncalled bet ($4.50) returned to Barracuda B
Barracuda B collected $2.75 from pot
*** SUMMARY ***
Total pot $2.85 | Rake $0.10 
Board [7c 4d 3s]
Seat 1: Bobby1776 (small blind) folded before Flop
Seat 2: MissStax (big blind) folded before Flop
Seat 3: Brainstew88 folded on the Flop
Seat 4: Barracuda B collected ($2.75)
Seat 6: aintitkewl folded before Flop (didn't bet)
Seat 7: Alameda22 folded before Flop (didn't bet)
Seat 9: LAultima666 (button) folded before Flop (didn't bet)



PokerStars Game #20105284142:  Hold'em No Limit ($0.10/$0.25) - 2008/09/02 22:18:14 ET
Table 'Pomona IV' 9-max Seat #1 is the button
Seat 1: Bobby1776 ($26.55 in chips) 
Seat 2: MissStax ($38.65 in chips) 
Seat 3: Brainstew88 ($4.40 in chips) 
Seat 4: Barracuda B ($11 in chips) 
Seat 6: aintitkewl ($25 in chips) 
Seat 7: Alameda22 ($30.25 in chips) 
Seat 9: LAultima666 ($10.35 in chips) 
MissStax: posts small blind $0.10
Brainstew88: posts big blind $0.25
PokerStud_A8: sits out 
*** HOLE CARDS ***
Dealt to Alameda22 [6h 4c]
Barracuda B: folds 
aintitkewl: folds 
Alameda22: folds 
LAultima666: calls $0.25
Bobby1776: raises $0.50 to $0.75
MissStax: folds 
Brainstew88: folds 
LAultima666: calls $0.50
*** FLOP *** [Ad Ts Jc]
LAultima666: checks 
Bobby1776: bets $0.50
LAultima666: calls $0.50
*** TURN *** [Ad Ts Jc] [5h]
LAultima666: checks 
Bobby1776: checks 
*** RIVER *** [Ad Ts Jc 5h] [2d]
LAultima666: bets $0.75
Bobby1776: calls $0.75
*** SHOW DOWN ***
LAultima666: shows [7c Qc] (high card Ace)
Bobby1776: shows [Kc Jh] (a pair of Jacks)
Bobby1776 collected $4.15 from pot
*** SUMMARY ***
Total pot $4.35 | Rake $0.20 
Board [Ad Ts Jc 5h 2d]
Seat 1: Bobby1776 (button) showed [Kc Jh] and won ($4.15) with a pair of Jacks
Seat 2: MissStax (small blind) folded before Flop
Seat 3: Brainstew88 (big blind) folded before Flop
Seat 4: Barracuda B folded before Flop (didn't bet)
Seat 6: aintitkewl folded before Flop (didn't bet)
Seat 7: Alameda22 folded before Flop (didn't bet)
Seat 9: LAultima666 showed [7c Qc] and lost with high card Ace



PokerStars Game #20105305567:  Hold'em No Limit ($0.10/$0.25) - 2008/09/02 22:19:12 ET
Table 'Pomona IV' 9-max Seat #2 is the button
Seat 1: Bobby1776 ($28.70 in chips) 
Seat 2: MissStax ($38.55 in chips) 
Seat 3: Brainstew88 ($4.15 in chips) 
Seat 4: Barracuda B ($11 in chips) 
Seat 6: aintitkewl ($25 in chips) 
Seat 7: Alameda22 ($30.25 in chips) 
Seat 9: LAultima666 ($8.35 in chips) 
Brainstew88: posts small blind $0.10
Barracuda B: posts big blind $0.25
PokerStud_A8: sits out 
*** HOLE CARDS ***
Dealt to Alameda22 [3s Td]
aintitkewl: folds 
JOWbudman joins the table at seat #5 
Alameda22: folds 
LAultima666: folds 
Bobby1776: raises $0.50 to $0.75
MissStax: folds 
Brainstew88: folds 
Barracuda B: calls $0.50
*** FLOP *** [Ad 9s Ac]
Barracuda B: checks 
Bobby1776: checks 
*** TURN *** [Ad 9s Ac] [Qs]
Barracuda B: checks 
Bobby1776: bets $0.75
Barracuda B: folds 
Uncalled bet ($0.75) returned to Bobby1776
Bobby1776 collected $1.55 from pot
Bobby1776: doesn't show hand 
*** SUMMARY ***
Total pot $1.60 | Rake $0.05 
Board [Ad 9s Ac Qs]
Seat 1: Bobby1776 collected ($1.55)
Seat 2: MissStax (button) folded before Flop (didn't bet)
Seat 3: Brainstew88 (small blind) folded before Flop
Seat 4: Barracuda B (big blind) folded on the Turn
Seat 6: aintitkewl folded before Flop (didn't bet)
Seat 7: Alameda22 folded before Flop (didn't bet)
Seat 9: LAultima666 folded before Flop (didn't bet)



PokerStars Game #20105331388:  Hold'em No Limit ($0.10/$0.25) - 2008/09/02 22:20:23 ET
Table 'Pomona IV' 9-max Seat #3 is the button
Seat 1: Bobby1776 ($29.50 in chips) 
Seat 2: MissStax ($38.55 in chips) 
Seat 3: Brainstew88 ($4.05 in chips) 
Seat 4: Barracuda B ($10.25 in chips) 
Seat 5: JOWbudman ($15 in chips) 
Seat 6: aintitkewl ($25 in chips) 
Seat 7: Alameda22 ($30.25 in chips) 
Seat 9: LAultima666 ($8.35 in chips) 
Barracuda B: posts small blind $0.10
JOWbudman: posts big blind $0.25
PokerStud_A8: is sitting out 
PokerStud_A8 leaves the table
*** HOLE CARDS ***
Dealt to Alameda22 [Ah Td]
aintitkewl: folds 
Alameda22: folds 
LAultima666: folds 
Bobby1776: raises $0.50 to $0.75
MissStax: folds 
Brainstew88: folds 
Barracuda B: calls $0.65
JOWbudman: folds 
*** FLOP *** [Kc 4s 3s]
Barracuda B: bets $1
Bobby1776: calls $1
*** TURN *** [Kc 4s 3s] [2d]
jasons0147 joins the table at seat #8 
Barracuda B: bets $4
Bobby1776: folds 
Uncalled bet ($4) returned to Barracuda B
Barracuda B collected $3.60 from pot
*** SUMMARY ***
Total pot $3.75 | Rake $0.15 
Board [Kc 4s 3s 2d]
Seat 1: Bobby1776 folded on the Turn
Seat 2: MissStax folded before Flop (didn't bet)
Seat 3: Brainstew88 (button) folded before Flop (didn't bet)
Seat 4: Barracuda B (small blind) collected ($3.60)
Seat 5: JOWbudman (big blind) folded before Flop
Seat 6: aintitkewl folded before Flop (didn't bet)
Seat 7: Alameda22 folded before Flop (didn't bet)
Seat 9: LAultima666 folded before Flop (didn't bet)



PokerStars Game #20105358154:  Hold'em No Limit ($0.10/$0.25) - 2008/09/02 22:21:35 ET
Table 'Pomona IV' 9-max Seat #4 is the button
Seat 1: Bobby1776 ($27.75 in chips) 
Seat 2: MissStax ($38.55 in chips) 
Seat 3: Brainstew88 ($4.05 in chips) 
Seat 4: Barracuda B ($12.10 in chips) 
Seat 5: JOWbudman ($14.75 in chips) 
Seat 6: aintitkewl ($25 in chips) 
Seat 7: Alameda22 ($30.25 in chips) 
Seat 9: LAultima666 ($8.35 in chips) 
JOWbudman: posts small blind $0.10
aintitkewl: posts big blind $0.25
jasons0147: sits out 
*** HOLE CARDS ***
Dealt to Alameda22 [6c Qd]
Alameda22: folds 
LAultima666: folds 
Bobby1776: folds 
MissStax: folds 
Brainstew88: raises $0.25 to $0.50
Barracuda B: calls $0.50
JOWbudman: folds 
aintitkewl: calls $0.25
*** FLOP *** [4h 9h As]
aintitkewl: checks 
Brainstew88: bets $0.50
Barracuda B: calls $0.50
aintitkewl: folds 
*** TURN *** [4h 9h As] [8h]
Brainstew88: bets $1
Barracuda B: folds 
Uncalled bet ($1) returned to Brainstew88
Brainstew88 collected $2.50 from pot
Brainstew88: doesn't show hand 
*** SUMMARY ***
Total pot $2.60 | Rake $0.10 
Board [4h 9h As 8h]
Seat 1: Bobby1776 folded before Flop (didn't bet)
Seat 2: MissStax folded before Flop (didn't bet)
Seat 3: Brainstew88 collected ($2.50)
Seat 4: Barracuda B (button) folded on the Turn
Seat 5: JOWbudman (small blind) folded before Flop
Seat 6: aintitkewl (big blind) folded on the Flop
Seat 7: Alameda22 folded before Flop (didn't bet)
Seat 9: LAultima666 folded before Flop (didn't bet)



PokerStars Game #20105386644:  Hold'em No Limit ($0.10/$0.25) - 2008/09/02 22:22:52 ET
Table 'Pomona IV' 9-max Seat #5 is the button
Seat 1: Bobby1776 ($27.75 in chips) 
Seat 2: MissStax ($38.55 in chips) 
Seat 3: Brainstew88 ($5.55 in chips) 
Seat 4: Barracuda B ($11.10 in chips) 
Seat 5: JOWbudman ($14.65 in chips) 
Seat 6: aintitkewl ($24.50 in chips) 
Seat 7: Alameda22 ($30.25 in chips) 
Seat 9: LAultima666 ($8.35 in chips) 
aintitkewl: posts small blind $0.10
Alameda22: posts big blind $0.25
jasons0147: sits out 
*** HOLE CARDS ***
Dealt to Alameda22 [6h 8h]
LAultima666: calls $0.25
Bobby1776: raises $0.50 to $0.75
MissStax: raises $1.25 to $2
Brainstew88: folds 
Barracuda B: folds 
JOWbudman: folds 
aintitkewl: folds 
Alameda22: folds 
LAultima666: folds 
Bobby1776: folds 
Uncalled bet ($1.25) returned to MissStax
MissStax collected $2.10 from pot
MissStax: doesn't show hand 
*** SUMMARY ***
Total pot $2.10 | Rake $0 
Seat 1: Bobby1776 folded before Flop
Seat 2: MissStax collected ($2.10)
Seat 3: Brainstew88 folded before Flop (didn't bet)
Seat 4: Barracuda B folded before Flop (didn't bet)
Seat 5: JOWbudman (button) folded before Flop (didn't bet)
Seat 6: aintitkewl (small blind) folded before Flop
Seat 7: Alameda22 (big blind) folded before Flop
Seat 9: LAultima666 folded before Flop



PokerStars Game #20105403774:  Hold'em No Limit ($0.10/$0.25) - 2008/09/02 22:23:39 ET
Table 'Pomona IV' 9-max Seat #6 is the button
Seat 1: Bobby1776 ($27 in chips) 
Seat 2: MissStax ($39.90 in chips) 
Seat 3: Brainstew88 ($5.55 in chips) 
Seat 4: Barracuda B ($11.10 in chips) 
Seat 5: JOWbudman ($14.65 in chips) 
Seat 6: aintitkewl ($24.40 in chips) 
Seat 7: Alameda22 ($30 in chips) 
Seat 8: jasons0147 ($27.70 in chips) 
Seat 9: LAultima666 ($8.10 in chips) 
Alameda22: posts small blind $0.10
LAultima666 said, "zzzzzzzzzzzzzzzzzzzzzzzz"
jasons0147: posts big blind $0.25
*** HOLE CARDS ***
Dealt to Alameda22 [3c Jc]
LAultima666: folds 
Bobby1776: raises $0.50 to $0.75
MissStax: folds 
LAultima666 leaves the table
Brainstew88: calls $0.75
Vino_Kulafu joins the table at seat #9 
Barracuda B: folds 
JOWbudman: calls $0.75
aintitkewl: folds 
Alameda22: folds 
jasons0147: folds 
*** FLOP *** [5c Ah 3h]
Bobby1776: bets $1.75
Brainstew88: calls $1.75
JOWbudman: folds 
*** TURN *** [5c Ah 3h] [Kh]
Bobby1776: checks 
Brainstew88: bets $3.05 and is all-in
Bobby1776: folds 
Uncalled bet ($3.05) returned to Brainstew88
Brainstew88 collected $5.80 from pot
Brainstew88: doesn't show hand 
*** SUMMARY ***
Total pot $6.10 | Rake $0.30 
Board [5c Ah 3h Kh]
Seat 1: Bobby1776 folded on the Turn
Seat 2: MissStax folded before Flop (didn't bet)
Seat 3: Brainstew88 collected ($5.80)
Seat 4: Barracuda B folded before Flop (didn't bet)
Seat 5: JOWbudman folded on the Flop
Seat 6: aintitkewl (button) folded before Flop (didn't bet)
Seat 7: Alameda22 (small blind) folded before Flop
Seat 8: jasons0147 (big blind) folded before Flop
Seat 9: LAultima666 folded before Flop (didn't bet)



PokerStars Game #20105437126:  Hold'em No Limit ($0.10/$0.25) - 2008/09/02 22:25:09 ET
Table 'Pomona IV' 9-max Seat #7 is the button
Seat 1: Bobby1776 ($24.50 in chips) 
Seat 2: MissStax ($39.90 in chips) 
Seat 3: Brainstew88 ($8.85 in chips) 
Seat 4: Barracuda B ($11.10 in chips) 
Seat 5: JOWbudman ($13.90 in chips) 
Seat 6: aintitkewl ($24.40 in chips) 
Seat 7: Alameda22 ($29.90 in chips) 
Seat 8: jasons0147 ($27.45 in chips) 
Seat 9: Vino_Kulafu ($15 in chips) 
jasons0147: posts small blind $0.10
Vino_Kulafu: posts big blind $0.25
*** HOLE CARDS ***
Dealt to Alameda22 [Jh Td]
Bobby1776: folds 
MissStax: folds 
MissStax leaves the table
Brainstew88: calls $0.25
Barracuda B: calls $0.25
JOWbudman: folds 
aintitkewl: folds 
Alameda22: folds 
jasons0147: folds 
Vino_Kulafu: checks 
*** FLOP *** [Qh As 8d]
Vino_Kulafu: checks 
Brainstew88: checks 
Barracuda B: checks 
*** TURN *** [Qh As 8d] [2s]
Vino_Kulafu: checks 
Brainstew88: checks 
Barracuda B: checks 
*** RIVER *** [Qh As 8d 2s] [Ad]
Vino_Kulafu: checks 
Brainstew88: bets $0.50
Barracuda B: raises $1 to $1.50
Vino_Kulafu: folds 
yjqian23 joins the table at seat #2 
Brainstew88: calls $1
*** SHOW DOWN ***
Barracuda B: shows [3s 3h] (two pair, Aces and Threes)
Brainstew88: shows [7s 7h] (two pair, Aces and Sevens)
Brainstew88 collected $3.70 from pot
*** SUMMARY ***
Total pot $3.85 | Rake $0.15 
Board [Qh As 8d 2s Ad]
Seat 1: Bobby1776 folded before Flop (didn't bet)
Seat 2: MissStax folded before Flop (didn't bet)
Seat 3: Brainstew88 showed [7s 7h] and won ($3.70) with two pair, Aces and Sevens
Seat 4: Barracuda B showed [3s 3h] and lost with two pair, Aces and Threes
Seat 5: JOWbudman folded before Flop (didn't bet)
Seat 6: aintitkewl folded before Flop (didn't bet)
Seat 7: Alameda22 (button) folded before Flop (didn't bet)
Seat 8: jasons0147 (small blind) folded before Flop
Seat 9: Vino_Kulafu (big blind) folded on the River



PokerStars Game #20105469504:  Hold'em No Limit ($0.10/$0.25) - 2008/09/02 22:26:38 ET
Table 'Pomona IV' 9-max Seat #8 is the button
Seat 1: Bobby1776 ($24.50 in chips) 
Seat 3: Brainstew88 ($10.80 in chips) 
Seat 4: Barracuda B ($9.35 in chips) 
Seat 5: JOWbudman ($13.90 in chips) 
Seat 6: aintitkewl ($24.40 in chips) 
Seat 7: Alameda22 ($29.90 in chips) 
Seat 8: jasons0147 ($27.35 in chips) 
Seat 9: Vino_Kulafu ($14.75 in chips) 
Vino_Kulafu: posts small blind $0.10
Bobby1776: posts big blind $0.25
yjqian23: sits out 
*** HOLE CARDS ***
Dealt to Alameda22 [Th 3c]
Brainstew88: folds 
Barracuda B: calls $0.25
JOWbudman: raises $0.25 to $0.50
aintitkewl: folds 
Alameda22: folds 
jasons0147: folds 
Vino_Kulafu: folds 
Bobby1776: raises $0.50 to $1
Barracuda B: calls $0.75
JOWbudman: calls $0.50
*** FLOP *** [5s Qc 7d]
Bobby1776: bets $2.50
Barracuda B: folds 
JOWbudman: folds 
Uncalled bet ($2.50) returned to Bobby1776
Bobby1776 collected $2.95 from pot
Bobby1776: doesn't show hand 
*** SUMMARY ***
Total pot $3.10 | Rake $0.15 
Board [5s Qc 7d]
Seat 1: Bobby1776 (big blind) collected ($2.95)
Seat 3: Brainstew88 folded before Flop (didn't bet)
Seat 4: Barracuda B folded on the Flop
Seat 5: JOWbudman folded on the Flop
Seat 6: aintitkewl folded before Flop (didn't bet)
Seat 7: Alameda22 folded before Flop (didn't bet)
Seat 8: jasons0147 (button) folded before Flop (didn't bet)
Seat 9: Vino_Kulafu (small blind) folded before Flop



PokerStars Game #20105504424:  Hold'em No Limit ($0.10/$0.25) - 2008/09/02 22:28:13 ET
Table 'Pomona IV' 9-max Seat #9 is the button
Seat 1: Bobby1776 ($26.45 in chips) 
Seat 2: yjqian23 ($25 in chips) 
Seat 3: Brainstew88 ($10.80 in chips) 
Seat 4: Barracuda B ($8.35 in chips) 
Seat 5: JOWbudman ($12.90 in chips) 
Seat 6: aintitkewl ($24.40 in chips) 
Seat 7: Alameda22 ($29.90 in chips) 
Seat 8: jasons0147 ($27.35 in chips) 
Seat 9: Vino_Kulafu ($14.65 in chips) 
Bobby1776: posts small blind $0.10
yjqian23: posts big blind $0.25
*** HOLE CARDS ***
Dealt to Alameda22 [4c 7s]
Brainstew88: folds 
Brainstew88 is sitting out
Barracuda B: raises $0.75 to $1
JOWbudman: folds 
aintitkewl: folds 
Brainstew88 leaves the table
Alameda22: folds 
jasons0147: folds 
Vino_Kulafu: folds 
Bobby1776: calls $0.90
Bhaphom3t joins the table at seat #3 
yjqian23: folds 
*** FLOP *** [5c 8h Kd]
Bobby1776: checks 
Barracuda B: bets $2
Bobby1776: folds 
Uncalled bet ($2) returned to Barracuda B
Barracuda B collected $2.15 from pot
*** SUMMARY ***
Total pot $2.25 | Rake $0.10 
Board [5c 8h Kd]
Seat 1: Bobby1776 (small blind) folded on the Flop
Seat 2: yjqian23 (big blind) folded before Flop
Seat 3: Brainstew88 folded before Flop (didn't bet)
Seat 4: Barracuda B collected ($2.15)
Seat 5: JOWbudman folded before Flop (didn't bet)
Seat 6: aintitkewl folded before Flop (didn't bet)
Seat 7: Alameda22 folded before Flop (didn't bet)
Seat 8: jasons0147 folded before Flop (didn't bet)
Seat 9: Vino_Kulafu (button) folded before Flop (didn't bet)



