PokerStars Game #19973856347:  Hold'em No Limit ($0.10/$0.25) - 2008/08/28 - 19:11:38 (ET)
Table 'Hippasos IV' 9-max Seat #3 is the button
Seat 1: HammettBets ($17.10 in chips) 
Seat 2: Poker Barrie ($54.95 in chips) 
Seat 3: phillme13 ($23.60 in chips) 
Seat 6: Mrinaldi ($17.20 in chips) 
Seat 7: Alameda22 ($25 in chips) 
Seat 8: jaydubya ($8.65 in chips) 
Seat 9: ssp25 ($24.95 in chips) 
momocgn will be allowed to play after the button
davkan will be allowed to play after the button
Mrinaldi: posts small blind $0.10
Alameda22: posts big blind $0.25
*** HOLE CARDS ***
Dealt to Alameda22 [9h Qs]
jaydubya: folds 
ssp25: folds 
HammettBets: folds 
Poker Barrie: folds 
phillme13: folds 
Mrinaldi: folds 
Uncalled bet ($0.15) returned to Alameda22
Alameda22 collected $0.20 from pot
Alameda22: doesn't show hand 
*** SUMMARY ***
Total pot $0.20 | Rake $0 
Seat 1: HammettBets folded before Flop (didn't bet)
Seat 2: Poker Barrie folded before Flop (didn't bet)
Seat 3: phillme13 (button) folded before Flop (didn't bet)
Seat 6: Mrinaldi (small blind) folded before Flop
Seat 7: Alameda22 (big blind) collected ($0.20)
Seat 8: jaydubya folded before Flop (didn't bet)
Seat 9: ssp25 folded before Flop (didn't bet)



PokerStars Game #19973867607:  Hold'em No Limit ($0.10/$0.25) - 2008/08/28 - 19:12:08 (ET)
Table 'Hippasos IV' 9-max Seat #6 is the button
Seat 1: HammettBets ($17.10 in chips) 
Seat 2: Poker Barrie ($54.95 in chips) 
Seat 3: phillme13 ($23.60 in chips) 
Seat 4: momocgn ($4.75 in chips) 
Seat 5: davkan ($25 in chips) 
Seat 6: Mrinaldi ($17.10 in chips) 
Seat 7: Alameda22 ($25.10 in chips) 
Seat 8: jaydubya ($8.65 in chips) 
Seat 9: ssp25 ($24.95 in chips) 
Alameda22: posts small blind $0.10
jaydubya: posts big blind $0.25
momocgn: posts small & big blinds $0.35
davkan: posts big blind $0.25
*** HOLE CARDS ***
Dealt to Alameda22 [Js 9s]
ssp25: folds 
HammettBets: folds 
Poker Barrie: raises $0.75 to $1
phillme13: folds 
momocgn: folds 
davkan: calls $0.75
Mrinaldi: folds 
Alameda22: folds 
jaydubya: folds 
*** FLOP *** [4d Ah 5d]
Poker Barrie: bets $0.75
davkan: raises $1.25 to $2
Poker Barrie: calls $1.25
*** TURN *** [4d Ah 5d] [5h]
Poker Barrie: checks 
davkan: bets $2.25
Poker Barrie: folds 
Uncalled bet ($2.25) returned to davkan
davkan collected $6.40 from pot
davkan: doesn't show hand 
*** SUMMARY ***
Total pot $6.70 | Rake $0.30 
Board [4d Ah 5d 5h]
Seat 1: HammettBets folded before Flop (didn't bet)
Seat 2: Poker Barrie folded on the Turn
Seat 3: phillme13 folded before Flop (didn't bet)
Seat 4: momocgn folded before Flop
Seat 5: davkan collected ($6.40)
Seat 6: Mrinaldi (button) folded before Flop (didn't bet)
Seat 7: Alameda22 (small blind) folded before Flop
Seat 8: jaydubya (big blind) folded before Flop
Seat 9: ssp25 folded before Flop (didn't bet)



PokerStars Game #19973901778:  Hold'em No Limit ($0.10/$0.25) - 2008/08/28 - 19:13:41 (ET)
Table 'Hippasos IV' 9-max Seat #7 is the button
Seat 1: HammettBets ($17.10 in chips) 
Seat 2: Poker Barrie ($51.95 in chips) 
Seat 3: phillme13 ($23.60 in chips) 
Seat 4: momocgn ($4.40 in chips) 
Seat 5: davkan ($28.40 in chips) 
Seat 6: Mrinaldi ($17.10 in chips) 
Seat 7: Alameda22 ($25 in chips) 
Seat 8: jaydubya ($8.40 in chips) 
Seat 9: ssp25 ($24.95 in chips) 
jaydubya: posts small blind $0.10
ssp25: posts big blind $0.25
*** HOLE CARDS ***
Dealt to Alameda22 [4c 6c]
HammettBets: raises $0.25 to $0.50
Poker Barrie: calls $0.50
phillme13: calls $0.50
momocgn: folds 
davkan: calls $0.50
Mrinaldi: folds 
Alameda22: folds 
jaydubya: folds 
ssp25: folds 
*** FLOP *** [9s Ts Jh]
HammettBets: checks 
Poker Barrie: bets $1
phillme13: folds 
davkan: calls $1
HammettBets: folds 
*** TURN *** [9s Ts Jh] [6h]
Poker Barrie: bets $1
davkan: calls $1
*** RIVER *** [9s Ts Jh 6h] [Qd]
Poker Barrie: bets $1
davkan: calls $1
*** SHOW DOWN ***
Poker Barrie: shows [9d 8c] (a straight, Eight to Queen)
davkan: mucks hand 
Poker Barrie collected $7.95 from pot
*** SUMMARY ***
Total pot $8.35 | Rake $0.40 
Board [9s Ts Jh 6h Qd]
Seat 1: HammettBets folded on the Flop
Seat 2: Poker Barrie showed [9d 8c] and won ($7.95) with a straight, Eight to Queen
Seat 3: phillme13 folded on the Flop
Seat 4: momocgn folded before Flop (didn't bet)
Seat 5: davkan mucked [Qc As]
Seat 6: Mrinaldi folded before Flop (didn't bet)
Seat 7: Alameda22 (button) folded before Flop (didn't bet)
Seat 8: jaydubya (small blind) folded before Flop
Seat 9: ssp25 (big blind) folded before Flop



PokerStars Game #19973932318:  Hold'em No Limit ($0.10/$0.25) - 2008/08/28 - 19:15:04 (ET)
Table 'Hippasos IV' 9-max Seat #8 is the button
Seat 1: HammettBets ($16.60 in chips) 
Seat 2: Poker Barrie ($56.40 in chips) 
Seat 3: phillme13 ($23.10 in chips) 
Seat 4: momocgn ($5 in chips) 
Seat 5: davkan ($24.90 in chips) 
Seat 6: Mrinaldi ($17.10 in chips) 
Seat 7: Alameda22 ($25 in chips) 
Seat 8: jaydubya ($8.30 in chips) 
Seat 9: ssp25 ($24.70 in chips) 
ssp25: posts small blind $0.10
HammettBets: posts big blind $0.25
*** HOLE CARDS ***
Dealt to Alameda22 [9h 2h]
Poker Barrie: folds 
phillme13: folds 
momocgn: folds 
davkan: folds 
Mrinaldi: calls $0.25
Alameda22: folds 
jaydubya: folds 
ssp25: calls $0.15
HammettBets: checks 
*** FLOP *** [4c Jc 8s]
ssp25: checks 
HammettBets: checks 
Mrinaldi: bets $0.75
ssp25: folds 
HammettBets: folds 
Uncalled bet ($0.75) returned to Mrinaldi
Mrinaldi collected $0.75 from pot
Mrinaldi: doesn't show hand 
*** SUMMARY ***
Total pot $0.75 | Rake $0 
Board [4c Jc 8s]
Seat 1: HammettBets (big blind) folded on the Flop
Seat 2: Poker Barrie folded before Flop (didn't bet)
Seat 3: phillme13 folded before Flop (didn't bet)
Seat 4: momocgn folded before Flop (didn't bet)
Seat 5: davkan folded before Flop (didn't bet)
Seat 6: Mrinaldi collected ($0.75)
Seat 7: Alameda22 folded before Flop (didn't bet)
Seat 8: jaydubya (button) folded before Flop (didn't bet)
Seat 9: ssp25 (small blind) folded on the Flop



PokerStars Game #19973961507:  Hold'em No Limit ($0.10/$0.25) - 2008/08/28 - 19:16:24 (ET)
Table 'Hippasos IV' 9-max Seat #9 is the button
Seat 1: HammettBets ($16.35 in chips) 
Seat 2: Poker Barrie ($56.40 in chips) 
Seat 3: phillme13 ($23.10 in chips) 
Seat 4: momocgn ($5 in chips) 
Seat 5: davkan ($24.90 in chips) 
Seat 6: Mrinaldi ($17.60 in chips) 
Seat 7: Alameda22 ($25 in chips) 
Seat 8: jaydubya ($8.30 in chips) 
Seat 9: ssp25 ($24.45 in chips) 
HammettBets: posts small blind $0.10
Poker Barrie: posts big blind $0.25
*** HOLE CARDS ***
Dealt to Alameda22 [Ts Th]
phillme13: calls $0.25
momocgn: folds 
davkan: folds 
davkan leaves the table
Mrinaldi: raises $0.50 to $0.75
Alameda22: calls $0.75
Valezius joins the table at seat #5 
jaydubya: folds 
ssp25: folds 
HammettBets: folds 
Poker Barrie: calls $0.50
phillme13: calls $0.50
*** FLOP *** [3d 8s Jd]
Poker Barrie: checks 
phillme13: checks 
Mrinaldi: checks 
Alameda22: bets $2
Poker Barrie: calls $2
phillme13: raises $4 to $6
Mrinaldi: folds 
Alameda22: folds 
Poker Barrie: calls $4
*** TURN *** [3d 8s Jd] [4h]
Poker Barrie: checks 
phillme13: bets $9.50
Poker Barrie: folds 
Uncalled bet ($9.50) returned to phillme13
phillme13 collected $16.30 from pot
phillme13 is sitting out
phillme13: doesn't show hand 
*** SUMMARY ***
Total pot $17.10 | Rake $0.80 
Board [3d 8s Jd 4h]
Seat 1: HammettBets (small blind) folded before Flop
Seat 2: Poker Barrie (big blind) folded on the Turn
Seat 3: phillme13 collected ($16.30)
Seat 4: momocgn folded before Flop (didn't bet)
Seat 5: davkan folded before Flop (didn't bet)
Seat 6: Mrinaldi folded on the Flop
Seat 7: Alameda22 folded on the Flop
Seat 8: jaydubya folded before Flop (didn't bet)
Seat 9: ssp25 (button) folded before Flop (didn't bet)



PokerStars Game #19973996804:  Hold'em No Limit ($0.10/$0.25) - 2008/08/28 - 19:18:00 (ET)
Table 'Hippasos IV' 9-max Seat #1 is the button
Seat 1: HammettBets ($16.25 in chips) 
Seat 2: Poker Barrie ($49.65 in chips) 
Seat 4: momocgn ($5 in chips) 
Seat 6: Mrinaldi ($16.85 in chips) 
Seat 7: Alameda22 ($22.25 in chips) 
Seat 8: jaydubya ($8.30 in chips) 
Seat 9: ssp25 ($24.45 in chips) 
Poker Barrie: posts small blind $0.10
momocgn: posts big blind $0.25
Valezius: sits out 
*** HOLE CARDS ***
Dealt to Alameda22 [7c 4d]
Mrinaldi: folds 
Alameda22: folds 
jaydubya: calls $0.25
ssp25: folds 
HammettBets: raises $0.50 to $0.75
Poker Barrie: folds 
momocgn: folds 
jaydubya: calls $0.50
*** FLOP *** [7s 9h Ac]
jaydubya: checks 
HammettBets: bets $1
jaydubya: calls $1
*** TURN *** [7s 9h Ac] [Jh]
jaydubya: checks 
HammettBets: checks 
*** RIVER *** [7s 9h Ac Jh] [6d]
jaydubya: checks 
HammettBets: checks 
*** SHOW DOWN ***
jaydubya: shows [9d Td] (a pair of Nines)
HammettBets: shows [Tc Ts] (a pair of Tens)
HammettBets collected $3.70 from pot
*** SUMMARY ***
Total pot $3.85 | Rake $0.15 
Board [7s 9h Ac Jh 6d]
Seat 1: HammettBets (button) showed [Tc Ts] and won ($3.70) with a pair of Tens
Seat 2: Poker Barrie (small blind) folded before Flop
Seat 4: momocgn (big blind) folded before Flop
Seat 6: Mrinaldi folded before Flop (didn't bet)
Seat 7: Alameda22 folded before Flop (didn't bet)
Seat 8: jaydubya showed [9d Td] and lost with a pair of Nines
Seat 9: ssp25 folded before Flop (didn't bet)



PokerStars Game #19974017447:  Hold'em No Limit ($0.10/$0.25) - 2008/08/28 - 19:18:56 (ET)
Table 'Hippasos IV' 9-max Seat #2 is the button
Seat 1: HammettBets ($18.20 in chips) 
Seat 2: Poker Barrie ($49.55 in chips) 
Seat 4: momocgn ($4.75 in chips) 
Seat 5: Valezius ($5 in chips) 
Seat 6: Mrinaldi ($16.85 in chips) 
Seat 7: Alameda22 ($22.25 in chips) 
Seat 8: jaydubya ($6.55 in chips) 
Seat 9: ssp25 ($24.45 in chips) 
momocgn: posts small blind $0.10
Valezius: posts big blind $0.25
*** HOLE CARDS ***
Dealt to Alameda22 [As 6h]
Mrinaldi: folds 
Alameda22: folds 
jaydubya: folds 
ssp25: folds 
HammettBets: folds 
Poker Barrie: raises $0.75 to $1
momocgn: folds 
Valezius: folds 
Uncalled bet ($0.75) returned to Poker Barrie
Poker Barrie collected $0.60 from pot
Poker Barrie: doesn't show hand 
*** SUMMARY ***
Total pot $0.60 | Rake $0 
Seat 1: HammettBets folded before Flop (didn't bet)
Seat 2: Poker Barrie (button) collected ($0.60)
Seat 4: momocgn (small blind) folded before Flop
Seat 5: Valezius (big blind) folded before Flop
Seat 6: Mrinaldi folded before Flop (didn't bet)
Seat 7: Alameda22 folded before Flop (didn't bet)
Seat 8: jaydubya folded before Flop (didn't bet)
Seat 9: ssp25 folded before Flop (didn't bet)



PokerStars Game #19974040489:  Hold'em No Limit ($0.10/$0.25) - 2008/08/28 - 19:20:00 (ET)
Table 'Hippasos IV' 9-max Seat #4 is the button
Seat 1: HammettBets ($18.20 in chips) 
Seat 2: Poker Barrie ($49.90 in chips) 
Seat 4: momocgn ($4.65 in chips) 
Seat 5: Valezius ($4.75 in chips) 
Seat 6: Mrinaldi ($16.85 in chips) 
Seat 7: Alameda22 ($22.25 in chips) 
Seat 8: jaydubya ($6.55 in chips) 
Seat 9: ssp25 ($24.45 in chips) 
Valezius: posts small blind $0.10
Mrinaldi: posts big blind $0.25
*** HOLE CARDS ***
Dealt to Alameda22 [Kc Qd]
Alameda22: folds 
jaydubya: folds 
ssp25: folds 
HammettBets: folds 
Poker Barrie: raises $0.75 to $1
momocgn: folds 
Valezius: folds 
Mrinaldi: folds 
Uncalled bet ($0.75) returned to Poker Barrie
Poker Barrie collected $0.60 from pot
Poker Barrie: doesn't show hand 
phillme13 has returned
*** SUMMARY ***
Total pot $0.60 | Rake $0 
Seat 1: HammettBets folded before Flop (didn't bet)
Seat 2: Poker Barrie collected ($0.60)
Seat 4: momocgn (button) folded before Flop (didn't bet)
Seat 5: Valezius (small blind) folded before Flop
Seat 6: Mrinaldi (big blind) folded before Flop
Seat 7: Alameda22 folded before Flop (didn't bet)
Seat 8: jaydubya folded before Flop (didn't bet)
Seat 9: ssp25 folded before Flop (didn't bet)



PokerStars Game #19974054451:  Hold'em No Limit ($0.10/$0.25) - 2008/08/28 - 19:20:38 (ET)
Table 'Hippasos IV' 9-max Seat #5 is the button
Seat 1: HammettBets ($18.20 in chips) 
Seat 2: Poker Barrie ($50.25 in chips) 
Seat 3: phillme13 ($32.65 in chips) 
Seat 4: momocgn ($4.65 in chips) 
Seat 5: Valezius ($4.65 in chips) 
Seat 6: Mrinaldi ($16.60 in chips) 
Seat 7: Alameda22 ($22.25 in chips) 
Seat 8: jaydubya ($6.55 in chips) 
Seat 9: ssp25 ($24.45 in chips) 
Mrinaldi: posts small blind $0.10
Alameda22: posts big blind $0.25
phillme13: posts small & big blinds $0.35
*** HOLE CARDS ***
Dealt to Alameda22 [Kh 5d]
jaydubya: raises $1 to $1.25
ssp25: folds 
HammettBets: folds 
Poker Barrie: folds 
phillme13: folds 
momocgn: folds 
Valezius: folds 
Mrinaldi: folds 
Alameda22: folds 
Uncalled bet ($1) returned to jaydubya
jaydubya collected $0.95 from pot
*** SUMMARY ***
Total pot $0.95 | Rake $0 
Seat 1: HammettBets folded before Flop (didn't bet)
Seat 2: Poker Barrie folded before Flop (didn't bet)
Seat 3: phillme13 folded before Flop
Seat 4: momocgn folded before Flop (didn't bet)
Seat 5: Valezius (button) folded before Flop (didn't bet)
Seat 6: Mrinaldi (small blind) folded before Flop
Seat 7: Alameda22 (big blind) folded before Flop
Seat 8: jaydubya collected ($0.95)
Seat 9: ssp25 folded before Flop (didn't bet)



PokerStars Game #19974065549:  Hold'em No Limit ($0.10/$0.25) - 2008/08/28 - 19:21:08 (ET)
Table 'Hippasos IV' 9-max Seat #6 is the button
Seat 1: HammettBets ($18.20 in chips) 
Seat 2: Poker Barrie ($50.25 in chips) 
Seat 3: phillme13 ($32.30 in chips) 
Seat 4: momocgn ($4.65 in chips) 
Seat 5: Valezius ($4.65 in chips) 
Seat 6: Mrinaldi ($16.50 in chips) 
Seat 7: Alameda22 ($22 in chips) 
Seat 8: jaydubya ($7.25 in chips) 
Seat 9: ssp25 ($24.45 in chips) 
Alameda22: posts small blind $0.10
jaydubya: posts big blind $0.25
*** HOLE CARDS ***
Dealt to Alameda22 [8d Td]
ssp25: folds 
HammettBets: folds 
Poker Barrie: raises $0.75 to $1
phillme13: folds 
momocgn: folds 
Valezius: folds 
Mrinaldi: calls $1
Alameda22: folds 
jaydubya: calls $0.75
*** FLOP *** [Ah Kc Kh]
jaydubya: checks 
Poker Barrie: bets $0.75
Mrinaldi: folds 
jaydubya: raises $5.50 to $6.25 and is all-in
Poker Barrie: calls $5.50
*** TURN *** [Ah Kc Kh] [7s]
*** RIVER *** [Ah Kc Kh 7s] [Jd]
*** SHOW DOWN ***
jaydubya: shows [9d Ad] (two pair, Aces and Kings)
Poker Barrie: shows [As Qc] (two pair, Aces and Kings - Queen kicker)
Poker Barrie collected $14.85 from pot
jaydubya leaves the table
*** SUMMARY ***
Total pot $15.60 | Rake $0.75 
Board [Ah Kc Kh 7s Jd]
Seat 1: HammettBets folded before Flop (didn't bet)
Seat 2: Poker Barrie showed [As Qc] and won ($14.85) with two pair, Aces and Kings
Seat 3: phillme13 folded before Flop (didn't bet)
Seat 4: momocgn folded before Flop (didn't bet)
Seat 5: Valezius folded before Flop (didn't bet)
Seat 6: Mrinaldi (button) folded on the Flop
Seat 7: Alameda22 (small blind) folded before Flop
Seat 8: jaydubya (big blind) showed [9d Ad] and lost with two pair, Aces and Kings
Seat 9: ssp25 folded before Flop (didn't bet)



PokerStars Game #19974086923:  Hold'em No Limit ($0.10/$0.25) - 2008/08/28 - 19:22:08 (ET)
Table 'Hippasos IV' 9-max Seat #7 is the button
Seat 1: HammettBets ($18.20 in chips) 
Seat 2: Poker Barrie ($57.85 in chips) 
Seat 3: phillme13 ($32.30 in chips) 
Seat 4: momocgn ($4.65 in chips) 
Seat 5: Valezius ($4.65 in chips) 
Seat 6: Mrinaldi ($15.50 in chips) 
Seat 7: Alameda22 ($25 in chips) 
Seat 9: ssp25 ($24.45 in chips) 
ssp25: posts small blind $0.10
HammettBets: posts big blind $0.25
*** HOLE CARDS ***
Dealt to Alameda22 [Td Js]
Poker Barrie: folds 
phillme13: folds 
momocgn: folds 
BufordDalt joins the table at seat #8 
Valezius: folds 
Mrinaldi: folds 
Alameda22: raises $0.50 to $0.75
ssp25: folds 
HammettBets: folds 
Uncalled bet ($0.50) returned to Alameda22
Alameda22 collected $0.60 from pot
Alameda22: doesn't show hand 
*** SUMMARY ***
Total pot $0.60 | Rake $0 
Seat 1: HammettBets (big blind) folded before Flop
Seat 2: Poker Barrie folded before Flop (didn't bet)
Seat 3: phillme13 folded before Flop (didn't bet)
Seat 4: momocgn folded before Flop (didn't bet)
Seat 5: Valezius folded before Flop (didn't bet)
Seat 6: Mrinaldi folded before Flop (didn't bet)
Seat 7: Alameda22 (button) collected ($0.60)
Seat 9: ssp25 (small blind) folded before Flop



PokerStars Game #19974098951:  Hold'em No Limit ($0.10/$0.25) - 2008/08/28 - 19:22:41 (ET)
Table 'Hippasos IV' 9-max Seat #9 is the button
Seat 1: HammettBets ($17.95 in chips) 
Seat 2: Poker Barrie ($57.85 in chips) 
Seat 3: phillme13 ($32.30 in chips) 
Seat 4: momocgn ($4.65 in chips) 
Seat 5: Valezius ($4.65 in chips) 
Seat 6: Mrinaldi ($15.50 in chips) 
Seat 7: Alameda22 ($25.35 in chips) 
Seat 9: ssp25 ($24.35 in chips) 
HammettBets: posts small blind $0.10
Poker Barrie: posts big blind $0.25
BufordDalt: sits out 
*** HOLE CARDS ***
Dealt to Alameda22 [4h Qh]
phillme13: folds 
momocgn: folds 
Valezius: folds 
Mrinaldi: folds 
Alameda22: folds 
ssp25: folds 
HammettBets: folds 
Uncalled bet ($0.15) returned to Poker Barrie
Poker Barrie collected $0.20 from pot
Poker Barrie: doesn't show hand 
*** SUMMARY ***
Total pot $0.20 | Rake $0 
Seat 1: HammettBets (small blind) folded before Flop
Seat 2: Poker Barrie (big blind) collected ($0.20)
Seat 3: phillme13 folded before Flop (didn't bet)
Seat 4: momocgn folded before Flop (didn't bet)
Seat 5: Valezius folded before Flop (didn't bet)
Seat 6: Mrinaldi folded before Flop (didn't bet)
Seat 7: Alameda22 folded before Flop (didn't bet)
Seat 9: ssp25 (button) folded before Flop (didn't bet)



PokerStars Game #19974109498:  Hold'em No Limit ($0.10/$0.25) - 2008/08/28 - 19:23:10 (ET)
Table 'Hippasos IV' 9-max Seat #1 is the button
Seat 1: HammettBets ($17.85 in chips) 
Seat 2: Poker Barrie ($57.95 in chips) 
Seat 3: phillme13 ($32.30 in chips) 
Seat 4: momocgn ($4.65 in chips) 
Seat 5: Valezius ($4.65 in chips) 
Seat 6: Mrinaldi ($15.50 in chips) 
Seat 7: Alameda22 ($25.35 in chips) 
Seat 9: ssp25 ($24.35 in chips) 
Poker Barrie: posts small blind $0.10
phillme13: posts big blind $0.25
BufordDalt: sits out 
*** HOLE CARDS ***
Dealt to Alameda22 [8h 3d]
momocgn: folds 
Valezius: raises $0.75 to $1
Mrinaldi: folds 
Alameda22: folds 
ssp25: folds 
HammettBets: folds 
Poker Barrie: folds 
phillme13: calls $0.75
*** FLOP *** [Kc Jc 6h]
phillme13: checks 
Valezius: bets $1.25
phillme13: folds 
Uncalled bet ($1.25) returned to Valezius
Valezius collected $2 from pot
Valezius: doesn't show hand 
*** SUMMARY ***
Total pot $2.10 | Rake $0.10 
Board [Kc Jc 6h]
Seat 1: HammettBets (button) folded before Flop (didn't bet)
Seat 2: Poker Barrie (small blind) folded before Flop
Seat 3: phillme13 (big blind) folded on the Flop
Seat 4: momocgn folded before Flop (didn't bet)
Seat 5: Valezius collected ($2)
Seat 6: Mrinaldi folded before Flop (didn't bet)
Seat 7: Alameda22 folded before Flop (didn't bet)
Seat 9: ssp25 folded before Flop (didn't bet)



PokerStars Game #19974123520:  Hold'em No Limit ($0.10/$0.25) - 2008/08/28 - 19:23:48 (ET)
Table 'Hippasos IV' 9-max Seat #2 is the button
Seat 1: HammettBets ($17.85 in chips) 
Seat 2: Poker Barrie ($57.85 in chips) 
Seat 3: phillme13 ($31.30 in chips) 
Seat 4: momocgn ($4.65 in chips) 
Seat 5: Valezius ($5.65 in chips) 
Seat 6: Mrinaldi ($15.50 in chips) 
Seat 7: Alameda22 ($25.35 in chips) 
Seat 9: ssp25 ($24.35 in chips) 
phillme13: posts small blind $0.10
momocgn: posts big blind $0.25
BufordDalt: sits out 
*** HOLE CARDS ***
Dealt to Alameda22 [Jd 3c]
Valezius: folds 
Mrinaldi: folds 
Alameda22: folds 
ssp25: folds 
HammettBets: folds 
Poker Barrie: folds 
phillme13: calls $0.15
momocgn: checks 
*** FLOP *** [Qd Jh Js]
phillme13: checks 
momocgn: checks 
*** TURN *** [Qd Jh Js] [As]
phillme13: checks 
momocgn: checks 
*** RIVER *** [Qd Jh Js As] [Ac]
phillme13: checks 
momocgn: checks 
*** SHOW DOWN ***
phillme13: shows [4h 7h] (two pair, Aces and Jacks)
momocgn: shows [6s 7c] (two pair, Aces and Jacks)
phillme13 collected $0.25 from pot
momocgn collected $0.25 from pot
*** SUMMARY ***
Total pot $0.50 | Rake $0 
Board [Qd Jh Js As Ac]
Seat 1: HammettBets folded before Flop (didn't bet)
Seat 2: Poker Barrie (button) folded before Flop (didn't bet)
Seat 3: phillme13 (small blind) showed [4h 7h] and won ($0.25) with two pair, Aces and Jacks
Seat 4: momocgn (big blind) showed [6s 7c] and won ($0.25) with two pair, Aces and Jacks
Seat 5: Valezius folded before Flop (didn't bet)
Seat 6: Mrinaldi folded before Flop (didn't bet)
Seat 7: Alameda22 folded before Flop (didn't bet)
Seat 9: ssp25 folded before Flop (didn't bet)



PokerStars Game #19974138580:  Hold'em No Limit ($0.10/$0.25) - 2008/08/28 - 19:24:30 (ET)
Table 'Hippasos IV' 9-max Seat #3 is the button
Seat 1: HammettBets ($17.85 in chips) 
Seat 2: Poker Barrie ($57.85 in chips) 
Seat 3: phillme13 ($31.30 in chips) 
Seat 4: momocgn ($4.65 in chips) 
Seat 5: Valezius ($5.65 in chips) 
Seat 6: Mrinaldi ($15.50 in chips) 
Seat 7: Alameda22 ($25.35 in chips) 
Seat 9: ssp25 ($24.35 in chips) 
momocgn: posts small blind $0.10
Valezius: posts big blind $0.25
BufordDalt: sits out 
*** HOLE CARDS ***
Dealt to Alameda22 [Js Jh]
Mrinaldi: folds 
Alameda22: raises $0.50 to $0.75
ssp25: folds 
HammettBets: folds 
Poker Barrie: folds 
phillme13: calls $0.75
momocgn: folds 
Valezius: folds 
*** FLOP *** [8c 2c 4h]
Alameda22: bets $1.25
phillme13: folds 
Uncalled bet ($1.25) returned to Alameda22
Alameda22 collected $1.80 from pot
Alameda22: doesn't show hand 
*** SUMMARY ***
Total pot $1.85 | Rake $0.05 
Board [8c 2c 4h]
Seat 1: HammettBets folded before Flop (didn't bet)
Seat 2: Poker Barrie folded before Flop (didn't bet)
Seat 3: phillme13 (button) folded on the Flop
Seat 4: momocgn (small blind) folded before Flop
Seat 5: Valezius (big blind) folded before Flop
Seat 6: Mrinaldi folded before Flop (didn't bet)
Seat 7: Alameda22 collected ($1.80)
Seat 9: ssp25 folded before Flop (didn't bet)



PokerStars Game #19974152233:  Hold'em No Limit ($0.10/$0.25) - 2008/08/28 - 19:25:08 (ET)
Table 'Hippasos IV' 9-max Seat #4 is the button
Seat 1: HammettBets ($17.85 in chips) 
Seat 2: Poker Barrie ($57.85 in chips) 
Seat 3: phillme13 ($30.55 in chips) 
Seat 4: momocgn ($4.55 in chips) 
Seat 5: Valezius ($5.40 in chips) 
Seat 6: Mrinaldi ($15.50 in chips) 
Seat 7: Alameda22 ($26.40 in chips) 
Seat 9: ssp25 ($24.35 in chips) 
Valezius: posts small blind $0.10
Mrinaldi: posts big blind $0.25
BufordDalt: sits out 
*** HOLE CARDS ***
Dealt to Alameda22 [Ad Qd]
Alameda22: raises $0.50 to $0.75
ssp25: folds 
HammettBets: folds 
Poker Barrie: folds 
phillme13: folds 
momocgn: folds 
Valezius: folds 
Mrinaldi: folds 
Uncalled bet ($0.50) returned to Alameda22
Alameda22 collected $0.60 from pot
Alameda22: doesn't show hand 
*** SUMMARY ***
Total pot $0.60 | Rake $0 
Seat 1: HammettBets folded before Flop (didn't bet)
Seat 2: Poker Barrie folded before Flop (didn't bet)
Seat 3: phillme13 folded before Flop (didn't bet)
Seat 4: momocgn (button) folded before Flop (didn't bet)
Seat 5: Valezius (small blind) folded before Flop
Seat 6: Mrinaldi (big blind) folded before Flop
Seat 7: Alameda22 collected ($0.60)
Seat 9: ssp25 folded before Flop (didn't bet)



PokerStars Game #19974168226:  Hold'em No Limit ($0.10/$0.25) - 2008/08/28 - 19:25:52 (ET)
Table 'Hippasos IV' 9-max Seat #5 is the button
Seat 1: HammettBets ($17.85 in chips) 
Seat 2: Poker Barrie ($57.85 in chips) 
Seat 3: phillme13 ($30.55 in chips) 
Seat 4: momocgn ($4.55 in chips) 
Seat 5: Valezius ($5.30 in chips) 
Seat 6: Mrinaldi ($15.25 in chips) 
Seat 7: Alameda22 ($26.75 in chips) 
Seat 9: ssp25 ($24.35 in chips) 
Mrinaldi: posts small blind $0.10
Alameda22: posts big blind $0.25
BufordDalt: sits out 
*** HOLE CARDS ***
Dealt to Alameda22 [Ad Jc]
ssp25: folds 
HammettBets: folds 
Poker Barrie: folds 
phillme13: raises $0.50 to $0.75
momocgn: folds 
Valezius: folds 
Mrinaldi: folds 
Alameda22: calls $0.50
*** FLOP *** [5c 9s Kh]
Alameda22: checks 
phillme13: checks 
*** TURN *** [5c 9s Kh] [4c]
Alameda22: checks 
phillme13: bets $1
Alameda22: folds 
Uncalled bet ($1) returned to phillme13
phillme13 collected $1.55 from pot
phillme13: doesn't show hand 
*** SUMMARY ***
Total pot $1.60 | Rake $0.05 
Board [5c 9s Kh 4c]
Seat 1: HammettBets folded before Flop (didn't bet)
Seat 2: Poker Barrie folded before Flop (didn't bet)
Seat 3: phillme13 collected ($1.55)
Seat 4: momocgn folded before Flop (didn't bet)
Seat 5: Valezius (button) folded before Flop (didn't bet)
Seat 6: Mrinaldi (small blind) folded before Flop
Seat 7: Alameda22 (big blind) folded on the Turn
Seat 9: ssp25 folded before Flop (didn't bet)



PokerStars Game #19974194300:  Hold'em No Limit ($0.10/$0.25) - 2008/08/28 - 19:27:04 (ET)
Table 'Hippasos IV' 9-max Seat #6 is the button
Seat 1: HammettBets ($17.85 in chips) 
Seat 2: Poker Barrie ($57.85 in chips) 
Seat 3: phillme13 ($31.35 in chips) 
Seat 4: momocgn ($4.55 in chips) 
Seat 5: Valezius ($5.30 in chips) 
Seat 6: Mrinaldi ($15.15 in chips) 
Seat 7: Alameda22 ($26 in chips) 
Seat 9: ssp25 ($24.35 in chips) 
Alameda22: posts small blind $0.10
BufordDalt: is sitting out 
ssp25: posts big blind $0.25
*** HOLE CARDS ***
Dealt to Alameda22 [5s 7c]
HammettBets: folds 
Poker Barrie: calls $0.25
phillme13: folds 
momocgn: folds 
Valezius: folds 
Mrinaldi: calls $0.25
Alameda22: folds 
BufordDalt leaves the table
ssp25: raises $0.75 to $1
LyolikBY joins the table at seat #8 
Poker Barrie: calls $0.75
Mrinaldi: calls $0.75
*** FLOP *** [Ks Jd Kc]
ssp25: bets $2.25
Poker Barrie: folds 
Mrinaldi: calls $2.25
*** TURN *** [Ks Jd Kc] [6s]
ssp25: bets $5.25
Mrinaldi: calls $5.25
*** RIVER *** [Ks Jd Kc 6s] [Ts]
ssp25: checks 
Mrinaldi: checks 
*** SHOW DOWN ***
ssp25: shows [Kh As] (three of a kind, Kings)
Mrinaldi: mucks hand 
ssp25 collected $17.25 from pot
*** SUMMARY ***
Total pot $18.10 | Rake $0.85 
Board [Ks Jd Kc 6s Ts]
Seat 1: HammettBets folded before Flop (didn't bet)
Seat 2: Poker Barrie folded on the Flop
Seat 3: phillme13 folded before Flop (didn't bet)
Seat 4: momocgn folded before Flop (didn't bet)
Seat 5: Valezius folded before Flop (didn't bet)
Seat 6: Mrinaldi (button) mucked [Ac Jc]
Seat 7: Alameda22 (small blind) folded before Flop
Seat 9: ssp25 (big blind) showed [Kh As] and won ($17.25) with three of a kind, Kings



PokerStars Game #19974228413:  Hold'em No Limit ($0.10/$0.25) - 2008/08/28 - 19:28:38 (ET)
Table 'Hippasos IV' 9-max Seat #7 is the button
Seat 1: HammettBets ($17.85 in chips) 
Seat 2: Poker Barrie ($56.85 in chips) 
Seat 3: phillme13 ($31.35 in chips) 
Seat 4: momocgn ($4.55 in chips) 
Seat 5: Valezius ($5.30 in chips) 
Seat 6: Mrinaldi ($6.65 in chips) 
Seat 7: Alameda22 ($25.90 in chips) 
Seat 9: ssp25 ($33.10 in chips) 
LyolikBY will be allowed to play after the button
ssp25: posts small blind $0.10
HammettBets: posts big blind $0.25
*** HOLE CARDS ***
Dealt to Alameda22 [6d 8h]
Poker Barrie: folds 
phillme13: folds 
momocgn: raises $0.75 to $1
Valezius: folds 
Mrinaldi: folds 
Alameda22: folds 
ssp25: folds 
HammettBets: folds 
Uncalled bet ($0.75) returned to momocgn
momocgn collected $0.60 from pot
momocgn: doesn't show hand 
*** SUMMARY ***
Total pot $0.60 | Rake $0 
Seat 1: HammettBets (big blind) folded before Flop
Seat 2: Poker Barrie folded before Flop (didn't bet)
Seat 3: phillme13 folded before Flop (didn't bet)
Seat 4: momocgn collected ($0.60)
Seat 5: Valezius folded before Flop (didn't bet)
Seat 6: Mrinaldi folded before Flop (didn't bet)
Seat 7: Alameda22 (button) folded before Flop (didn't bet)
Seat 9: ssp25 (small blind) folded before Flop



PokerStars Game #19974236900:  Hold'em No Limit ($0.10/$0.25) - 2008/08/28 - 19:29:02 (ET)
Table 'Hippasos IV' 9-max Seat #9 is the button
Seat 1: HammettBets ($17.60 in chips) 
Seat 2: Poker Barrie ($56.85 in chips) 
Seat 3: phillme13 ($31.35 in chips) 
Seat 4: momocgn ($4.90 in chips) 
Seat 5: Valezius ($5.30 in chips) 
Seat 6: Mrinaldi ($6.65 in chips) 
Seat 7: Alameda22 ($25.90 in chips) 
Seat 9: ssp25 ($33 in chips) 
HammettBets: posts small blind $0.10
Poker Barrie: posts big blind $0.25
LyolikBY: sits out 
*** HOLE CARDS ***
Dealt to Alameda22 [6s Ts]
phillme13: calls $0.25
momocgn: folds 
Valezius: folds 
Mrinaldi: folds 
Alameda22: folds 
ssp25: folds 
HammettBets: folds 
Poker Barrie: checks 
*** FLOP *** [3s Jd Js]
Poker Barrie: checks 
phillme13: bets $0.50
Poker Barrie: calls $0.50
*** TURN *** [3s Jd Js] [8d]
Poker Barrie: checks 
phillme13: bets $0.75
Poker Barrie: calls $0.75
*** RIVER *** [3s Jd Js 8d] [Jc]
Poker Barrie: checks 
phillme13: checks 
*** SHOW DOWN ***
Poker Barrie: shows [2c 3h] (a full house, Jacks full of Threes)
phillme13: mucks hand 
Poker Barrie collected $2.95 from pot
phillme13 said, "lucky fish"
*** SUMMARY ***
Total pot $3.10 | Rake $0.15 
Board [3s Jd Js 8d Jc]
Seat 1: HammettBets (small blind) folded before Flop
Seat 2: Poker Barrie (big blind) showed [2c 3h] and won ($2.95) with a full house, Jacks full of Threes
Seat 3: phillme13 mucked [6h Ah]
Seat 4: momocgn folded before Flop (didn't bet)
Seat 5: Valezius folded before Flop (didn't bet)
Seat 6: Mrinaldi folded before Flop (didn't bet)
Seat 7: Alameda22 folded before Flop (didn't bet)
Seat 9: ssp25 (button) folded before Flop (didn't bet)



PokerStars Game #19974255070:  Hold'em No Limit ($0.10/$0.25) - 2008/08/28 - 19:29:53 (ET)
Table 'Hippasos IV' 9-max Seat #1 is the button
Seat 1: HammettBets ($17.50 in chips) 
Seat 2: Poker Barrie ($58.30 in chips) 
Seat 3: phillme13 ($29.85 in chips) 
Seat 4: momocgn ($4.90 in chips) 
Seat 5: Valezius ($5.30 in chips) 
Seat 6: Mrinaldi ($6.65 in chips) 
Seat 7: Alameda22 ($25.90 in chips) 
Seat 9: ssp25 ($33 in chips) 
Poker Barrie: posts small blind $0.10
phillme13: posts big blind $0.25
LyolikBY: sits out 
*** HOLE CARDS ***
Dealt to Alameda22 [3d 5c]
momocgn: folds 
Valezius: folds 
Mrinaldi: raises $0.50 to $0.75
Alameda22: folds 
ssp25: folds 
HammettBets: folds 
Poker Barrie: raises $0.50 to $1.25
phillme13: folds 
Mrinaldi: calls $0.50
*** FLOP *** [6s 9d 7c]
Poker Barrie: bets $1.25
Mrinaldi: folds 
Uncalled bet ($1.25) returned to Poker Barrie
Poker Barrie collected $2.65 from pot
Poker Barrie: doesn't show hand 
*** SUMMARY ***
Total pot $2.75 | Rake $0.10 
Board [6s 9d 7c]
Seat 1: HammettBets (button) folded before Flop (didn't bet)
Seat 2: Poker Barrie (small blind) collected ($2.65)
Seat 3: phillme13 (big blind) folded before Flop
Seat 4: momocgn folded before Flop (didn't bet)
Seat 5: Valezius folded before Flop (didn't bet)
Seat 6: Mrinaldi folded on the Flop
Seat 7: Alameda22 folded before Flop (didn't bet)
Seat 9: ssp25 folded before Flop (didn't bet)



PokerStars Game #19974271950:  Hold'em No Limit ($0.10/$0.25) - 2008/08/28 - 19:30:40 (ET)
Table 'Hippasos IV' 9-max Seat #2 is the button
Seat 1: HammettBets ($17.50 in chips) 
Seat 2: Poker Barrie ($59.70 in chips) 
Seat 3: phillme13 ($29.60 in chips) 
Seat 4: momocgn ($4.90 in chips) 
Seat 5: Valezius ($5.30 in chips) 
Seat 6: Mrinaldi ($5.40 in chips) 
Seat 7: Alameda22 ($25.90 in chips) 
Seat 9: ssp25 ($33 in chips) 
phillme13: posts small blind $0.10
momocgn: posts big blind $0.25
LyolikBY: sits out 
*** HOLE CARDS ***
Dealt to Alameda22 [3s Ac]
Valezius: raises $0.75 to $1
Mrinaldi: folds 
Alameda22: folds 
ssp25: folds 
HammettBets: folds 
Poker Barrie: folds 
phillme13: folds 
momocgn: folds 
Uncalled bet ($0.75) returned to Valezius
Valezius collected $0.60 from pot
Valezius: doesn't show hand 
*** SUMMARY ***
Total pot $0.60 | Rake $0 
Seat 1: HammettBets folded before Flop (didn't bet)
Seat 2: Poker Barrie (button) folded before Flop (didn't bet)
Seat 3: phillme13 (small blind) folded before Flop
Seat 4: momocgn (big blind) folded before Flop
Seat 5: Valezius collected ($0.60)
Seat 6: Mrinaldi folded before Flop (didn't bet)
Seat 7: Alameda22 folded before Flop (didn't bet)
Seat 9: ssp25 folded before Flop (didn't bet)



PokerStars Game #19974291071:  Hold'em No Limit ($0.10/$0.25) - 2008/08/28 - 19:31:30 (ET)
Table 'Hippasos IV' 9-max Seat #3 is the button
Seat 1: HammettBets ($17.50 in chips) 
Seat 2: Poker Barrie ($59.70 in chips) 
Seat 3: phillme13 ($29.50 in chips) 
Seat 4: momocgn ($4.65 in chips) 
Seat 5: Valezius ($5.65 in chips) 
Seat 6: Mrinaldi ($5.40 in chips) 
Seat 7: Alameda22 ($25.90 in chips) 
Seat 9: ssp25 ($33 in chips) 
momocgn: posts small blind $0.10
Valezius: posts big blind $0.25
LyolikBY: sits out 
*** HOLE CARDS ***
Dealt to Alameda22 [Ah 6s]
Mrinaldi: folds 
Alameda22: folds 
ssp25: folds 
HammettBets: folds 
Poker Barrie: raises $0.75 to $1
phillme13: folds 
momocgn: folds 
Valezius: folds 
Uncalled bet ($0.75) returned to Poker Barrie
Poker Barrie collected $0.60 from pot
Poker Barrie: doesn't show hand 
*** SUMMARY ***
Total pot $0.60 | Rake $0 
Seat 1: HammettBets folded before Flop (didn't bet)
Seat 2: Poker Barrie collected ($0.60)
Seat 3: phillme13 (button) folded before Flop (didn't bet)
Seat 4: momocgn (small blind) folded before Flop
Seat 5: Valezius (big blind) folded before Flop
Seat 6: Mrinaldi folded before Flop (didn't bet)
Seat 7: Alameda22 folded before Flop (didn't bet)
Seat 9: ssp25 folded before Flop (didn't bet)



PokerStars Game #19974310819:  Hold'em No Limit ($0.10/$0.25) - 2008/08/28 - 19:32:23 (ET)
Table 'Hippasos IV' 9-max Seat #4 is the button
Seat 1: HammettBets ($17.50 in chips) 
Seat 2: Poker Barrie ($60.05 in chips) 
Seat 3: phillme13 ($29.50 in chips) 
Seat 4: momocgn ($4.55 in chips) 
Seat 5: Valezius ($5.40 in chips) 
Seat 6: Mrinaldi ($5.40 in chips) 
Seat 7: Alameda22 ($25.90 in chips) 
Seat 9: ssp25 ($33 in chips) 
Valezius: posts small blind $0.10
Mrinaldi: posts big blind $0.25
LyolikBY: sits out 
*** HOLE CARDS ***
Dealt to Alameda22 [5s 3h]
Alameda22: folds 
ssp25: folds 
HammettBets: raises $0.50 to $0.75
Poker Barrie: folds 
phillme13: folds 
momocgn: folds 
Valezius: folds 
Mrinaldi: folds 
Uncalled bet ($0.50) returned to HammettBets
HammettBets collected $0.60 from pot
HammettBets: doesn't show hand 
*** SUMMARY ***
Total pot $0.60 | Rake $0 
Seat 1: HammettBets collected ($0.60)
Seat 2: Poker Barrie folded before Flop (didn't bet)
Seat 3: phillme13 folded before Flop (didn't bet)
Seat 4: momocgn (button) folded before Flop (didn't bet)
Seat 5: Valezius (small blind) folded before Flop
Seat 6: Mrinaldi (big blind) folded before Flop
Seat 7: Alameda22 folded before Flop (didn't bet)
Seat 9: ssp25 folded before Flop (didn't bet)



PokerStars Game #19974326290:  Hold'em No Limit ($0.10/$0.25) - 2008/08/28 - 19:33:04 (ET)
Table 'Hippasos IV' 9-max Seat #5 is the button
Seat 1: HammettBets ($17.85 in chips) 
Seat 2: Poker Barrie ($60.05 in chips) 
Seat 3: phillme13 ($29.50 in chips) 
Seat 4: momocgn ($4.55 in chips) 
Seat 5: Valezius ($5.30 in chips) 
Seat 6: Mrinaldi ($5.15 in chips) 
Seat 7: Alameda22 ($25.90 in chips) 
Seat 9: ssp25 ($33 in chips) 
Mrinaldi: posts small blind $0.10
Alameda22: posts big blind $0.25
LyolikBY: sits out 
*** HOLE CARDS ***
Dealt to Alameda22 [8h Kc]
ssp25: folds 
HammettBets: folds 
Poker Barrie: calls $0.25
phillme13: folds 
momocgn: folds 
Valezius: folds 
Mrinaldi: folds 
Alameda22: checks 
*** FLOP *** [5c 4h 9h]
Alameda22: checks 
Poker Barrie: bets $1
Alameda22: folds 
Uncalled bet ($1) returned to Poker Barrie
Poker Barrie collected $0.60 from pot
Poker Barrie: doesn't show hand 
*** SUMMARY ***
Total pot $0.60 | Rake $0 
Board [5c 4h 9h]
Seat 1: HammettBets folded before Flop (didn't bet)
Seat 2: Poker Barrie collected ($0.60)
Seat 3: phillme13 folded before Flop (didn't bet)
Seat 4: momocgn folded before Flop (didn't bet)
Seat 5: Valezius (button) folded before Flop (didn't bet)
Seat 6: Mrinaldi (small blind) folded before Flop
Seat 7: Alameda22 (big blind) folded on the Flop
Seat 9: ssp25 folded before Flop (didn't bet)



PokerStars Game #19974352855:  Hold'em No Limit ($0.10/$0.25) - 2008/08/28 - 19:34:15 (ET)
Table 'Hippasos IV' 9-max Seat #6 is the button
Seat 1: HammettBets ($17.85 in chips) 
Seat 2: Poker Barrie ($60.40 in chips) 
Seat 3: phillme13 ($29.50 in chips) 
Seat 4: momocgn ($4.55 in chips) 
Seat 5: Valezius ($5.30 in chips) 
Seat 6: Mrinaldi ($5.05 in chips) 
Seat 7: Alameda22 ($25.65 in chips) 
Seat 8: LyolikBY ($5 in chips) 
Seat 9: ssp25 ($33 in chips) 
Alameda22: posts small blind $0.10
LyolikBY: posts big blind $0.25
*** HOLE CARDS ***
Dealt to Alameda22 [6s Ac]
ssp25: folds 
HammettBets: folds 
Poker Barrie: folds 
phillme13: folds 
momocgn: folds 
Valezius: folds 
Mrinaldi: raises $0.25 to $0.50
Alameda22: folds 
LyolikBY: folds 
Uncalled bet ($0.25) returned to Mrinaldi
Mrinaldi collected $0.60 from pot
Mrinaldi: doesn't show hand 
*** SUMMARY ***
Total pot $0.60 | Rake $0 
Seat 1: HammettBets folded before Flop (didn't bet)
Seat 2: Poker Barrie folded before Flop (didn't bet)
Seat 3: phillme13 folded before Flop (didn't bet)
Seat 4: momocgn folded before Flop (didn't bet)
Seat 5: Valezius folded before Flop (didn't bet)
Seat 6: Mrinaldi (button) collected ($0.60)
Seat 7: Alameda22 (small blind) folded before Flop
Seat 8: LyolikBY (big blind) folded before Flop
Seat 9: ssp25 folded before Flop (didn't bet)



PokerStars Game #19974373032:  Hold'em No Limit ($0.10/$0.25) - 2008/08/28 - 19:35:09 (ET)
Table 'Hippasos IV' 9-max Seat #7 is the button
Seat 1: HammettBets ($17.85 in chips) 
Seat 2: Poker Barrie ($60.40 in chips) 
Seat 3: phillme13 ($29.50 in chips) 
Seat 4: momocgn ($4.55 in chips) 
Seat 5: Valezius ($5.30 in chips) 
Seat 6: Mrinaldi ($15.40 in chips) 
Seat 7: Alameda22 ($25.55 in chips) 
Seat 8: LyolikBY ($4.75 in chips) 
Seat 9: ssp25 ($33 in chips) 
LyolikBY: posts small blind $0.10
ssp25: posts big blind $0.25
*** HOLE CARDS ***
Dealt to Alameda22 [9c 2h]
HammettBets: raises $0.25 to $0.50
Poker Barrie: raises $1 to $1.50
phillme13: folds 
momocgn: folds 
Valezius: folds 
Mrinaldi: folds 
Alameda22: folds 
LyolikBY: folds 
ssp25: folds 
HammettBets: folds 
Uncalled bet ($1) returned to Poker Barrie
Poker Barrie collected $1.35 from pot
Poker Barrie: doesn't show hand 
*** SUMMARY ***
Total pot $1.35 | Rake $0 
Seat 1: HammettBets folded before Flop
Seat 2: Poker Barrie collected ($1.35)
Seat 3: phillme13 folded before Flop (didn't bet)
Seat 4: momocgn folded before Flop (didn't bet)
Seat 5: Valezius folded before Flop (didn't bet)
Seat 6: Mrinaldi folded before Flop (didn't bet)
Seat 7: Alameda22 (button) folded before Flop (didn't bet)
Seat 8: LyolikBY (small blind) folded before Flop
Seat 9: ssp25 (big blind) folded before Flop



PokerStars Game #19974391938:  Hold'em No Limit ($0.10/$0.25) - 2008/08/28 - 19:36:00 (ET)
Table 'Hippasos IV' 9-max Seat #8 is the button
Seat 1: HammettBets ($17.35 in chips) 
Seat 2: Poker Barrie ($61.25 in chips) 
Seat 3: phillme13 ($29.50 in chips) 
Seat 4: momocgn ($4.55 in chips) 
Seat 5: Valezius ($5.30 in chips) 
Seat 6: Mrinaldi ($15.40 in chips) 
Seat 7: Alameda22 ($25.55 in chips) 
Seat 8: LyolikBY ($4.65 in chips) 
Seat 9: ssp25 ($32.75 in chips) 
ssp25: posts small blind $0.10
HammettBets: posts big blind $0.25
*** HOLE CARDS ***
Dealt to Alameda22 [3s Ks]
Poker Barrie: folds 
phillme13: folds 
momocgn: folds 
Valezius: folds 
Mrinaldi: raises $0.75 to $1
Alameda22: folds 
LyolikBY: folds 
ssp25: folds 
HammettBets: folds 
Uncalled bet ($0.75) returned to Mrinaldi
Mrinaldi collected $0.60 from pot
Mrinaldi: doesn't show hand 
*** SUMMARY ***
Total pot $0.60 | Rake $0 
Seat 1: HammettBets (big blind) folded before Flop
Seat 2: Poker Barrie folded before Flop (didn't bet)
Seat 3: phillme13 folded before Flop (didn't bet)
Seat 4: momocgn folded before Flop (didn't bet)
Seat 5: Valezius folded before Flop (didn't bet)
Seat 6: Mrinaldi collected ($0.60)
Seat 7: Alameda22 folded before Flop (didn't bet)
Seat 8: LyolikBY (button) folded before Flop (didn't bet)
Seat 9: ssp25 (small blind) folded before Flop



PokerStars Game #19974404893:  Hold'em No Limit ($0.10/$0.25) - 2008/08/28 - 19:36:34 (ET)
Table 'Hippasos IV' 9-max Seat #9 is the button
Seat 1: HammettBets ($17.10 in chips) 
Seat 2: Poker Barrie ($61.25 in chips) 
Seat 3: phillme13 ($29.50 in chips) 
Seat 4: momocgn ($4.55 in chips) 
Seat 5: Valezius ($5.30 in chips) 
Seat 6: Mrinaldi ($15.75 in chips) 
Seat 7: Alameda22 ($25.55 in chips) 
Seat 8: LyolikBY ($4.65 in chips) 
Seat 9: ssp25 ($32.65 in chips) 
HammettBets: posts small blind $0.10
Poker Barrie: posts big blind $0.25
*** HOLE CARDS ***
Dealt to Alameda22 [Jh 8s]
phillme13: folds 
momocgn: folds 
Valezius: folds 
Mrinaldi: folds 
Alameda22: folds 
LyolikBY: folds 
ssp25: folds 
HammettBets: calls $0.15
Poker Barrie: checks 
*** FLOP *** [8d Ah 6s]
HammettBets: bets $0.50
Poker Barrie: folds 
Uncalled bet ($0.50) returned to HammettBets
HammettBets collected $0.50 from pot
HammettBets: doesn't show hand 
*** SUMMARY ***
Total pot $0.50 | Rake $0 
Board [8d Ah 6s]
Seat 1: HammettBets (small blind) collected ($0.50)
Seat 2: Poker Barrie (big blind) folded on the Flop
Seat 3: phillme13 folded before Flop (didn't bet)
Seat 4: momocgn folded before Flop (didn't bet)
Seat 5: Valezius folded before Flop (didn't bet)
Seat 6: Mrinaldi folded before Flop (didn't bet)
Seat 7: Alameda22 folded before Flop (didn't bet)
Seat 8: LyolikBY folded before Flop (didn't bet)
Seat 9: ssp25 (button) folded before Flop (didn't bet)



PokerStars Game #19974423029:  Hold'em No Limit ($0.10/$0.25) - 2008/08/28 - 19:37:22 (ET)
Table 'Hippasos IV' 9-max Seat #1 is the button
Seat 1: HammettBets ($17.35 in chips) 
Seat 2: Poker Barrie ($61 in chips) 
Seat 3: phillme13 ($29.50 in chips) 
Seat 4: momocgn ($4.55 in chips) 
Seat 5: Valezius ($5.30 in chips) 
Seat 6: Mrinaldi ($15.75 in chips) 
Seat 7: Alameda22 ($25.55 in chips) 
Seat 8: LyolikBY ($4.65 in chips) 
Seat 9: ssp25 ($32.65 in chips) 
Poker Barrie: posts small blind $0.10
phillme13: posts big blind $0.25
*** HOLE CARDS ***
Dealt to Alameda22 [7h Qd]
momocgn: folds 
Valezius: folds 
Mrinaldi: folds 
Alameda22: folds 
LyolikBY: folds 
ssp25: folds 
HammettBets: raises $0.50 to $0.75
Poker Barrie: calls $0.65
phillme13: calls $0.50
*** FLOP *** [Td 4d Kc]
Poker Barrie: checks 
phillme13: checks 
HammettBets: checks 
*** TURN *** [Td 4d Kc] [4s]
Poker Barrie: checks 
phillme13: bets $0.75
HammettBets: folds 
Poker Barrie: folds 
Uncalled bet ($0.75) returned to phillme13
phillme13 collected $2.15 from pot
phillme13: doesn't show hand 
*** SUMMARY ***
Total pot $2.25 | Rake $0.10 
Board [Td 4d Kc 4s]
Seat 1: HammettBets (button) folded on the Turn
Seat 2: Poker Barrie (small blind) folded on the Turn
Seat 3: phillme13 (big blind) collected ($2.15)
Seat 4: momocgn folded before Flop (didn't bet)
Seat 5: Valezius folded before Flop (didn't bet)
Seat 6: Mrinaldi folded before Flop (didn't bet)
Seat 7: Alameda22 folded before Flop (didn't bet)
Seat 8: LyolikBY folded before Flop (didn't bet)
Seat 9: ssp25 folded before Flop (didn't bet)



PokerStars Game #19974444808:  Hold'em No Limit ($0.10/$0.25) - 2008/08/28 - 19:38:21 (ET)
Table 'Hippasos IV' 9-max Seat #2 is the button
Seat 1: HammettBets ($16.60 in chips) 
Seat 2: Poker Barrie ($60.25 in chips) 
Seat 3: phillme13 ($30.90 in chips) 
Seat 4: momocgn ($4.55 in chips) 
Seat 5: Valezius ($5.30 in chips) 
Seat 6: Mrinaldi ($15.75 in chips) 
Seat 7: Alameda22 ($25.55 in chips) 
Seat 8: LyolikBY ($4.65 in chips) 
Seat 9: ssp25 ($32.65 in chips) 
phillme13: posts small blind $0.10
momocgn: posts big blind $0.25
*** HOLE CARDS ***
Dealt to Alameda22 [Ks As]
Valezius: folds 
Mrinaldi: folds 
Alameda22: raises $0.50 to $0.75
LyolikBY: folds 
ssp25: folds 
HammettBets: folds 
Poker Barrie: calls $0.75
phillme13: folds 
momocgn: folds 
*** FLOP *** [6s 2h 5d]
Alameda22: bets $1.25
Poker Barrie: folds 
Uncalled bet ($1.25) returned to Alameda22
Alameda22 collected $1.80 from pot
Alameda22: doesn't show hand 
*** SUMMARY ***
Total pot $1.85 | Rake $0.05 
Board [6s 2h 5d]
Seat 1: HammettBets folded before Flop (didn't bet)
Seat 2: Poker Barrie (button) folded on the Flop
Seat 3: phillme13 (small blind) folded before Flop
Seat 4: momocgn (big blind) folded before Flop
Seat 5: Valezius folded before Flop (didn't bet)
Seat 6: Mrinaldi folded before Flop (didn't bet)
Seat 7: Alameda22 collected ($1.80)
Seat 8: LyolikBY folded before Flop (didn't bet)
Seat 9: ssp25 folded before Flop (didn't bet)



PokerStars Game #19974462113:  Hold'em No Limit ($0.10/$0.25) - 2008/08/28 - 19:39:08 (ET)
Table 'Hippasos IV' 9-max Seat #3 is the button
Seat 1: HammettBets ($16.60 in chips) 
Seat 2: Poker Barrie ($59.50 in chips) 
Seat 3: phillme13 ($30.80 in chips) 
Seat 4: momocgn ($4.30 in chips) 
Seat 5: Valezius ($5.30 in chips) 
Seat 6: Mrinaldi ($15.75 in chips) 
Seat 7: Alameda22 ($26.60 in chips) 
Seat 8: LyolikBY ($4.65 in chips) 
Seat 9: ssp25 ($32.65 in chips) 
momocgn: posts small blind $0.10
Valezius: posts big blind $0.25
*** HOLE CARDS ***
Dealt to Alameda22 [2h 8d]
Mrinaldi: folds 
Alameda22: folds 
LyolikBY: folds 
ssp25: folds 
HammettBets: folds 
Poker Barrie: raises $0.75 to $1
phillme13: folds 
momocgn: folds 
Valezius: folds 
Uncalled bet ($0.75) returned to Poker Barrie
Poker Barrie collected $0.60 from pot
Poker Barrie: doesn't show hand 
*** SUMMARY ***
Total pot $0.60 | Rake $0 
Seat 1: HammettBets folded before Flop (didn't bet)
Seat 2: Poker Barrie collected ($0.60)
Seat 3: phillme13 (button) folded before Flop (didn't bet)
Seat 4: momocgn (small blind) folded before Flop
Seat 5: Valezius (big blind) folded before Flop
Seat 6: Mrinaldi folded before Flop (didn't bet)
Seat 7: Alameda22 folded before Flop (didn't bet)
Seat 8: LyolikBY folded before Flop (didn't bet)
Seat 9: ssp25 folded before Flop (didn't bet)



PokerStars Game #19974477663:  Hold'em No Limit ($0.10/$0.25) - 2008/08/28 - 19:39:50 (ET)
Table 'Hippasos IV' 9-max Seat #4 is the button
Seat 1: HammettBets ($16.60 in chips) 
Seat 2: Poker Barrie ($59.85 in chips) 
Seat 3: phillme13 ($30.80 in chips) 
Seat 4: momocgn ($4.20 in chips) 
Seat 5: Valezius ($5.05 in chips) 
Seat 6: Mrinaldi ($15.75 in chips) 
Seat 7: Alameda22 ($26.60 in chips) 
Seat 8: LyolikBY ($4.65 in chips) 
Seat 9: ssp25 ($32.65 in chips) 
Valezius: posts small blind $0.10
Mrinaldi: posts big blind $0.25
*** HOLE CARDS ***
Dealt to Alameda22 [8c Kd]
Alameda22: folds 
LyolikBY: folds 
ssp25: folds 
HammettBets: folds 
Poker Barrie: folds 
phillme13: folds 
momocgn: folds 
Valezius: folds 
Uncalled bet ($0.15) returned to Mrinaldi
Mrinaldi collected $0.20 from pot
Mrinaldi: doesn't show hand 
*** SUMMARY ***
Total pot $0.20 | Rake $0 
Seat 1: HammettBets folded before Flop (didn't bet)
Seat 2: Poker Barrie folded before Flop (didn't bet)
Seat 3: phillme13 folded before Flop (didn't bet)
Seat 4: momocgn (button) folded before Flop (didn't bet)
Seat 5: Valezius (small blind) folded before Flop
Seat 6: Mrinaldi (big blind) collected ($0.20)
Seat 7: Alameda22 folded before Flop (didn't bet)
Seat 8: LyolikBY folded before Flop (didn't bet)
Seat 9: ssp25 folded before Flop (didn't bet)



PokerStars Game #19974484355:  Hold'em No Limit ($0.10/$0.25) - 2008/08/28 - 19:40:06 (ET)
Table 'Hippasos IV' 9-max Seat #5 is the button
Seat 1: HammettBets ($16.60 in chips) 
Seat 2: Poker Barrie ($59.85 in chips) 
Seat 3: phillme13 ($30.80 in chips) 
Seat 4: momocgn ($4.20 in chips) 
Seat 5: Valezius ($4.95 in chips) 
Seat 6: Mrinaldi ($15.85 in chips) 
Seat 7: Alameda22 ($26.60 in chips) 
Seat 8: LyolikBY ($4.65 in chips) 
Seat 9: ssp25 ($32.65 in chips) 
Mrinaldi: posts small blind $0.10
Alameda22: posts big blind $0.25
*** HOLE CARDS ***
Dealt to Alameda22 [2d 6c]
LyolikBY: folds 
ssp25: folds 
HammettBets: calls $0.25
Poker Barrie: folds 
phillme13: calls $0.25
momocgn: raises $1.25 to $1.50
Valezius: folds 
Mrinaldi: folds 
Alameda22: folds 
HammettBets: folds 
phillme13: folds 
Uncalled bet ($1.25) returned to momocgn
momocgn collected $1.10 from pot
*** SUMMARY ***
Total pot $1.10 | Rake $0 
Seat 1: HammettBets folded before Flop
Seat 2: Poker Barrie folded before Flop (didn't bet)
Seat 3: phillme13 folded before Flop
Seat 4: momocgn collected ($1.10)
Seat 5: Valezius (button) folded before Flop (didn't bet)
Seat 6: Mrinaldi (small blind) folded before Flop
Seat 7: Alameda22 (big blind) folded before Flop
Seat 8: LyolikBY folded before Flop (didn't bet)
Seat 9: ssp25 folded before Flop (didn't bet)



PokerStars Game #19974506574:  Hold'em No Limit ($0.10/$0.25) - 2008/08/28 - 19:41:06 (ET)
Table 'Hippasos IV' 9-max Seat #6 is the button
Seat 1: HammettBets ($16.35 in chips) 
Seat 2: Poker Barrie ($59.85 in chips) 
Seat 3: phillme13 ($30.55 in chips) 
Seat 4: momocgn ($5.05 in chips) 
Seat 5: Valezius ($4.95 in chips) 
Seat 6: Mrinaldi ($15.75 in chips) 
Seat 7: Alameda22 ($26.35 in chips) 
Seat 8: LyolikBY ($4.65 in chips) 
Seat 9: ssp25 ($32.65 in chips) 
Alameda22: posts small blind $0.10
LyolikBY: posts big blind $0.25
*** HOLE CARDS ***
Dealt to Alameda22 [2h 9d]
ssp25: folds 
HammettBets: folds 
Poker Barrie: folds 
phillme13: folds 
momocgn: folds 
Valezius: folds 
Mrinaldi: folds 
Alameda22: folds 
Uncalled bet ($0.15) returned to LyolikBY
LyolikBY collected $0.20 from pot
LyolikBY: doesn't show hand 
*** SUMMARY ***
Total pot $0.20 | Rake $0 
Seat 1: HammettBets folded before Flop (didn't bet)
Seat 2: Poker Barrie folded before Flop (didn't bet)
Seat 3: phillme13 folded before Flop (didn't bet)
Seat 4: momocgn folded before Flop (didn't bet)
Seat 5: Valezius folded before Flop (didn't bet)
Seat 6: Mrinaldi (button) folded before Flop (didn't bet)
Seat 7: Alameda22 (small blind) folded before Flop
Seat 8: LyolikBY (big blind) collected ($0.20)
Seat 9: ssp25 folded before Flop (didn't bet)



PokerStars Game #19974520072:  Hold'em No Limit ($0.10/$0.25) - 2008/08/28 - 19:41:42 (ET)
Table 'Hippasos IV' 9-max Seat #7 is the button
Seat 1: HammettBets ($16.35 in chips) 
Seat 2: Poker Barrie ($59.85 in chips) 
Seat 3: phillme13 ($30.55 in chips) 
Seat 4: momocgn ($5.05 in chips) 
Seat 5: Valezius ($4.95 in chips) 
Seat 6: Mrinaldi ($15.75 in chips) 
Seat 7: Alameda22 ($26.25 in chips) 
Seat 8: LyolikBY ($4.75 in chips) 
Seat 9: ssp25 ($32.65 in chips) 
LyolikBY: posts small blind $0.10
ssp25: posts big blind $0.25
*** HOLE CARDS ***
Dealt to Alameda22 [7d 9c]
HammettBets: folds 
Poker Barrie: folds 
phillme13: folds 
momocgn: folds 
Valezius: folds 
Mrinaldi: folds 
Alameda22: folds 
LyolikBY: raises $0.50 to $0.75
ssp25: folds 
Uncalled bet ($0.50) returned to LyolikBY
LyolikBY collected $0.50 from pot
LyolikBY: doesn't show hand 
*** SUMMARY ***
Total pot $0.50 | Rake $0 
Seat 1: HammettBets folded before Flop (didn't bet)
Seat 2: Poker Barrie folded before Flop (didn't bet)
Seat 3: phillme13 folded before Flop (didn't bet)
Seat 4: momocgn folded before Flop (didn't bet)
Seat 5: Valezius folded before Flop (didn't bet)
Seat 6: Mrinaldi folded before Flop (didn't bet)
Seat 7: Alameda22 (button) folded before Flop (didn't bet)
Seat 8: LyolikBY (small blind) collected ($0.50)
Seat 9: ssp25 (big blind) folded before Flop



PokerStars Game #19974535066:  Hold'em No Limit ($0.10/$0.25) - 2008/08/28 - 19:42:23 (ET)
Table 'Hippasos IV' 9-max Seat #8 is the button
Seat 1: HammettBets ($16.35 in chips) 
Seat 2: Poker Barrie ($59.85 in chips) 
Seat 3: phillme13 ($30.55 in chips) 
Seat 4: momocgn ($5.05 in chips) 
Seat 5: Valezius ($4.95 in chips) 
Seat 6: Mrinaldi ($15.75 in chips) 
Seat 7: Alameda22 ($26.25 in chips) 
Seat 8: LyolikBY ($5 in chips) 
Seat 9: ssp25 ($32.40 in chips) 
ssp25: posts small blind $0.10
HammettBets: posts big blind $0.25
*** HOLE CARDS ***
Dealt to Alameda22 [Qs 4c]
Poker Barrie: folds 
phillme13: calls $0.25
momocgn: folds 
Valezius: folds 
Mrinaldi: folds 
Alameda22: folds 
LyolikBY: folds 
ssp25: calls $0.15
HammettBets: checks 
*** FLOP *** [3s 8d 3d]
ssp25: checks 
HammettBets: checks 
phillme13: bets $0.75
ssp25: folds 
HammettBets: folds 
Uncalled bet ($0.75) returned to phillme13
phillme13 collected $0.75 from pot
phillme13: doesn't show hand 
*** SUMMARY ***
Total pot $0.75 | Rake $0 
Board [3s 8d 3d]
Seat 1: HammettBets (big blind) folded on the Flop
Seat 2: Poker Barrie folded before Flop (didn't bet)
Seat 3: phillme13 collected ($0.75)
Seat 4: momocgn folded before Flop (didn't bet)
Seat 5: Valezius folded before Flop (didn't bet)
Seat 6: Mrinaldi folded before Flop (didn't bet)
Seat 7: Alameda22 folded before Flop (didn't bet)
Seat 8: LyolikBY (button) folded before Flop (didn't bet)
Seat 9: ssp25 (small blind) folded on the Flop



PokerStars Game #19974554157:  Hold'em No Limit ($0.10/$0.25) - 2008/08/28 - 19:43:15 (ET)
Table 'Hippasos IV' 9-max Seat #9 is the button
Seat 1: HammettBets ($16.10 in chips) 
Seat 2: Poker Barrie ($59.85 in chips) 
Seat 3: phillme13 ($31.05 in chips) 
Seat 4: momocgn ($5.05 in chips) 
Seat 5: Valezius ($4.95 in chips) 
Seat 6: Mrinaldi ($15.75 in chips) 
Seat 7: Alameda22 ($26.25 in chips) 
Seat 8: LyolikBY ($5 in chips) 
Seat 9: ssp25 ($32.15 in chips) 
HammettBets: posts small blind $0.10
Poker Barrie: posts big blind $0.25
*** HOLE CARDS ***
Dealt to Alameda22 [4s 3h]
phillme13: folds 
momocgn: folds 
Valezius: folds 
Mrinaldi: folds 
Alameda22: folds 
LyolikBY: folds 
ssp25: folds 
HammettBets: calls $0.15
Poker Barrie: raises $0.75 to $1
HammettBets: calls $0.75
*** FLOP *** [Kh 2h 3c]
HammettBets: checks 
Poker Barrie: bets $1
HammettBets: folds 
Uncalled bet ($1) returned to Poker Barrie
Poker Barrie collected $1.90 from pot
Poker Barrie: doesn't show hand 
*** SUMMARY ***
Total pot $2 | Rake $0.10 
Board [Kh 2h 3c]
Seat 1: HammettBets (small blind) folded on the Flop
Seat 2: Poker Barrie (big blind) collected ($1.90)
Seat 3: phillme13 folded before Flop (didn't bet)
Seat 4: momocgn folded before Flop (didn't bet)
Seat 5: Valezius folded before Flop (didn't bet)
Seat 6: Mrinaldi folded before Flop (didn't bet)
Seat 7: Alameda22 folded before Flop (didn't bet)
Seat 8: LyolikBY folded before Flop (didn't bet)
Seat 9: ssp25 (button) folded before Flop (didn't bet)



PokerStars Game #19974573903:  Hold'em No Limit ($0.10/$0.25) - 2008/08/28 - 19:44:09 (ET)
Table 'Hippasos IV' 9-max Seat #1 is the button
Seat 1: HammettBets ($15.10 in chips) 
Seat 2: Poker Barrie ($60.75 in chips) 
Seat 3: phillme13 ($31.05 in chips) 
Seat 4: momocgn ($5.05 in chips) 
Seat 5: Valezius ($4.95 in chips) 
Seat 6: Mrinaldi ($15.75 in chips) 
Seat 7: Alameda22 ($26.25 in chips) 
Seat 8: LyolikBY ($5 in chips) 
Seat 9: ssp25 ($32.15 in chips) 
Poker Barrie: posts small blind $0.10
phillme13: posts big blind $0.25
*** HOLE CARDS ***
Dealt to Alameda22 [6c Tc]
momocgn: folds 
Valezius: folds 
Mrinaldi: raises $0.50 to $0.75
Alameda22: folds 
LyolikBY: folds 
ssp25: folds 
HammettBets: folds 
Poker Barrie: folds 
phillme13: folds 
Uncalled bet ($0.50) returned to Mrinaldi
Mrinaldi collected $0.60 from pot
Mrinaldi: doesn't show hand 
*** SUMMARY ***
Total pot $0.60 | Rake $0 
Seat 1: HammettBets (button) folded before Flop (didn't bet)
Seat 2: Poker Barrie (small blind) folded before Flop
Seat 3: phillme13 (big blind) folded before Flop
Seat 4: momocgn folded before Flop (didn't bet)
Seat 5: Valezius folded before Flop (didn't bet)
Seat 6: Mrinaldi collected ($0.60)
Seat 7: Alameda22 folded before Flop (didn't bet)
Seat 8: LyolikBY folded before Flop (didn't bet)
Seat 9: ssp25 folded before Flop (didn't bet)



PokerStars Game #19974586133:  Hold'em No Limit ($0.10/$0.25) - 2008/08/28 - 19:44:42 (ET)
Table 'Hippasos IV' 9-max Seat #2 is the button
Seat 1: HammettBets ($15.10 in chips) 
Seat 2: Poker Barrie ($60.65 in chips) 
Seat 3: phillme13 ($30.80 in chips) 
Seat 4: momocgn ($5.05 in chips) 
Seat 5: Valezius ($4.95 in chips) 
Seat 6: Mrinaldi ($16.10 in chips) 
Seat 7: Alameda22 ($26.25 in chips) 
Seat 8: LyolikBY ($5 in chips) 
Seat 9: ssp25 ($32.15 in chips) 
phillme13: posts small blind $0.10
momocgn: posts big blind $0.25
*** HOLE CARDS ***
Dealt to Alameda22 [8c 2h]
Valezius: folds 
Mrinaldi: folds 
Alameda22: folds 
LyolikBY: folds 
ssp25: folds 
HammettBets: raises $0.50 to $0.75
Poker Barrie: folds 
phillme13: folds 
momocgn: folds 
Uncalled bet ($0.50) returned to HammettBets
HammettBets collected $0.60 from pot
HammettBets: doesn't show hand 
*** SUMMARY ***
Total pot $0.60 | Rake $0 
Seat 1: HammettBets collected ($0.60)
Seat 2: Poker Barrie (button) folded before Flop (didn't bet)
Seat 3: phillme13 (small blind) folded before Flop
Seat 4: momocgn (big blind) folded before Flop
Seat 5: Valezius folded before Flop (didn't bet)
Seat 6: Mrinaldi folded before Flop (didn't bet)
Seat 7: Alameda22 folded before Flop (didn't bet)
Seat 8: LyolikBY folded before Flop (didn't bet)
Seat 9: ssp25 folded before Flop (didn't bet)



PokerStars Game #19974599836:  Hold'em No Limit ($0.10/$0.25) - 2008/08/28 - 19:45:20 (ET)
Table 'Hippasos IV' 9-max Seat #3 is the button
Seat 1: HammettBets ($15.45 in chips) 
Seat 2: Poker Barrie ($60.65 in chips) 
Seat 3: phillme13 ($30.70 in chips) 
Seat 4: momocgn ($4.80 in chips) 
Seat 6: Mrinaldi ($16.10 in chips) 
Seat 7: Alameda22 ($26.25 in chips) 
Seat 8: LyolikBY ($5 in chips) 
Seat 9: ssp25 ($32.15 in chips) 
momocgn: posts small blind $0.10
Valezius: is sitting out 
Valezius leaves the table
Mrinaldi: posts big blind $0.25
*** HOLE CARDS ***
Dealt to Alameda22 [2c 6h]
Alameda22: folds 
LyolikBY: folds 
ssp25: folds 
HammettBets: raises $0.50 to $0.75
Poker Barrie: folds 
phillme13: folds 
momocgn: folds 
Mrinaldi: folds 
Uncalled bet ($0.50) returned to HammettBets
HammettBets collected $0.60 from pot
HammettBets: doesn't show hand 
*** SUMMARY ***
Total pot $0.60 | Rake $0 
Seat 1: HammettBets collected ($0.60)
Seat 2: Poker Barrie folded before Flop (didn't bet)
Seat 3: phillme13 (button) folded before Flop (didn't bet)
Seat 4: momocgn (small blind) folded before Flop
Seat 6: Mrinaldi (big blind) folded before Flop
Seat 7: Alameda22 folded before Flop (didn't bet)
Seat 8: LyolikBY folded before Flop (didn't bet)
Seat 9: ssp25 folded before Flop (didn't bet)



PokerStars Game #19974613552:  Hold'em No Limit ($0.10/$0.25) - 2008/08/28 - 19:45:56 (ET)
Table 'Hippasos IV' 9-max Seat #4 is the button
Seat 1: HammettBets ($15.80 in chips) 
Seat 2: Poker Barrie ($60.65 in chips) 
Seat 3: phillme13 ($30.70 in chips) 
Seat 4: momocgn ($4.70 in chips) 
Seat 6: Mrinaldi ($15.85 in chips) 
Seat 7: Alameda22 ($26.25 in chips) 
Seat 8: LyolikBY ($5 in chips) 
Seat 9: ssp25 ($32.15 in chips) 
Mrinaldi: posts small blind $0.10
Alameda22: posts big blind $0.25
*** HOLE CARDS ***
Dealt to Alameda22 [9s Ad]
LyolikBY: folds 
ssp25: folds 
HammettBets: folds 
Poker Barrie: folds 
phillme13: folds 
momocgn: folds 
Mrinaldi: folds 
Uncalled bet ($0.15) returned to Alameda22
Alameda22 collected $0.20 from pot
Alameda22: doesn't show hand 
*** SUMMARY ***
Total pot $0.20 | Rake $0 
Seat 1: HammettBets folded before Flop (didn't bet)
Seat 2: Poker Barrie folded before Flop (didn't bet)
Seat 3: phillme13 folded before Flop (didn't bet)
Seat 4: momocgn (button) folded before Flop (didn't bet)
Seat 6: Mrinaldi (small blind) folded before Flop
Seat 7: Alameda22 (big blind) collected ($0.20)
Seat 8: LyolikBY folded before Flop (didn't bet)
Seat 9: ssp25 folded before Flop (didn't bet)



PokerStars Game #19974623898:  Hold'em No Limit ($0.10/$0.25) - 2008/08/28 - 19:46:25 (ET)
Table 'Hippasos IV' 9-max Seat #6 is the button
Seat 1: HammettBets ($15.80 in chips) 
Seat 2: Poker Barrie ($60.65 in chips) 
Seat 3: phillme13 ($30.70 in chips) 
Seat 4: momocgn ($4.70 in chips) 
Seat 6: Mrinaldi ($15.75 in chips) 
Seat 7: Alameda22 ($26.35 in chips) 
Seat 8: LyolikBY ($5 in chips) 
Seat 9: ssp25 ($32.15 in chips) 
Alameda22: posts small blind $0.10
LyolikBY: posts big blind $0.25
*** HOLE CARDS ***
Dealt to Alameda22 [9s Kc]
ssp25: folds 
HammettBets: folds 
Poker Barrie: folds 
phillme13: folds 
ssp25 leaves the table
momocgn: folds 
Mrinaldi: raises $0.50 to $0.75
Alameda22: folds 
LyolikBY: raises $4.25 to $5 and is all-in
Mrinaldi: folds 
Uncalled bet ($4.25) returned to LyolikBY
LyolikBY collected $1.60 from pot
LyolikBY: doesn't show hand 
*** SUMMARY ***
Total pot $1.60 | Rake $0 
Seat 1: HammettBets folded before Flop (didn't bet)
Seat 2: Poker Barrie folded before Flop (didn't bet)
Seat 3: phillme13 folded before Flop (didn't bet)
Seat 4: momocgn folded before Flop (didn't bet)
Seat 6: Mrinaldi (button) folded before Flop
Seat 7: Alameda22 (small blind) folded before Flop
Seat 8: LyolikBY (big blind) collected ($1.60)
Seat 9: ssp25 folded before Flop (didn't bet)



PokerStars Game #19974644212:  Hold'em No Limit ($0.10/$0.25) - 2008/08/28 - 19:47:20 (ET)
Table 'Hippasos IV' 9-max Seat #7 is the button
Seat 1: HammettBets ($15.80 in chips) 
Seat 2: Poker Barrie ($60.65 in chips) 
Seat 3: phillme13 ($30.70 in chips) 
Seat 4: momocgn ($4.70 in chips) 
Seat 6: Mrinaldi ($15 in chips) 
Seat 7: Alameda22 ($26.25 in chips) 
Seat 8: LyolikBY ($5.85 in chips) 
LyolikBY: posts small blind $0.10
HammettBets: posts big blind $0.25
*** HOLE CARDS ***
Dealt to Alameda22 [5s Tc]
Poker Barrie: folds 
phillme13: folds 
momocgn: folds 
Mrinaldi: raises $0.50 to $0.75
Alameda22: folds 
LyolikBY: folds 
HammettBets: folds 
Uncalled bet ($0.50) returned to Mrinaldi
Mrinaldi collected $0.60 from pot
Mrinaldi: doesn't show hand 
*** SUMMARY ***
Total pot $0.60 | Rake $0 
Seat 1: HammettBets (big blind) folded before Flop
Seat 2: Poker Barrie folded before Flop (didn't bet)
Seat 3: phillme13 folded before Flop (didn't bet)
Seat 4: momocgn folded before Flop (didn't bet)
Seat 6: Mrinaldi collected ($0.60)
Seat 7: Alameda22 (button) folded before Flop (didn't bet)
Seat 8: LyolikBY (small blind) folded before Flop



PokerStars Game #19974654667:  Hold'em No Limit ($0.10/$0.25) - 2008/08/28 - 19:47:49 (ET)
Table 'Hippasos IV' 9-max Seat #8 is the button
Seat 1: HammettBets ($15.55 in chips) 
Seat 2: Poker Barrie ($60.65 in chips) 
Seat 3: phillme13 ($30.70 in chips) 
Seat 4: momocgn ($4.70 in chips) 
Seat 6: Mrinaldi ($15.35 in chips) 
Seat 7: Alameda22 ($26.25 in chips) 
Seat 8: LyolikBY ($5.75 in chips) 
HammettBets: posts small blind $0.10
Poker Barrie: posts big blind $0.25
*** HOLE CARDS ***
Dealt to Alameda22 [Th 5c]
phillme13: folds 
momocgn: folds 
Mrinaldi: folds 
Alameda22: folds 
LyolikBY: folds 
HammettBets: calls $0.15
Poker Barrie: checks 
*** FLOP *** [Ts 9d Jd]
HammettBets: bets $0.50
Poker Barrie: folds 
Uncalled bet ($0.50) returned to HammettBets
HammettBets collected $0.50 from pot
HammettBets: doesn't show hand 
*** SUMMARY ***
Total pot $0.50 | Rake $0 
Board [Ts 9d Jd]
Seat 1: HammettBets (small blind) collected ($0.50)
Seat 2: Poker Barrie (big blind) folded on the Flop
Seat 3: phillme13 folded before Flop (didn't bet)
Seat 4: momocgn folded before Flop (didn't bet)
Seat 6: Mrinaldi folded before Flop (didn't bet)
Seat 7: Alameda22 folded before Flop (didn't bet)
Seat 8: LyolikBY (button) folded before Flop (didn't bet)



PokerStars Game #19974668870:  Hold'em No Limit ($0.10/$0.25) - 2008/08/28 - 19:48:27 (ET)
Table 'Hippasos IV' 9-max Seat #1 is the button
Seat 1: HammettBets ($15.80 in chips) 
Seat 2: Poker Barrie ($60.40 in chips) 
Seat 3: phillme13 ($30.70 in chips) 
Seat 4: momocgn ($4.70 in chips) 
Seat 6: Mrinaldi ($15.35 in chips) 
Seat 7: Alameda22 ($26.25 in chips) 
Seat 8: LyolikBY ($5.75 in chips) 
Poker Barrie: posts small blind $0.10
phillme13: posts big blind $0.25
*** HOLE CARDS ***
Dealt to Alameda22 [7s 2s]
momocgn: folds 
Mrinaldi: folds 
Alameda22: folds 
LyolikBY: raises $0.75 to $1
HammettBets: folds 
Poker Barrie: calls $0.90
phillme13: folds 
*** FLOP *** [Qs Kh 5d]
Poker Barrie: bets $1
LyolikBY: raises $3.75 to $4.75 and is all-in
Poker Barrie: calls $3.75
*** TURN *** [Qs Kh 5d] [Kd]
*** RIVER *** [Qs Kh 5d Kd] [9c]
*** SHOW DOWN ***
Poker Barrie: shows [Qd Js] (two pair, Kings and Queens)
LyolikBY: shows [Kc Tc] (three of a kind, Kings)
LyolikBY collected $11.20 from pot
*** SUMMARY ***
Total pot $11.75 | Rake $0.55 
Board [Qs Kh 5d Kd 9c]
Seat 1: HammettBets (button) folded before Flop (didn't bet)
Seat 2: Poker Barrie (small blind) showed [Qd Js] and lost with two pair, Kings and Queens
Seat 3: phillme13 (big blind) folded before Flop
Seat 4: momocgn folded before Flop (didn't bet)
Seat 6: Mrinaldi folded before Flop (didn't bet)
Seat 7: Alameda22 folded before Flop (didn't bet)
Seat 8: LyolikBY showed [Kc Tc] and won ($11.20) with three of a kind, Kings



PokerStars Game #19974686583:  Hold'em No Limit ($0.10/$0.25) - 2008/08/28 - 19:49:15 (ET)
Table 'Hippasos IV' 9-max Seat #2 is the button
Seat 1: HammettBets ($15.80 in chips) 
Seat 2: Poker Barrie ($54.65 in chips) 
Seat 3: phillme13 ($30.45 in chips) 
Seat 4: momocgn ($4.70 in chips) 
Seat 6: Mrinaldi ($15.35 in chips) 
Seat 7: Alameda22 ($26.25 in chips) 
Seat 8: LyolikBY ($11.20 in chips) 
phillme13: posts small blind $0.10
momocgn: posts big blind $0.25
*** HOLE CARDS ***
Dealt to Alameda22 [7h 4h]
Mrinaldi: calls $0.25
Alameda22: folds 
LyolikBY: folds 
HammettBets: folds 
Poker Barrie: calls $0.25
phillme13: calls $0.15
momocgn: checks 
*** FLOP *** [4c Kc 9d]
phillme13: checks 
momocgn: checks 
Mrinaldi: bets $1
Poker Barrie: calls $1
phillme13: folds 
momocgn: folds 
*** TURN *** [4c Kc 9d] [9c]
Mrinaldi: bets $2
Poker Barrie: raises $2 to $4
Zchien joins the table at seat #9 
Mrinaldi: raises $10.10 to $14.10 and is all-in
Poker Barrie: calls $10.10
*** RIVER *** [4c Kc 9d 9c] [Jc]
*** SHOW DOWN ***
Mrinaldi: shows [8c Ac] (a flush, Ace high)
Poker Barrie: mucks hand 
Mrinaldi collected $29.65 from pot
*** SUMMARY ***
Total pot $31.20 | Rake $1.55 
Board [4c Kc 9d 9c Jc]
Seat 1: HammettBets folded before Flop (didn't bet)
Seat 2: Poker Barrie (button) mucked [Tc 5c]
Seat 3: phillme13 (small blind) folded on the Flop
Seat 4: momocgn (big blind) folded on the Flop
Seat 6: Mrinaldi showed [8c Ac] and won ($29.65) with a flush, Ace high
Seat 7: Alameda22 folded before Flop (didn't bet)
Seat 8: LyolikBY folded before Flop (didn't bet)



PokerStars Game #19974716387:  Hold'em No Limit ($0.10/$0.25) - 2008/08/28 - 19:50:38 (ET)
Table 'Hippasos IV' 9-max Seat #3 is the button
Seat 1: HammettBets ($15.80 in chips) 
Seat 2: Poker Barrie ($39.30 in chips) 
Seat 3: phillme13 ($30.20 in chips) 
Seat 4: momocgn ($4.45 in chips) 
Seat 6: Mrinaldi ($29.65 in chips) 
Seat 7: Alameda22 ($26.25 in chips) 
Seat 8: LyolikBY ($11.20 in chips) 
Seat 9: Zchien ($5 in chips) 
momocgn: posts small blind $0.10
Mrinaldi: posts big blind $0.25
Zchien: posts big blind $0.25
*** HOLE CARDS ***
Dealt to Alameda22 [5s 8s]
Alameda22: folds 
LyolikBY: folds 
Zchien: checks 
HammettBets: raises $0.50 to $0.75
Poker Barrie: folds 
phillme13: folds 
momocgn: folds 
Mrinaldi: folds 
Zchien: calls $0.50
*** FLOP *** [6d Th 8h]
Zchien: checks 
HammettBets: bets $0.75
Zchien: calls $0.75
*** TURN *** [6d Th 8h] [3d]
Zchien: checks 
HammettBets: checks 
*** RIVER *** [6d Th 8h 3d] [4d]
Zchien: bets $1.50
HammettBets: folds 
Uncalled bet ($1.50) returned to Zchien
Zchien collected $3.20 from pot
Zchien: doesn't show hand 
*** SUMMARY ***
Total pot $3.35 | Rake $0.15 
Board [6d Th 8h 3d 4d]
Seat 1: HammettBets folded on the River
Seat 2: Poker Barrie folded before Flop (didn't bet)
Seat 3: phillme13 (button) folded before Flop (didn't bet)
Seat 4: momocgn (small blind) folded before Flop
Seat 6: Mrinaldi (big blind) folded before Flop
Seat 7: Alameda22 folded before Flop (didn't bet)
Seat 8: LyolikBY folded before Flop (didn't bet)
Seat 9: Zchien collected ($3.20)



PokerStars Game #19974750899:  Hold'em No Limit ($0.10/$0.25) - 2008/08/28 - 19:52:13 (ET)
Table 'Hippasos IV' 9-max Seat #4 is the button
Seat 1: HammettBets ($14.30 in chips) 
Seat 2: Poker Barrie ($39.30 in chips) 
Seat 3: phillme13 ($30.20 in chips) 
Seat 4: momocgn ($4.35 in chips) 
Seat 6: Mrinaldi ($29.40 in chips) 
Seat 7: Alameda22 ($26.25 in chips) 
Seat 8: LyolikBY ($11.20 in chips) 
Seat 9: Zchien ($6.70 in chips) 
Mrinaldi: posts small blind $0.10
Alameda22: posts big blind $0.25
*** HOLE CARDS ***
Dealt to Alameda22 [Jc 5h]
LyolikBY: folds 
Zchien: folds 
LyolikBY leaves the table
HammettBets: raises $0.50 to $0.75
Poker Barrie: raises $0.50 to $1.25
phillme13: folds 
momocgn: folds 
Mrinaldi: folds 
Alameda22: folds 
HammettBets: calls $0.50
*** FLOP *** [Kh 6d Jh]
HammettBets: checks 
Poker Barrie: bets $1.25
HammettBets: folds 
Uncalled bet ($1.25) returned to Poker Barrie
Poker Barrie collected $2.75 from pot
Poker Barrie: doesn't show hand 
*** SUMMARY ***
Total pot $2.85 | Rake $0.10 
Board [Kh 6d Jh]
Seat 1: HammettBets folded on the Flop
Seat 2: Poker Barrie collected ($2.75)
Seat 3: phillme13 folded before Flop (didn't bet)
Seat 4: momocgn (button) folded before Flop (didn't bet)
Seat 6: Mrinaldi (small blind) folded before Flop
Seat 7: Alameda22 (big blind) folded before Flop
Seat 8: LyolikBY folded before Flop (didn't bet)
Seat 9: Zchien folded before Flop (didn't bet)



PokerStars Game #19974771339:  Hold'em No Limit ($0.10/$0.25) - 2008/08/28 - 19:53:09 (ET)
Table 'Hippasos IV' 9-max Seat #6 is the button
Seat 1: HammettBets ($13.05 in chips) 
Seat 2: Poker Barrie ($40.80 in chips) 
Seat 3: phillme13 ($30.20 in chips) 
Seat 4: momocgn ($4.35 in chips) 
Seat 6: Mrinaldi ($29.30 in chips) 
Seat 7: Alameda22 ($26 in chips) 
Seat 9: Zchien ($6.70 in chips) 
Alameda22: posts small blind $0.10
Zchien: posts big blind $0.25
*** HOLE CARDS ***
Dealt to Alameda22 [Qc Qh]
HammettBets: folds 
Poker Barrie: folds 
phillme13: folds 
momocgn: folds 
Mrinaldi: folds 
Alameda22: raises $0.50 to $0.75
Zchien: calls $0.50
*** FLOP *** [7s 3c 4d]
Alameda22: bets $1
Zchien: calls $1
*** TURN *** [7s 3c 4d] [5s]
Alameda22: bets $2
Zchien: calls $2
*** RIVER *** [7s 3c 4d 5s] [Kc]
Alameda22: checks 
Zchien: checks 
*** SHOW DOWN ***
Alameda22: shows [Qc Qh] (a pair of Queens)
Zchien: shows [Td 7h] (a pair of Sevens)
Alameda22 collected $7.15 from pot
*** SUMMARY ***
Total pot $7.50 | Rake $0.35 
Board [7s 3c 4d 5s Kc]
Seat 1: HammettBets folded before Flop (didn't bet)
Seat 2: Poker Barrie folded before Flop (didn't bet)
Seat 3: phillme13 folded before Flop (didn't bet)
Seat 4: momocgn folded before Flop (didn't bet)
Seat 6: Mrinaldi (button) folded before Flop (didn't bet)
Seat 7: Alameda22 (small blind) showed [Qc Qh] and won ($7.15) with a pair of Queens
Seat 9: Zchien (big blind) showed [Td 7h] and lost with a pair of Sevens



PokerStars Game #19974805720:  Hold'em No Limit ($0.10/$0.25) - 2008/08/28 - 19:54:43 (ET)
Table 'Hippasos IV' 9-max Seat #7 is the button
Seat 1: HammettBets ($13.05 in chips) 
Seat 2: Poker Barrie ($40.80 in chips) 
Seat 3: phillme13 ($30.20 in chips) 
Seat 4: momocgn ($4.35 in chips) 
Seat 6: Mrinaldi ($29.30 in chips) 
Seat 7: Alameda22 ($29.40 in chips) 
Seat 9: Zchien ($2.95 in chips) 
Zchien: posts small blind $0.10
HammettBets: posts big blind $0.25
*** HOLE CARDS ***
Dealt to Alameda22 [Qd 4h]
Poker Barrie: raises $0.50 to $0.75
phillme13: calls $0.75
momocgn: folds 
Mrinaldi: folds 
Alameda22: folds 
Zchien: folds 
HammettBets: folds 
*** FLOP *** [Kh 5c Td]
Poker Barrie: checks 
phillme13: checks 
*** TURN *** [Kh 5c Td] [5h]
Poker Barrie: checks 
phillme13: checks 
*** RIVER *** [Kh 5c Td 5h] [9h]
Poker Barrie: checks 
phillme13: bets $1.50
Poker Barrie: calls $1.50
*** SHOW DOWN ***
phillme13: shows [9d 9s] (a full house, Nines full of Fives)
Poker Barrie: mucks hand 
phillme13 collected $4.65 from pot
*** SUMMARY ***
Total pot $4.85 | Rake $0.20 
Board [Kh 5c Td 5h 9h]
Seat 1: HammettBets (big blind) folded before Flop
Seat 2: Poker Barrie mucked [2d 2s]
Seat 3: phillme13 showed [9d 9s] and won ($4.65) with a full house, Nines full of Fives
Seat 4: momocgn folded before Flop (didn't bet)
Seat 6: Mrinaldi folded before Flop (didn't bet)
Seat 7: Alameda22 (button) folded before Flop (didn't bet)
Seat 9: Zchien (small blind) folded before Flop



PokerStars Game #19974823298:  Hold'em No Limit ($0.10/$0.25) - 2008/08/28 - 19:55:32 (ET)
Table 'Hippasos IV' 9-max Seat #9 is the button
Seat 1: HammettBets ($12.80 in chips) 
Seat 2: Poker Barrie ($38.55 in chips) 
Seat 3: phillme13 ($32.60 in chips) 
Seat 4: momocgn ($4.35 in chips) 
Seat 6: Mrinaldi ($29.30 in chips) 
Seat 7: Alameda22 ($29.40 in chips) 
Seat 9: Zchien ($2.85 in chips) 
HammettBets: posts small blind $0.10
Poker Barrie: posts big blind $0.25
*** HOLE CARDS ***
Dealt to Alameda22 [2d Jd]
phillme13: calls $0.25
momocgn: folds 
Mrinaldi: folds 
Alameda22: folds 
Zchien: folds 
HammettBets: calls $0.15
Poker Barrie: checks 
*** FLOP *** [9h 8h Tc]
HammettBets: checks 
Poker Barrie: bets $0.75
phillme13: calls $0.75
HammettBets: folds 
*** TURN *** [9h 8h Tc] [5c]
Poker Barrie: bets $0.75
phillme13: calls $0.75
*** RIVER *** [9h 8h Tc 5c] [4h]
Poker Barrie: bets $1
phillme13: calls $1
*** SHOW DOWN ***
Poker Barrie: shows [9c 6d] (a pair of Nines)
phillme13: shows [Jh Jc] (a pair of Jacks)
phillme13 collected $5.50 from pot
*** SUMMARY ***
Total pot $5.75 | Rake $0.25 
Board [9h 8h Tc 5c 4h]
Seat 1: HammettBets (small blind) folded on the Flop
Seat 2: Poker Barrie (big blind) showed [9c 6d] and lost with a pair of Nines
Seat 3: phillme13 showed [Jh Jc] and won ($5.50) with a pair of Jacks
Seat 4: momocgn folded before Flop (didn't bet)
Seat 6: Mrinaldi folded before Flop (didn't bet)
Seat 7: Alameda22 folded before Flop (didn't bet)
Seat 9: Zchien (button) folded before Flop (didn't bet)



PokerStars Game #19974839845:  Hold'em No Limit ($0.10/$0.25) - 2008/08/28 - 19:56:17 (ET)
Table 'Hippasos IV' 9-max Seat #1 is the button
Seat 1: HammettBets ($12.55 in chips) 
Seat 2: Poker Barrie ($35.80 in chips) 
Seat 3: phillme13 ($35.35 in chips) 
Seat 4: momocgn ($4.35 in chips) 
Seat 6: Mrinaldi ($29.30 in chips) 
Seat 7: Alameda22 ($29.40 in chips) 
Seat 9: Zchien ($2.85 in chips) 
Poker Barrie: posts small blind $0.10
phillme13: posts big blind $0.25
*** HOLE CARDS ***
Dealt to Alameda22 [6d 9d]
momocgn: folds 
Mrinaldi: folds 
Alameda22: folds 
Zchien: raises $0.75 to $1
HammettBets: folds 
Poker Barrie: folds 
phillme13: calls $0.75
*** FLOP *** [8h Ah Tc]
phillme13: checks 
Zchien: bets $1
phillme13: folds 
Uncalled bet ($1) returned to Zchien
Zchien collected $2 from pot
Zchien: doesn't show hand 
*** SUMMARY ***
Total pot $2.10 | Rake $0.10 
Board [8h Ah Tc]
Seat 1: HammettBets (button) folded before Flop (didn't bet)
Seat 2: Poker Barrie (small blind) folded before Flop
Seat 3: phillme13 (big blind) folded on the Flop
Seat 4: momocgn folded before Flop (didn't bet)
Seat 6: Mrinaldi folded before Flop (didn't bet)
Seat 7: Alameda22 folded before Flop (didn't bet)
Seat 9: Zchien collected ($2)



PokerStars Game #19974853550:  Hold'em No Limit ($0.10/$0.25) - 2008/08/28 - 19:56:55 (ET)
Table 'Hippasos IV' 9-max Seat #2 is the button
Seat 1: HammettBets ($12.55 in chips) 
Seat 2: Poker Barrie ($35.70 in chips) 
Seat 3: phillme13 ($34.35 in chips) 
Seat 4: momocgn ($4.35 in chips) 
Seat 6: Mrinaldi ($29.30 in chips) 
Seat 7: Alameda22 ($29.40 in chips) 
Seat 9: Zchien ($3.85 in chips) 
phillme13: posts small blind $0.10
momocgn: posts big blind $0.25
*** HOLE CARDS ***
Dealt to Alameda22 [9d 5c]
Mrinaldi: raises $0.50 to $0.75
Alameda22: folds 
Zchien: calls $0.75
HammettBets: folds 
Poker Barrie: calls $0.75
phillme13: folds 
momocgn: folds 
*** FLOP *** [Js Jd 4d]
brujo120 joins the table at seat #5 
Mrinaldi: checks 
Zchien: checks 
Poker Barrie: bets $0.75
Mrinaldi: calls $0.75
Zchien: folds 
*** TURN *** [Js Jd 4d] [9c]
Mrinaldi: checks 
Poker Barrie: bets $1
Mrinaldi: calls $1
*** RIVER *** [Js Jd 4d 9c] [2s]
Mrinaldi: checks 
Poker Barrie: bets $2.50
Mrinaldi: calls $2.50
Linndim joins the table at seat #8 
*** SHOW DOWN ***
Poker Barrie: shows [Th Jc] (three of a kind, Jacks)
Mrinaldi: mucks hand 
Poker Barrie collected $10.60 from pot
*** SUMMARY ***
Total pot $11.10 | Rake $0.50 
Board [Js Jd 4d 9c 2s]
Seat 1: HammettBets folded before Flop (didn't bet)
Seat 2: Poker Barrie (button) showed [Th Jc] and won ($10.60) with three of a kind, Jacks
Seat 3: phillme13 (small blind) folded before Flop
Seat 4: momocgn (big blind) folded before Flop
Seat 6: Mrinaldi mucked [8d 8c]
Seat 7: Alameda22 folded before Flop (didn't bet)
Seat 9: Zchien folded on the Flop



PokerStars Game #19974882823:  Hold'em No Limit ($0.10/$0.25) - 2008/08/28 - 19:58:17 (ET)
Table 'Hippasos IV' 9-max Seat #3 is the button
Seat 1: HammettBets ($12.55 in chips) 
Seat 2: Poker Barrie ($41.30 in chips) 
Seat 3: phillme13 ($34.25 in chips) 
Seat 4: momocgn ($5 in chips) 
Seat 5: brujo120 ($15 in chips) 
Seat 6: Mrinaldi ($24.30 in chips) 
Seat 7: Alameda22 ($29.40 in chips) 
Seat 8: Linndim ($7.35 in chips) 
Seat 9: Zchien ($3.10 in chips) 
momocgn: posts small blind $0.10
brujo120: posts big blind $0.25
Linndim: posts big blind $0.25
*** HOLE CARDS ***
Dealt to Alameda22 [Kc Jd]
Mrinaldi: calls $0.25
Alameda22: folds 
Linndim: checks 
Zchien: calls $0.25
HammettBets: folds 
Poker Barrie: folds 
phillme13: folds 
momocgn: calls $0.15
brujo120: checks 
*** FLOP *** [2h 9c Ac]
momocgn: bets $0.50
brujo120: folds 
Mrinaldi: calls $0.50
Linndim: calls $0.50
Zchien: calls $0.50
*** TURN *** [2h 9c Ac] [8s]
momocgn: bets $1
Mrinaldi: calls $1
Linndim: calls $1
Zchien: folds 
*** RIVER *** [2h 9c Ac 8s] [Td]
momocgn: bets $2.75
Mrinaldi: folds 
Linndim: folds 
Uncalled bet ($2.75) returned to momocgn
momocgn collected $5.95 from pot
momocgn leaves the table
*** SUMMARY ***
Total pot $6.25 | Rake $0.30 
Board [2h 9c Ac 8s Td]
Seat 1: HammettBets folded before Flop (didn't bet)
Seat 2: Poker Barrie folded before Flop (didn't bet)
Seat 3: phillme13 (button) folded before Flop (didn't bet)
Seat 4: momocgn (small blind) collected ($5.95)
Seat 5: brujo120 (big blind) folded on the Flop
Seat 6: Mrinaldi folded on the River
Seat 7: Alameda22 folded before Flop (didn't bet)
Seat 8: Linndim folded on the River
Seat 9: Zchien folded on the Turn



PokerStars Game #19974905775:  Hold'em No Limit ($0.10/$0.25) - 2008/08/28 - 19:59:21 (ET)
Table 'Hippasos IV' 9-max Seat #5 is the button
Seat 1: HammettBets ($12.55 in chips) 
Seat 2: Poker Barrie ($41.30 in chips) 
Seat 3: phillme13 ($34.25 in chips) 
Seat 5: brujo120 ($14.75 in chips) 
Seat 6: Mrinaldi ($22.55 in chips) 
Seat 7: Alameda22 ($29.40 in chips) 
Seat 8: Linndim ($5.60 in chips) 
Seat 9: Zchien ($2.35 in chips) 
Mrinaldi: posts small blind $0.10
Alameda22: posts big blind $0.25
*** HOLE CARDS ***
Dealt to Alameda22 [9h 4h]
Linndim: calls $0.25
Zchien: calls $0.25
HammettBets: raises $0.50 to $0.75
Poker Barrie: folds 
phillme13: folds 
brujo120: folds 
Mrinaldi: folds 
Alameda22: folds 
Linndim: calls $0.50
Zchien: calls $0.50
*** FLOP *** [Ac Qd Jd]
Linndim: bets $0.75
Zchien: calls $0.75
HammettBets: folds 
*** TURN *** [Ac Qd Jd] [Qh]
Linndim: bets $1.75
Zchien: calls $0.85 and is all-in
Uncalled bet ($0.90) returned to Linndim
*** RIVER *** [Ac Qd Jd Qh] [4s]
*** SHOW DOWN ***
Linndim: shows [7d 5d] (a pair of Queens)
Zchien: shows [8s Ad] (two pair, Aces and Queens)
Zchien collected $5.55 from pot
*** SUMMARY ***
Total pot $5.80 | Rake $0.25 
Board [Ac Qd Jd Qh 4s]
Seat 1: HammettBets folded on the Flop
Seat 2: Poker Barrie folded before Flop (didn't bet)
Seat 3: phillme13 folded before Flop (didn't bet)
Seat 5: brujo120 (button) folded before Flop (didn't bet)
Seat 6: Mrinaldi (small blind) folded before Flop
Seat 7: Alameda22 (big blind) folded before Flop
Seat 8: Linndim showed [7d 5d] and lost with a pair of Queens
Seat 9: Zchien showed [8s Ad] and won ($5.55) with two pair, Aces and Queens



PokerStars Game #19974924548:  Hold'em No Limit ($0.10/$0.25) - 2008/08/28 - 20:00:11 (ET)
Table 'Hippasos IV' 9-max Seat #6 is the button
Seat 1: HammettBets ($11.80 in chips) 
Seat 2: Poker Barrie ($41.30 in chips) 
Seat 3: phillme13 ($34.25 in chips) 
Seat 5: brujo120 ($14.75 in chips) 
Seat 6: Mrinaldi ($22.45 in chips) 
Seat 7: Alameda22 ($29.15 in chips) 
Seat 8: Linndim ($3.25 in chips) 
Seat 9: Zchien ($5.55 in chips) 
Alameda22: posts small blind $0.10
Linndim: posts big blind $0.25
*** HOLE CARDS ***
Dealt to Alameda22 [2c Kc]
Zchien: calls $0.25
HammettBets: folds 
Poker Barrie: folds 
phillme13: calls $0.25
brujo120 has timed out
brujo120: folds 
brujo120 is sitting out
Mrinaldi: folds 
Alameda22: folds 
Linndim: checks 
*** FLOP *** [Qd Ks 5h]
Linndim: checks 
Zchien: checks 
phillme13: checks 
*** TURN *** [Qd Ks 5h] [Qc]
Linndim: checks 
Zchien: checks 
phillme13: bets $0.75
Linndim: folds 
brujo120 has returned
Zchien: folds 
Uncalled bet ($0.75) returned to phillme13
phillme13 collected $0.85 from pot
phillme13: doesn't show hand 
*** SUMMARY ***
Total pot $0.85 | Rake $0 
Board [Qd Ks 5h Qc]
Seat 1: HammettBets folded before Flop (didn't bet)
Seat 2: Poker Barrie folded before Flop (didn't bet)
Seat 3: phillme13 collected ($0.85)
Seat 5: brujo120 folded before Flop (didn't bet)
Seat 6: Mrinaldi (button) folded before Flop (didn't bet)
Seat 7: Alameda22 (small blind) folded before Flop
Seat 8: Linndim (big blind) folded on the Turn
Seat 9: Zchien folded on the Turn



PokerStars Game #19974956076:  Hold'em No Limit ($0.10/$0.25) - 2008/08/28 - 20:01:37 (ET)
Table 'Hippasos IV' 9-max Seat #7 is the button
Seat 1: HammettBets ($11.80 in chips) 
Seat 2: Poker Barrie ($41.30 in chips) 
Seat 3: phillme13 ($34.85 in chips) 
Seat 5: brujo120 ($14.75 in chips) 
Seat 6: Mrinaldi ($22.45 in chips) 
Seat 7: Alameda22 ($29.05 in chips) 
Seat 8: Linndim ($3 in chips) 
Seat 9: Zchien ($5.30 in chips) 
Linndim: posts small blind $0.10
Zchien: posts big blind $0.25
*** HOLE CARDS ***
Dealt to Alameda22 [Ah 7d]
HammettBets: folds 
Poker Barrie: folds 
phillme13: folds 
brujo120: folds 
Mrinaldi: raises $0.50 to $0.75
Alameda22: folds 
Linndim: calls $0.65
Zchien: calls $0.50
*** FLOP *** [Th Ts 6c]
Linndim: checks 
Zchien: checks 
Mrinaldi: checks 
*** TURN *** [Th Ts 6c] [Kd]
Linndim: checks 
Zchien: checks 
Mrinaldi: checks 
*** RIVER *** [Th Ts 6c Kd] [Ad]
Linndim: checks 
Zchien: checks 
Mrinaldi: checks 
*** SHOW DOWN ***
Linndim: shows [8c Qc] (a pair of Tens)
Zchien: mucks hand 
Mrinaldi: shows [Kh Qh] (two pair, Kings and Tens)
Mrinaldi collected $2.15 from pot
*** SUMMARY ***
Total pot $2.25 | Rake $0.10 
Board [Th Ts 6c Kd Ad]
Seat 1: HammettBets folded before Flop (didn't bet)
Seat 2: Poker Barrie folded before Flop (didn't bet)
Seat 3: phillme13 folded before Flop (didn't bet)
Seat 5: brujo120 folded before Flop (didn't bet)
Seat 6: Mrinaldi showed [Kh Qh] and won ($2.15) with two pair, Kings and Tens
Seat 7: Alameda22 (button) folded before Flop (didn't bet)
Seat 8: Linndim (small blind) showed [8c Qc] and lost with a pair of Tens
Seat 9: Zchien (big blind) mucked [Jd 3d]



PokerStars Game #19974977184:  Hold'em No Limit ($0.10/$0.25) - 2008/08/28 - 20:02:35 (ET)
Table 'Hippasos IV' 9-max Seat #8 is the button
Seat 1: HammettBets ($11.80 in chips) 
Seat 2: Poker Barrie ($41.30 in chips) 
Seat 3: phillme13 ($34.85 in chips) 
Seat 5: brujo120 ($14.75 in chips) 
Seat 6: Mrinaldi ($23.85 in chips) 
Seat 7: Alameda22 ($29.05 in chips) 
Seat 8: Linndim ($2.25 in chips) 
Seat 9: Zchien ($4.55 in chips) 
Zchien: posts small blind $0.10
HammettBets: posts big blind $0.25
*** HOLE CARDS ***
Dealt to Alameda22 [Jd Jc]
Poker Barrie: folds 
phillme13: folds 
brujo120: folds 
Mrinaldi: folds 
Alameda22: raises $0.50 to $0.75
Linndim: raises $1.50 to $2.25 and is all-in
Zchien: folds 
HammettBets: folds 
Alameda22: calls $1.50
*** FLOP *** [Jh Kc 2d]
*** TURN *** [Jh Kc 2d] [2s]
*** RIVER *** [Jh Kc 2d 2s] [5s]
*** SHOW DOWN ***
Alameda22: shows [Jd Jc] (a full house, Jacks full of Deuces)
Linndim: mucks hand 
Alameda22 collected $4.65 from pot
Linndim leaves the table
*** SUMMARY ***
Total pot $4.85 | Rake $0.20 
Board [Jh Kc 2d 2s 5s]
Seat 1: HammettBets (big blind) folded before Flop
Seat 2: Poker Barrie folded before Flop (didn't bet)
Seat 3: phillme13 folded before Flop (didn't bet)
Seat 5: brujo120 folded before Flop (didn't bet)
Seat 6: Mrinaldi folded before Flop (didn't bet)
Seat 7: Alameda22 showed [Jd Jc] and won ($4.65) with a full house, Jacks full of Deuces
Seat 8: Linndim (button) mucked [Ks 9d]
Seat 9: Zchien (small blind) folded before Flop



PokerStars Game #19974994614:  Hold'em No Limit ($0.10/$0.25) - 2008/08/28 - 20:03:24 (ET)
Table 'Hippasos IV' 9-max Seat #9 is the button
Seat 1: HammettBets ($11.55 in chips) 
Seat 2: Poker Barrie ($41.30 in chips) 
Seat 3: phillme13 ($34.85 in chips) 
Seat 5: brujo120 ($14.75 in chips) 
Seat 6: Mrinaldi ($23.85 in chips) 
Seat 7: Alameda22 ($31.45 in chips) 
Seat 9: Zchien ($4.45 in chips) 
HammettBets: posts small blind $0.10
Poker Barrie: posts big blind $0.25
*** HOLE CARDS ***
Dealt to Alameda22 [Jc 7d]
phillme13: folds 
brujo120: folds 
Mrinaldi: folds 
Alameda22: folds 
LuckyGeo1 joins the table at seat #4 
Zchien: calls $0.25
Joe1973 joins the table at seat #8 
HammettBets: calls $0.15
Poker Barrie: checks 
*** FLOP *** [Jh As Td]
HammettBets: checks 
Poker Barrie: bets $0.50
Zchien: calls $0.50
HammettBets: folds 
*** TURN *** [Jh As Td] [3c]
Poker Barrie: checks 
Zchien: checks 
*** RIVER *** [Jh As Td 3c] [2d]
Poker Barrie: checks 
Zchien: bets $1
Poker Barrie: calls $1
*** SHOW DOWN ***
Zchien: shows [Kh 6h] (high card Ace)
Poker Barrie: shows [Ts Kd] (a pair of Tens)
Poker Barrie collected $3.60 from pot
*** SUMMARY ***
Total pot $3.75 | Rake $0.15 
Board [Jh As Td 3c 2d]
Seat 1: HammettBets (small blind) folded on the Flop
Seat 2: Poker Barrie (big blind) showed [Ts Kd] and won ($3.60) with a pair of Tens
Seat 3: phillme13 folded before Flop (didn't bet)
Seat 5: brujo120 folded before Flop (didn't bet)
Seat 6: Mrinaldi folded before Flop (didn't bet)
Seat 7: Alameda22 folded before Flop (didn't bet)
Seat 9: Zchien (button) showed [Kh 6h] and lost with high card Ace



PokerStars Game #19975024740:  Hold'em No Limit ($0.10/$0.25) - 2008/08/28 - 20:04:47 (ET)
Table 'Hippasos IV' 9-max Seat #1 is the button
Seat 1: HammettBets ($11.30 in chips) 
Seat 2: Poker Barrie ($43.15 in chips) 
Seat 3: phillme13 ($34.85 in chips) 
Seat 4: LuckyGeo1 ($8 in chips) 
Seat 5: brujo120 ($14.75 in chips) 
Seat 6: Mrinaldi ($23.85 in chips) 
Seat 7: Alameda22 ($31.45 in chips) 
Seat 8: Joe1973 ($5 in chips) 
Seat 9: Zchien ($2.70 in chips) 
Poker Barrie: posts small blind $0.10
phillme13: posts big blind $0.25
LuckyGeo1: posts big blind $0.25
Joe1973: posts big blind $0.25
*** HOLE CARDS ***
Dealt to Alameda22 [9s Jd]
Zchien said, "nh"
LuckyGeo1: checks 
brujo120: calls $0.25
Mrinaldi: folds 
Alameda22: folds 
Joe1973: checks 
Zchien: folds 
HammettBets: raises $0.50 to $0.75
Poker Barrie: folds 
phillme13: folds 
LuckyGeo1: folds 
brujo120: folds 
Joe1973: folds 
Uncalled bet ($0.50) returned to HammettBets
HammettBets collected $1.35 from pot
HammettBets: doesn't show hand 
*** SUMMARY ***
Total pot $1.35 | Rake $0 
Seat 1: HammettBets (button) collected ($1.35)
Seat 2: Poker Barrie (small blind) folded before Flop
Seat 3: phillme13 (big blind) folded before Flop
Seat 4: LuckyGeo1 folded before Flop
Seat 5: brujo120 folded before Flop
Seat 6: Mrinaldi folded before Flop (didn't bet)
Seat 7: Alameda22 folded before Flop (didn't bet)
Seat 8: Joe1973 folded before Flop
Seat 9: Zchien folded before Flop (didn't bet)



PokerStars Game #19975042645:  Hold'em No Limit ($0.10/$0.25) - 2008/08/28 - 20:05:37 (ET)
Table 'Hippasos IV' 9-max Seat #2 is the button
Seat 1: HammettBets ($12.40 in chips) 
Seat 2: Poker Barrie ($43.05 in chips) 
Seat 3: phillme13 ($34.60 in chips) 
Seat 4: LuckyGeo1 ($7.75 in chips) 
Seat 5: brujo120 ($14.50 in chips) 
Seat 6: Mrinaldi ($23.85 in chips) 
Seat 7: Alameda22 ($31.45 in chips) 
Seat 8: Joe1973 ($4.75 in chips) 
Seat 9: Zchien ($2.70 in chips) 
phillme13: posts small blind $0.10
LuckyGeo1: posts big blind $0.25
*** HOLE CARDS ***
Dealt to Alameda22 [5h Ts]
brujo120: folds 
Mrinaldi: folds 
Alameda22: folds 
Joe1973: folds 
Zchien: calls $0.25
HammettBets: folds 
Poker Barrie: folds 
phillme13: folds 
LuckyGeo1: raises $0.25 to $0.50
Zchien: calls $0.25
*** FLOP *** [2c Qd 9c]
LuckyGeo1: bets $1
Zchien: calls $1
*** TURN *** [2c Qd 9c] [2s]
LuckyGeo1: bets $1
Zchien: calls $1
*** RIVER *** [2c Qd 9c 2s] [Td]
LuckyGeo1: checks 
Zchien: bets $0.20 and is all-in
LuckyGeo1: calls $0.20
*** SHOW DOWN ***
Zchien: shows [Qc 9h] (two pair, Queens and Nines)
LuckyGeo1: mucks hand 
Zchien collected $5.25 from pot
*** SUMMARY ***
Total pot $5.50 | Rake $0.25 
Board [2c Qd 9c 2s Td]
Seat 1: HammettBets folded before Flop (didn't bet)
Seat 2: Poker Barrie (button) folded before Flop (didn't bet)
Seat 3: phillme13 (small blind) folded before Flop
Seat 4: LuckyGeo1 (big blind) mucked [8s 8d]
Seat 5: brujo120 folded before Flop (didn't bet)
Seat 6: Mrinaldi folded before Flop (didn't bet)
Seat 7: Alameda22 folded before Flop (didn't bet)
Seat 8: Joe1973 folded before Flop (didn't bet)
Seat 9: Zchien showed [Qc 9h] and won ($5.25) with two pair, Queens and Nines



PokerStars Game #19975065313:  Hold'em No Limit ($0.10/$0.25) - 2008/08/28 - 20:06:41 (ET)
Table 'Hippasos IV' 9-max Seat #3 is the button
Seat 1: HammettBets ($12.40 in chips) 
Seat 2: Poker Barrie ($43.05 in chips) 
Seat 3: phillme13 ($34.50 in chips) 
Seat 4: LuckyGeo1 ($5.05 in chips) 
Seat 5: brujo120 ($14.50 in chips) 
Seat 6: Mrinaldi ($23.85 in chips) 
Seat 7: Alameda22 ($31.45 in chips) 
Seat 8: Joe1973 ($4.75 in chips) 
Seat 9: Zchien ($5.25 in chips) 
LuckyGeo1: posts small blind $0.10
brujo120: posts big blind $0.25
*** HOLE CARDS ***
Dealt to Alameda22 [Tc Jd]
Mrinaldi: calls $0.25
Alameda22: folds 
Joe1973: raises $0.50 to $0.75
Zchien: calls $0.75
HammettBets: folds 
Poker Barrie: folds 
phillme13: folds 
LuckyGeo1: calls $0.65
brujo120: folds 
Mrinaldi: calls $0.50
*** FLOP *** [7h 5c Js]
LuckyGeo1: checks 
Mrinaldi: checks 
Joe1973: bets $1
Zchien: folds 
LuckyGeo1: calls $1
Mrinaldi: folds 
*** TURN *** [7h 5c Js] [Kc]
LuckyGeo1: checks 
Joe1973: bets $1.50
LuckyGeo1: folds 
Uncalled bet ($1.50) returned to Joe1973
Joe1973 collected $5 from pot
Joe1973: doesn't show hand 
*** SUMMARY ***
Total pot $5.25 | Rake $0.25 
Board [7h 5c Js Kc]
Seat 1: HammettBets folded before Flop (didn't bet)
Seat 2: Poker Barrie folded before Flop (didn't bet)
Seat 3: phillme13 (button) folded before Flop (didn't bet)
Seat 4: LuckyGeo1 (small blind) folded on the Turn
Seat 5: brujo120 (big blind) folded before Flop
Seat 6: Mrinaldi folded on the Flop
Seat 7: Alameda22 folded before Flop (didn't bet)
Seat 8: Joe1973 collected ($5)
Seat 9: Zchien folded on the Flop



PokerStars Game #19975094413:  Hold'em No Limit ($0.10/$0.25) - 2008/08/28 - 20:08:02 (ET)
Table 'Hippasos IV' 9-max Seat #4 is the button
Seat 1: HammettBets ($12.40 in chips) 
Seat 2: Poker Barrie ($43.05 in chips) 
Seat 3: phillme13 ($34.50 in chips) 
Seat 4: LuckyGeo1 ($3.30 in chips) 
Seat 5: brujo120 ($14.25 in chips) 
Seat 6: Mrinaldi ($23.10 in chips) 
Seat 7: Alameda22 ($31.45 in chips) 
Seat 8: Joe1973 ($8 in chips) 
Seat 9: Zchien ($4.50 in chips) 
brujo120: posts small blind $0.10
Mrinaldi: posts big blind $0.25
*** HOLE CARDS ***
Dealt to Alameda22 [Tc 5s]
Alameda22: folds 
Joe1973: calls $0.25
Zchien: folds 
HammettBets: calls $0.25
Poker Barrie: raises $0.75 to $1
phillme13: folds 
LuckyGeo1: folds 
brujo120: calls $0.90
Mrinaldi: folds 
Joe1973: calls $0.75
HammettBets: calls $0.75
*** FLOP *** [3c Qh Ad]
brujo120: checks 
Joe1973: checks 
HammettBets: checks 
Poker Barrie: bets $1
brujo120: folds 
Joe1973: calls $1
HammettBets: folds 
*** TURN *** [3c Qh Ad] [5d]
Joe1973: checks 
Poker Barrie: bets $1
Joe1973: calls $1
*** RIVER *** [3c Qh Ad 5d] [4d]
Joe1973: bets $5 and is all-in
Poker Barrie: calls $5
*** SHOW DOWN ***
Joe1973: shows [Qs Ah] (two pair, Aces and Queens)
Poker Barrie: mucks hand 
Joe1973 collected $17.40 from pot
*** SUMMARY ***
Total pot $18.25 | Rake $0.85 
Board [3c Qh Ad 5d 4d]
Seat 1: HammettBets folded on the Flop
Seat 2: Poker Barrie mucked [8c Ac]
Seat 3: phillme13 folded before Flop (didn't bet)
Seat 4: LuckyGeo1 (button) folded before Flop (didn't bet)
Seat 5: brujo120 (small blind) folded on the Flop
Seat 6: Mrinaldi (big blind) folded before Flop
Seat 7: Alameda22 folded before Flop (didn't bet)
Seat 8: Joe1973 showed [Qs Ah] and won ($17.40) with two pair, Aces and Queens
Seat 9: Zchien folded before Flop (didn't bet)



PokerStars Game #19975125053:  Hold'em No Limit ($0.10/$0.25) - 2008/08/28 - 20:09:26 (ET)
Table 'Hippasos IV' 9-max Seat #5 is the button
Seat 1: HammettBets ($11.40 in chips) 
Seat 2: Poker Barrie ($35.05 in chips) 
Seat 3: phillme13 ($34.50 in chips) 
Seat 4: LuckyGeo1 ($3.30 in chips) 
Seat 5: brujo120 ($13.25 in chips) 
Seat 6: Mrinaldi ($22.85 in chips) 
Seat 7: Alameda22 ($31.45 in chips) 
Seat 8: Joe1973 ($17.40 in chips) 
Seat 9: Zchien ($4.50 in chips) 
Mrinaldi: posts small blind $0.10
Alameda22: posts big blind $0.25
*** HOLE CARDS ***
Dealt to Alameda22 [Ts Tc]
Joe1973: folds 
Zchien: folds 
HammettBets: folds 
Poker Barrie: raises $0.75 to $1
phillme13: folds 
LuckyGeo1: calls $1
brujo120: folds 
Mrinaldi: folds 
Alameda22: calls $0.75
*** FLOP *** [Kc 9h 6h]
Alameda22: checks 
Poker Barrie: checks 
LuckyGeo1: bets $1.75
Alameda22: folds 
Poker Barrie: calls $1.75
*** TURN *** [Kc 9h 6h] [3s]
Poker Barrie: checks 
LuckyGeo1: bets $0.55 and is all-in
Poker Barrie: calls $0.55
*** RIVER *** [Kc 9h 6h 3s] [Qs]
*** SHOW DOWN ***
Poker Barrie: shows [7s 7c] (a pair of Sevens)
LuckyGeo1: shows [Qh Kd] (two pair, Kings and Queens)
LuckyGeo1 collected $7.35 from pot
*** SUMMARY ***
Total pot $7.70 | Rake $0.35 
Board [Kc 9h 6h 3s Qs]
Seat 1: HammettBets folded before Flop (didn't bet)
Seat 2: Poker Barrie showed [7s 7c] and lost with a pair of Sevens
Seat 3: phillme13 folded before Flop (didn't bet)
Seat 4: LuckyGeo1 showed [Qh Kd] and won ($7.35) with two pair, Kings and Queens
Seat 5: brujo120 (button) folded before Flop (didn't bet)
Seat 6: Mrinaldi (small blind) folded before Flop
Seat 7: Alameda22 (big blind) folded on the Flop
Seat 8: Joe1973 folded before Flop (didn't bet)
Seat 9: Zchien folded before Flop (didn't bet)



PokerStars Game #19975152148:  Hold'em No Limit ($0.10/$0.25) - 2008/08/28 - 20:10:43 (ET)
Table 'Hippasos IV' 9-max Seat #6 is the button
Seat 1: HammettBets ($11.40 in chips) 
Seat 2: Poker Barrie ($31.75 in chips) 
Seat 3: phillme13 ($34.50 in chips) 
Seat 4: LuckyGeo1 ($7.35 in chips) 
Seat 5: brujo120 ($13.25 in chips) 
Seat 6: Mrinaldi ($22.75 in chips) 
Seat 7: Alameda22 ($30.45 in chips) 
Seat 8: Joe1973 ($17.40 in chips) 
Seat 9: Zchien ($4.50 in chips) 
Alameda22: posts small blind $0.10
Joe1973: posts big blind $0.25
*** HOLE CARDS ***
Dealt to Alameda22 [5c Qc]
Zchien: calls $0.25
HammettBets: folds 
Poker Barrie: calls $0.25
phillme13: folds 
LuckyGeo1: calls $0.25
brujo120: folds 
Mrinaldi: folds 
Alameda22: folds 
Joe1973: checks 
*** FLOP *** [9c 2d Js]
Joe1973: checks 
Zchien: bets $0.25
Poker Barrie: raises $0.75 to $1
LuckyGeo1: calls $1
Joe1973: folds 
Zchien: calls $0.75
*** TURN *** [9c 2d Js] [2s]
Zchien: checks 
Poker Barrie: bets $0.50
LuckyGeo1: calls $0.50
Zchien: calls $0.50
*** RIVER *** [9c 2d Js 2s] [3s]
Zchien: checks 
Poker Barrie: checks 
LuckyGeo1: bets $0.75
Zchien: folds 
Poker Barrie: calls $0.75
*** SHOW DOWN ***
LuckyGeo1: shows [Td Jc] (two pair, Jacks and Deuces)
Poker Barrie: mucks hand 
LuckyGeo1 collected $6.80 from pot
*** SUMMARY ***
Total pot $7.10 | Rake $0.30 
Board [9c 2d Js 2s 3s]
Seat 1: HammettBets folded before Flop (didn't bet)
Seat 2: Poker Barrie mucked [Kc 9d]
Seat 3: phillme13 folded before Flop (didn't bet)
Seat 4: LuckyGeo1 showed [Td Jc] and won ($6.80) with two pair, Jacks and Deuces
Seat 5: brujo120 folded before Flop (didn't bet)
Seat 6: Mrinaldi (button) folded before Flop (didn't bet)
Seat 7: Alameda22 (small blind) folded before Flop
Seat 8: Joe1973 (big blind) folded on the Flop
Seat 9: Zchien folded on the River



PokerStars Game #19975183895:  Hold'em No Limit ($0.10/$0.25) - 2008/08/28 - 20:12:11 (ET)
Table 'Hippasos IV' 9-max Seat #7 is the button
Seat 1: HammettBets ($11.40 in chips) 
Seat 2: Poker Barrie ($29.25 in chips) 
Seat 3: phillme13 ($34.50 in chips) 
Seat 4: LuckyGeo1 ($11.65 in chips) 
Seat 5: brujo120 ($13.25 in chips) 
Seat 6: Mrinaldi ($22.75 in chips) 
Seat 7: Alameda22 ($30.35 in chips) 
Seat 8: Joe1973 ($17.15 in chips) 
Seat 9: Zchien ($2.75 in chips) 
Joe1973: posts small blind $0.10
Zchien: posts big blind $0.25
*** HOLE CARDS ***
Dealt to Alameda22 [Kh 6c]
HammettBets: folds 
Poker Barrie: folds 
phillme13: folds 
LuckyGeo1: calls $0.25
brujo120: folds 
Mrinaldi: raises $1 to $1.25
Alameda22: folds 
Joe1973: folds 
Zchien: folds 
LuckyGeo1: calls $1
*** FLOP *** [2c 4h 9h]
LuckyGeo1: checks 
Mrinaldi: checks 
*** TURN *** [2c 4h 9h] [As]
LuckyGeo1: checks 
Mrinaldi: bets $1.25
LuckyGeo1: calls $1.25
*** RIVER *** [2c 4h 9h As] [5s]
LuckyGeo1: checks 
Mrinaldi: checks 
*** SHOW DOWN ***
LuckyGeo1: shows [Qs 4s] (a pair of Fours)
Mrinaldi: shows [Th Ts] (a pair of Tens)
Mrinaldi collected $5.10 from pot
*** SUMMARY ***
Total pot $5.35 | Rake $0.25 
Board [2c 4h 9h As 5s]
Seat 1: HammettBets folded before Flop (didn't bet)
Seat 2: Poker Barrie folded before Flop (didn't bet)
Seat 3: phillme13 folded before Flop (didn't bet)
Seat 4: LuckyGeo1 showed [Qs 4s] and lost with a pair of Fours
Seat 5: brujo120 folded before Flop (didn't bet)
Seat 6: Mrinaldi showed [Th Ts] and won ($5.10) with a pair of Tens
Seat 7: Alameda22 (button) folded before Flop (didn't bet)
Seat 8: Joe1973 (small blind) folded before Flop
Seat 9: Zchien (big blind) folded before Flop



PokerStars Game #19975206037:  Hold'em No Limit ($0.10/$0.25) - 2008/08/28 - 20:13:12 (ET)
Table 'Hippasos IV' 9-max Seat #8 is the button
Seat 1: HammettBets ($11.40 in chips) 
Seat 2: Poker Barrie ($29.25 in chips) 
Seat 3: phillme13 ($34.50 in chips) 
Seat 4: LuckyGeo1 ($9.15 in chips) 
Seat 5: brujo120 ($13.25 in chips) 
Seat 6: Mrinaldi ($25.35 in chips) 
Seat 7: Alameda22 ($30.35 in chips) 
Seat 8: Joe1973 ($17.05 in chips) 
Seat 9: Zchien ($2.50 in chips) 
Zchien: posts small blind $0.10
HammettBets: posts big blind $0.25
*** HOLE CARDS ***
Dealt to Alameda22 [8d 5s]
Poker Barrie: raises $1 to $1.25
phillme13: folds 
LuckyGeo1: folds 
brujo120 has timed out
brujo120: folds 
brujo120 is sitting out
Mrinaldi: folds 
Alameda22: folds 
Joe1973: folds 
Zchien: folds 
HammettBets: folds 
Uncalled bet ($1) returned to Poker Barrie
Poker Barrie collected $0.60 from pot
Poker Barrie: doesn't show hand 
*** SUMMARY ***
Total pot $0.60 | Rake $0 
Seat 1: HammettBets (big blind) folded before Flop
Seat 2: Poker Barrie collected ($0.60)
Seat 3: phillme13 folded before Flop (didn't bet)
Seat 4: LuckyGeo1 folded before Flop (didn't bet)
Seat 5: brujo120 folded before Flop (didn't bet)
Seat 6: Mrinaldi folded before Flop (didn't bet)
Seat 7: Alameda22 folded before Flop (didn't bet)
Seat 8: Joe1973 (button) folded before Flop (didn't bet)
Seat 9: Zchien (small blind) folded before Flop



PokerStars Game #19975228550:  Hold'em No Limit ($0.10/$0.25) - 2008/08/28 - 20:14:16 (ET)
Table 'Hippasos IV' 9-max Seat #9 is the button
Seat 1: HammettBets ($11.15 in chips) 
Seat 2: Poker Barrie ($29.60 in chips) 
Seat 3: phillme13 ($34.50 in chips) 
Seat 4: LuckyGeo1 ($9.15 in chips) 
Seat 6: Mrinaldi ($25.35 in chips) 
Seat 7: Alameda22 ($30.35 in chips) 
Seat 8: Joe1973 ($17.05 in chips) 
Seat 9: Zchien ($2.40 in chips) 
HammettBets: posts small blind $0.10
Poker Barrie: posts big blind $0.25
*** HOLE CARDS ***
Dealt to Alameda22 [7d Qc]
phillme13: folds 
LuckyGeo1: calls $0.25
Mrinaldi: folds 
brujo120 has returned
Alameda22: folds 
Joe1973: folds 
Zchien: calls $0.25
HammettBets: folds 
Poker Barrie: checks 
*** FLOP *** [As 4h Th]
Poker Barrie: checks 
LuckyGeo1: bets $0.50
Zchien: calls $0.50
Poker Barrie: folds 
*** TURN *** [As 4h Th] [Ac]
LuckyGeo1: checks 
Zchien: bets $1
LuckyGeo1: raises $1 to $2
Zchien: calls $0.65 and is all-in
Uncalled bet ($0.35) returned to LuckyGeo1
*** RIVER *** [As 4h Th Ac] [2c]
*** SHOW DOWN ***
LuckyGeo1: shows [Td Ad] (a full house, Aces full of Tens)
Zchien: shows [Ts Qh] (two pair, Aces and Tens)
LuckyGeo1 collected $4.90 from pot
*** SUMMARY ***
Total pot $5.15 | Rake $0.25 
Board [As 4h Th Ac 2c]
Seat 1: HammettBets (small blind) folded before Flop
Seat 2: Poker Barrie (big blind) folded on the Flop
Seat 3: phillme13 folded before Flop (didn't bet)
Seat 4: LuckyGeo1 showed [Td Ad] and won ($4.90) with a full house, Aces full of Tens
Seat 6: Mrinaldi folded before Flop (didn't bet)
Seat 7: Alameda22 folded before Flop (didn't bet)
Seat 8: Joe1973 folded before Flop (didn't bet)
Seat 9: Zchien (button) showed [Ts Qh] and lost with two pair, Aces and Tens



PokerStars Game #19975271608:  Hold'em No Limit ($0.10/$0.25) - 2008/08/28 - 20:16:13 (ET)
Table 'Hippasos IV' 9-max Seat #1 is the button
Seat 1: HammettBets ($11.05 in chips) 
Seat 2: Poker Barrie ($29.35 in chips) 
Seat 3: phillme13 ($34.50 in chips) 
Seat 4: LuckyGeo1 ($11.65 in chips) 
Seat 5: brujo120 ($13.25 in chips) 
Seat 6: Mrinaldi ($25.35 in chips) 
Seat 7: Alameda22 ($30.35 in chips) 
Seat 8: Joe1973 ($17.05 in chips) 
Poker Barrie: posts small blind $0.10
phillme13: posts big blind $0.25
*** HOLE CARDS ***
Dealt to Alameda22 [Qs 6d]
LuckyGeo1: calls $0.25
brujo120: folds 
Mrinaldi: folds 
Alameda22: folds 
Joe1973: raises $0.25 to $0.50
HammettBets: folds 
Poker Barrie: calls $0.40
phillme13: calls $0.25
Zchien leaves the table
LuckyGeo1: calls $0.25
*** FLOP *** [7h Jd Js]
Poker Barrie: checks 
phillme13: checks 
LuckyGeo1: checks 
Joe1973: checks 
*** TURN *** [7h Jd Js] [5c]
Poker Barrie: checks 
Kevinvdv joins the table at seat #9 
phillme13: checks 
LuckyGeo1: bets $0.50
Joe1973: calls $0.50
Poker Barrie: folds 
phillme13: folds 
*** RIVER *** [7h Jd Js 5c] [4d]
LuckyGeo1: checks 
Joe1973: bets $1
LuckyGeo1: calls $1
*** SHOW DOWN ***
Joe1973: shows [Jh Kc] (three of a kind, Jacks)
LuckyGeo1: mucks hand 
Joe1973 collected $4.80 from pot
*** SUMMARY ***
Total pot $5 | Rake $0.20 
Board [7h Jd Js 5c 4d]
Seat 1: HammettBets (button) folded before Flop (didn't bet)
Seat 2: Poker Barrie (small blind) folded on the Turn
Seat 3: phillme13 (big blind) folded on the Turn
Seat 4: LuckyGeo1 mucked [5d Ad]
Seat 5: brujo120 folded before Flop (didn't bet)
Seat 6: Mrinaldi folded before Flop (didn't bet)
Seat 7: Alameda22 folded before Flop (didn't bet)
Seat 8: Joe1973 showed [Jh Kc] and won ($4.80) with three of a kind, Jacks



PokerStars Game #19975294305:  Hold'em No Limit ($0.10/$0.25) - 2008/08/28 - 20:17:14 (ET)
Table 'Hippasos IV' 9-max Seat #2 is the button
Seat 1: HammettBets ($11.05 in chips) 
Seat 2: Poker Barrie ($28.85 in chips) 
Seat 3: phillme13 ($34 in chips) 
Seat 4: LuckyGeo1 ($9.65 in chips) 
Seat 5: brujo120 ($13.25 in chips) 
Seat 6: Mrinaldi ($25.35 in chips) 
Seat 7: Alameda22 ($30.35 in chips) 
Seat 8: Joe1973 ($19.85 in chips) 
Seat 9: Kevinvdv ($23.30 in chips) 
phillme13: posts small blind $0.10
LuckyGeo1: posts big blind $0.25
Kevinvdv: posts big blind $0.25
*** HOLE CARDS ***
Dealt to Alameda22 [7s 6h]
brujo120: calls $0.25
Mrinaldi: folds 
Alameda22: folds 
Joe1973: calls $0.25
Kevinvdv: checks 
HammettBets: raises $0.50 to $0.75
Poker Barrie: folds 
phillme13: folds 
LuckyGeo1: calls $0.50
brujo120: folds 
Joe1973: folds 
Kevinvdv: folds 
*** FLOP *** [Ks 2h Ac]
LuckyGeo1: checks 
HammettBets: bets $1.25
LuckyGeo1: calls $1.25
*** TURN *** [Ks 2h Ac] [8d]
LuckyGeo1: checks 
HammettBets: checks 
*** RIVER *** [Ks 2h Ac 8d] [7d]
LuckyGeo1: checks 
HammettBets: checks 
*** SHOW DOWN ***
LuckyGeo1: shows [Qd Kh] (a pair of Kings)
HammettBets: shows [Tc Ad] (a pair of Aces)
HammettBets collected $4.65 from pot
*** SUMMARY ***
Total pot $4.85 | Rake $0.20 
Board [Ks 2h Ac 8d 7d]
Seat 1: HammettBets showed [Tc Ad] and won ($4.65) with a pair of Aces
Seat 2: Poker Barrie (button) folded before Flop (didn't bet)
Seat 3: phillme13 (small blind) folded before Flop
Seat 4: LuckyGeo1 (big blind) showed [Qd Kh] and lost with a pair of Kings
Seat 5: brujo120 folded before Flop
Seat 6: Mrinaldi folded before Flop (didn't bet)
Seat 7: Alameda22 folded before Flop (didn't bet)
Seat 8: Joe1973 folded before Flop
Seat 9: Kevinvdv folded before Flop



PokerStars Game #19975315840:  Hold'em No Limit ($0.10/$0.25) - 2008/08/28 - 20:18:12 (ET)
Table 'Hippasos IV' 9-max Seat #3 is the button
Seat 1: HammettBets ($13.70 in chips) 
Seat 2: Poker Barrie ($28.85 in chips) 
Seat 3: phillme13 ($33.90 in chips) 
Seat 4: LuckyGeo1 ($7.65 in chips) 
Seat 5: brujo120 ($13 in chips) 
Seat 6: Mrinaldi ($25.35 in chips) 
Seat 7: Alameda22 ($30.35 in chips) 
Seat 8: Joe1973 ($19.60 in chips) 
Seat 9: Kevinvdv ($23.05 in chips) 
LuckyGeo1: posts small blind $0.10
brujo120: posts big blind $0.25
*** HOLE CARDS ***
Dealt to Alameda22 [7s 7d]
Mrinaldi: folds 
Alameda22: folds 
Joe1973: folds 
Kevinvdv: folds 
HammettBets: folds 
Poker Barrie: calls $0.25
phillme13: calls $0.25
LuckyGeo1: raises $0.50 to $0.75
brujo120: folds 
Poker Barrie: calls $0.50
phillme13: calls $0.50
*** FLOP *** [Ah 2h 6c]
LuckyGeo1: checks 
Poker Barrie: checks 
phillme13: checks 
*** TURN *** [Ah 2h 6c] [As]
LuckyGeo1: checks 
Poker Barrie: checks 
phillme13: bets $1
LuckyGeo1: calls $1
Poker Barrie: calls $1
*** RIVER *** [Ah 2h 6c As] [5s]
LuckyGeo1: bets $1.50
Poker Barrie: calls $1.50
phillme13: folds 
*** SHOW DOWN ***
LuckyGeo1: shows [Ac Th] (three of a kind, Aces)
Poker Barrie: mucks hand 
LuckyGeo1 collected $8.10 from pot
*** SUMMARY ***
Total pot $8.50 | Rake $0.40 
Board [Ah 2h 6c As 5s]
Seat 1: HammettBets folded before Flop (didn't bet)
Seat 2: Poker Barrie mucked [8d 6d]
Seat 3: phillme13 (button) folded on the River
Seat 4: LuckyGeo1 (small blind) showed [Ac Th] and won ($8.10) with three of a kind, Aces
Seat 5: brujo120 (big blind) folded before Flop
Seat 6: Mrinaldi folded before Flop (didn't bet)
Seat 7: Alameda22 folded before Flop (didn't bet)
Seat 8: Joe1973 folded before Flop (didn't bet)
Seat 9: Kevinvdv folded before Flop (didn't bet)



PokerStars Game #19975339789:  Hold'em No Limit ($0.10/$0.25) - 2008/08/28 - 20:19:18 (ET)
Table 'Hippasos IV' 9-max Seat #4 is the button
Seat 1: HammettBets ($13.70 in chips) 
Seat 2: Poker Barrie ($25.60 in chips) 
Seat 3: phillme13 ($32.15 in chips) 
Seat 4: LuckyGeo1 ($12.50 in chips) 
Seat 5: brujo120 ($12.75 in chips) 
Seat 6: Mrinaldi ($25.35 in chips) 
Seat 7: Alameda22 ($30.35 in chips) 
Seat 8: Joe1973 ($19.60 in chips) 
Seat 9: Kevinvdv ($23.05 in chips) 
brujo120: posts small blind $0.10
Mrinaldi: posts big blind $0.25
*** HOLE CARDS ***
Dealt to Alameda22 [4c 5d]
Alameda22: folds 
Joe1973: folds 
Kevinvdv: raises $0.50 to $0.75
HammettBets: folds 
Poker Barrie: folds 
phillme13: calls $0.75
LuckyGeo1: calls $0.75
brujo120: folds 
Mrinaldi: folds 
*** FLOP *** [6h 9c Ac]
brujo120 leaves the table
Kevinvdv: bets $2.25
phillme13: folds 
LuckyGeo1: calls $2.25
*** TURN *** [6h 9c Ac] [7c]
phillme13 leaves the table
Kevinvdv: checks 
nick phlegm joins the table at seat #5 
LuckyGeo1: bets $1.75
Kevinvdv: folds 
Uncalled bet ($1.75) returned to LuckyGeo1
TheigerLIly joins the table at seat #3 
LuckyGeo1 collected $6.75 from pot
LuckyGeo1: doesn't show hand 
*** SUMMARY ***
Total pot $7.10 | Rake $0.35 
Board [6h 9c Ac 7c]
Seat 1: HammettBets folded before Flop (didn't bet)
Seat 2: Poker Barrie folded before Flop (didn't bet)
Seat 3: phillme13 folded on the Flop
Seat 4: LuckyGeo1 (button) collected ($6.75)
Seat 5: brujo120 (small blind) folded before Flop
Seat 6: Mrinaldi (big blind) folded before Flop
Seat 7: Alameda22 folded before Flop (didn't bet)
Seat 8: Joe1973 folded before Flop (didn't bet)
Seat 9: Kevinvdv folded on the Turn



PokerStars Game #19975359473:  Hold'em No Limit ($0.10/$0.25) - 2008/08/28 - 20:20:11 (ET)
Table 'Hippasos IV' 9-max Seat #6 is the button
Seat 1: HammettBets ($13.70 in chips) 
Seat 2: Poker Barrie ($25.60 in chips) 
Seat 3: TheigerLIly ($15 in chips) 
Seat 4: LuckyGeo1 ($16.25 in chips) 
Seat 5: nick phlegm ($15 in chips) 
Seat 6: Mrinaldi ($25.10 in chips) 
Seat 7: Alameda22 ($30.35 in chips) 
Seat 8: Joe1973 ($19.60 in chips) 
Seat 9: Kevinvdv ($20.05 in chips) 
Alameda22: posts small blind $0.10
Joe1973: posts big blind $0.25
TheigerLIly: posts big blind $0.25
nick phlegm: posts big blind $0.25
*** HOLE CARDS ***
Dealt to Alameda22 [Kc 6h]
Kevinvdv: folds 
HammettBets: folds 
Poker Barrie: calls $0.25
TheigerLIly: checks 
LuckyGeo1: folds 
nick phlegm: checks 
Mrinaldi: folds 
Alameda22: folds 
Joe1973: checks 
*** FLOP *** [2d 2c 7h]
Joe1973: checks 
Poker Barrie: checks 
TheigerLIly: bets $0.25
nick phlegm: folds 
Joe1973: folds 
Poker Barrie: calls $0.25
*** TURN *** [2d 2c 7h] [8d]
Poker Barrie: checks 
TheigerLIly: checks 
*** RIVER *** [2d 2c 7h 8d] [Jh]
Poker Barrie: checks 
TheigerLIly: checks 
*** SHOW DOWN ***
Poker Barrie: shows [Th Jd] (two pair, Jacks and Deuces)
TheigerLIly: mucks hand 
Poker Barrie collected $1.55 from pot
*** SUMMARY ***
Total pot $1.60 | Rake $0.05 
Board [2d 2c 7h 8d Jh]
Seat 1: HammettBets folded before Flop (didn't bet)
Seat 2: Poker Barrie showed [Th Jd] and won ($1.55) with two pair, Jacks and Deuces
Seat 3: TheigerLIly mucked [6d 6s]
Seat 4: LuckyGeo1 folded before Flop (didn't bet)
Seat 5: nick phlegm folded on the Flop
Seat 6: Mrinaldi (button) folded before Flop (didn't bet)
Seat 7: Alameda22 (small blind) folded before Flop
Seat 8: Joe1973 (big blind) folded on the Flop
Seat 9: Kevinvdv folded before Flop (didn't bet)



PokerStars Game #19975386185:  Hold'em No Limit ($0.10/$0.25) - 2008/08/28 - 20:21:24 (ET)
Table 'Hippasos IV' 9-max Seat #7 is the button
Seat 1: HammettBets ($13.70 in chips) 
Seat 2: Poker Barrie ($26.65 in chips) 
Seat 3: TheigerLIly ($14.50 in chips) 
Seat 4: LuckyGeo1 ($16.25 in chips) 
Seat 5: nick phlegm ($14.75 in chips) 
Seat 6: Mrinaldi ($25.10 in chips) 
Seat 7: Alameda22 ($30.25 in chips) 
Seat 8: Joe1973 ($19.35 in chips) 
Seat 9: Kevinvdv ($20.05 in chips) 
Joe1973: posts small blind $0.10
Kevinvdv: posts big blind $0.25
*** HOLE CARDS ***
Dealt to Alameda22 [9h 2h]
HammettBets: folds 
Poker Barrie: raises $0.25 to $0.50
TheigerLIly: folds 
LuckyGeo1: calls $0.50
nick phlegm: folds 
Mrinaldi: folds 
Alameda22: folds 
Joe1973: calls $0.40
Kevinvdv: folds 
*** FLOP *** [9d 4c Kc]
Joe1973: checks 
Poker Barrie: checks 
LuckyGeo1: checks 
*** TURN *** [9d 4c Kc] [3d]
Joe1973: checks 
Poker Barrie: checks 
LuckyGeo1: bets $1
Joe1973: folds 
Poker Barrie: folds 
Uncalled bet ($1) returned to LuckyGeo1
LuckyGeo1 collected $1.70 from pot
LuckyGeo1: doesn't show hand 
*** SUMMARY ***
Total pot $1.75 | Rake $0.05 
Board [9d 4c Kc 3d]
Seat 1: HammettBets folded before Flop (didn't bet)
Seat 2: Poker Barrie folded on the Turn
Seat 3: TheigerLIly folded before Flop (didn't bet)
Seat 4: LuckyGeo1 collected ($1.70)
Seat 5: nick phlegm folded before Flop (didn't bet)
Seat 6: Mrinaldi folded before Flop (didn't bet)
Seat 7: Alameda22 (button) folded before Flop (didn't bet)
Seat 8: Joe1973 (small blind) folded on the Turn
Seat 9: Kevinvdv (big blind) folded before Flop



PokerStars Game #19975406693:  Hold'em No Limit ($0.10/$0.25) - 2008/08/28 - 20:22:19 (ET)
Table 'Hippasos IV' 9-max Seat #8 is the button
Seat 1: HammettBets ($13.70 in chips) 
Seat 2: Poker Barrie ($26.15 in chips) 
Seat 3: TheigerLIly ($14.50 in chips) 
Seat 4: LuckyGeo1 ($17.45 in chips) 
Seat 5: nick phlegm ($14.75 in chips) 
Seat 6: Mrinaldi ($25.10 in chips) 
Seat 7: Alameda22 ($30.25 in chips) 
Seat 8: Joe1973 ($18.85 in chips) 
Seat 9: Kevinvdv ($19.80 in chips) 
Kevinvdv: posts small blind $0.10
HammettBets: posts big blind $0.25
*** HOLE CARDS ***
Dealt to Alameda22 [Qc 4c]
Poker Barrie: folds 
TheigerLIly: folds 
LuckyGeo1: calls $0.25
nick phlegm: folds 
Mrinaldi: calls $0.25
Alameda22: folds 
Joe1973: folds 
Kevinvdv: calls $0.15
HammettBets: raises $0.75 to $1
LuckyGeo1: calls $0.75
Mrinaldi: calls $0.75
Kevinvdv: folds 
*** FLOP *** [Jc 8h Qd]
HammettBets: bets $1.75
LuckyGeo1: folds 
Mrinaldi: calls $1.75
*** TURN *** [Jc 8h Qd] [4s]
HammettBets: checks 
Mrinaldi: bets $2.75
HammettBets: folds 
Uncalled bet ($2.75) returned to Mrinaldi
Mrinaldi collected $6.45 from pot
Mrinaldi: doesn't show hand 
*** SUMMARY ***
Total pot $6.75 | Rake $0.30 
Board [Jc 8h Qd 4s]
Seat 1: HammettBets (big blind) folded on the Turn
Seat 2: Poker Barrie folded before Flop (didn't bet)
Seat 3: TheigerLIly folded before Flop (didn't bet)
Seat 4: LuckyGeo1 folded on the Flop
Seat 5: nick phlegm folded before Flop (didn't bet)
Seat 6: Mrinaldi collected ($6.45)
Seat 7: Alameda22 folded before Flop (didn't bet)
Seat 8: Joe1973 (button) folded before Flop (didn't bet)
Seat 9: Kevinvdv (small blind) folded before Flop



PokerStars Game #19975436619:  Hold'em No Limit ($0.10/$0.25) - 2008/08/28 - 20:23:39 (ET)
Table 'Hippasos IV' 9-max Seat #9 is the button
Seat 1: HammettBets ($10.95 in chips) 
Seat 2: Poker Barrie ($26.15 in chips) 
Seat 3: TheigerLIly ($14.50 in chips) 
Seat 4: LuckyGeo1 ($16.45 in chips) 
Seat 5: nick phlegm ($14.75 in chips) 
Seat 6: Mrinaldi ($28.80 in chips) 
Seat 7: Alameda22 ($30.25 in chips) 
Seat 8: Joe1973 ($18.85 in chips) 
Seat 9: Kevinvdv ($19.55 in chips) 
HammettBets: posts small blind $0.10
Poker Barrie: posts big blind $0.25
*** HOLE CARDS ***
Dealt to Alameda22 [Kd 8d]
TheigerLIly: folds 
LuckyGeo1: calls $0.25
nick phlegm: folds 
Mrinaldi: folds 
Alameda22: folds 
Joe1973: folds 
Kevinvdv: raises $0.75 to $1
HammettBets: folds 
Poker Barrie: calls $0.75
LuckyGeo1: calls $0.75
*** FLOP *** [3d 4c 7d]
Poker Barrie: checks 
LuckyGeo1: checks 
Kevinvdv: bets $1.75
Poker Barrie: calls $1.75
LuckyGeo1: calls $1.75
*** TURN *** [3d 4c 7d] [6h]
Poker Barrie: checks 
LuckyGeo1: checks 
Kevinvdv: checks 
*** RIVER *** [3d 4c 7d 6h] [6s]
Poker Barrie: bets $1
LuckyGeo1: raises $1 to $2
Kevinvdv: folds 
Poker Barrie: calls $1
*** SHOW DOWN ***
LuckyGeo1: shows [5h Ad] (a straight, Three to Seven)
Poker Barrie: mucks hand 
LuckyGeo1 collected $11.80 from pot
*** SUMMARY ***
Total pot $12.35 | Rake $0.55 
Board [3d 4c 7d 6h 6s]
Seat 1: HammettBets (small blind) folded before Flop
Seat 2: Poker Barrie (big blind) mucked [3s As]
Seat 3: TheigerLIly folded before Flop (didn't bet)
Seat 4: LuckyGeo1 showed [5h Ad] and won ($11.80) with a straight, Three to Seven
Seat 5: nick phlegm folded before Flop (didn't bet)
Seat 6: Mrinaldi folded before Flop (didn't bet)
Seat 7: Alameda22 folded before Flop (didn't bet)
Seat 8: Joe1973 folded before Flop (didn't bet)
Seat 9: Kevinvdv (button) folded on the River



PokerStars Game #19975457396:  Hold'em No Limit ($0.10/$0.25) - 2008/08/28 - 20:24:35 (ET)
Table 'Hippasos IV' 9-max Seat #1 is the button
Seat 1: HammettBets ($10.85 in chips) 
Seat 2: Poker Barrie ($21.40 in chips) 
Seat 3: TheigerLIly ($14.50 in chips) 
Seat 4: LuckyGeo1 ($23.50 in chips) 
Seat 5: nick phlegm ($14.75 in chips) 
Seat 6: Mrinaldi ($28.80 in chips) 
Seat 7: Alameda22 ($30.25 in chips) 
Seat 8: Joe1973 ($18.85 in chips) 
Seat 9: Kevinvdv ($16.80 in chips) 
Poker Barrie: posts small blind $0.10
TheigerLIly: posts big blind $0.25
*** HOLE CARDS ***
Dealt to Alameda22 [7h 6d]
LuckyGeo1: raises $0.25 to $0.50
nick phlegm: folds 
Mrinaldi: folds 
Alameda22: folds 
Joe1973: folds 
Kevinvdv: calls $0.50
HammettBets: folds 
Poker Barrie: raises $0.50 to $1
TheigerLIly: folds 
LuckyGeo1: calls $0.50
Kevinvdv: calls $0.50
*** FLOP *** [8h Ks Ah]
Poker Barrie: checks 
LuckyGeo1: checks 
Kevinvdv: checks 
*** TURN *** [8h Ks Ah] [7s]
Poker Barrie: checks 
LuckyGeo1: bets $0.75
Kevinvdv: folds 
Poker Barrie: calls $0.75
*** RIVER *** [8h Ks Ah 7s] [6h]
Poker Barrie: checks 
LuckyGeo1: bets $0.75
Poker Barrie: calls $0.75
*** SHOW DOWN ***
LuckyGeo1: shows [Ad 9c] (a pair of Aces)
Poker Barrie: mucks hand 
LuckyGeo1 collected $5.95 from pot
*** SUMMARY ***
Total pot $6.25 | Rake $0.30 
Board [8h Ks Ah 7s 6h]
Seat 1: HammettBets (button) folded before Flop (didn't bet)
Seat 2: Poker Barrie (small blind) mucked [Jh Js]
Seat 3: TheigerLIly (big blind) folded before Flop
Seat 4: LuckyGeo1 showed [Ad 9c] and won ($5.95) with a pair of Aces
Seat 5: nick phlegm folded before Flop (didn't bet)
Seat 6: Mrinaldi folded before Flop (didn't bet)
Seat 7: Alameda22 folded before Flop (didn't bet)
Seat 8: Joe1973 folded before Flop (didn't bet)
Seat 9: Kevinvdv folded on the Turn



PokerStars Game #19975482913:  Hold'em No Limit ($0.10/$0.25) - 2008/08/28 - 20:25:44 (ET)
Table 'Hippasos IV' 9-max Seat #2 is the button
Seat 1: HammettBets ($10.85 in chips) 
Seat 2: Poker Barrie ($18.90 in chips) 
Seat 3: TheigerLIly ($14.25 in chips) 
Seat 4: LuckyGeo1 ($26.95 in chips) 
Seat 5: nick phlegm ($14.75 in chips) 
Seat 6: Mrinaldi ($28.80 in chips) 
Seat 7: Alameda22 ($30.25 in chips) 
Seat 8: Joe1973 ($18.85 in chips) 
Seat 9: Kevinvdv ($15.80 in chips) 
TheigerLIly: posts small blind $0.10
LuckyGeo1: posts big blind $0.25
*** HOLE CARDS ***
Dealt to Alameda22 [Jc 4s]
nick phlegm: raises $0.50 to $0.75
Mrinaldi: folds 
Alameda22: folds 
Joe1973: folds 
Kevinvdv: calls $0.75
HammettBets: folds 
Poker Barrie: calls $0.75
TheigerLIly: calls $0.65
LuckyGeo1: calls $0.50
*** FLOP *** [Th 5h 4c]
TheigerLIly: checks 
LuckyGeo1: checks 
nick phlegm: checks 
Kevinvdv: bets $4.25
Poker Barrie: folds 
TheigerLIly: folds 
LuckyGeo1: folds 
nick phlegm: folds 
Uncalled bet ($4.25) returned to Kevinvdv
Kevinvdv collected $3.60 from pot
Kevinvdv: doesn't show hand 
*** SUMMARY ***
Total pot $3.75 | Rake $0.15 
Board [Th 5h 4c]
Seat 1: HammettBets folded before Flop (didn't bet)
Seat 2: Poker Barrie (button) folded on the Flop
Seat 3: TheigerLIly (small blind) folded on the Flop
Seat 4: LuckyGeo1 (big blind) folded on the Flop
Seat 5: nick phlegm folded on the Flop
Seat 6: Mrinaldi folded before Flop (didn't bet)
Seat 7: Alameda22 folded before Flop (didn't bet)
Seat 8: Joe1973 folded before Flop (didn't bet)
Seat 9: Kevinvdv collected ($3.60)



PokerStars Game #19975509754:  Hold'em No Limit ($0.10/$0.25) - 2008/08/28 - 20:26:56 (ET)
Table 'Hippasos IV' 9-max Seat #3 is the button
Seat 1: HammettBets ($10.85 in chips) 
Seat 2: Poker Barrie ($18.15 in chips) 
Seat 3: TheigerLIly ($13.50 in chips) 
Seat 4: LuckyGeo1 ($26.20 in chips) 
Seat 5: nick phlegm ($14 in chips) 
Seat 6: Mrinaldi ($28.80 in chips) 
Seat 7: Alameda22 ($30.25 in chips) 
Seat 8: Joe1973 ($18.85 in chips) 
Seat 9: Kevinvdv ($18.65 in chips) 
LuckyGeo1: posts small blind $0.10
nick phlegm: posts big blind $0.25
*** HOLE CARDS ***
Dealt to Alameda22 [7d 3c]
Mrinaldi: folds 
Alameda22: folds 
Joe1973: folds 
Kevinvdv: calls $0.25
HammettBets: folds 
Poker Barrie: folds 
TheigerLIly: folds 
LuckyGeo1: calls $0.15
nick phlegm: checks 
*** FLOP *** [Td Th Qs]
LuckyGeo1: bets $0.25
nick phlegm: folds 
Kevinvdv: folds 
Uncalled bet ($0.25) returned to LuckyGeo1
LuckyGeo1 collected $0.75 from pot
LuckyGeo1: doesn't show hand 
*** SUMMARY ***
Total pot $0.75 | Rake $0 
Board [Td Th Qs]
Seat 1: HammettBets folded before Flop (didn't bet)
Seat 2: Poker Barrie folded before Flop (didn't bet)
Seat 3: TheigerLIly (button) folded before Flop (didn't bet)
Seat 4: LuckyGeo1 (small blind) collected ($0.75)
Seat 5: nick phlegm (big blind) folded on the Flop
Seat 6: Mrinaldi folded before Flop (didn't bet)
Seat 7: Alameda22 folded before Flop (didn't bet)
Seat 8: Joe1973 folded before Flop (didn't bet)
Seat 9: Kevinvdv folded on the Flop



PokerStars Game #19975525984:  Hold'em No Limit ($0.10/$0.25) - 2008/08/28 - 20:27:41 (ET)
Table 'Hippasos IV' 9-max Seat #4 is the button
Seat 1: HammettBets ($10.85 in chips) 
Seat 2: Poker Barrie ($18.15 in chips) 
Seat 3: TheigerLIly ($13.50 in chips) 
Seat 4: LuckyGeo1 ($26.70 in chips) 
Seat 5: nick phlegm ($13.75 in chips) 
Seat 6: Mrinaldi ($28.80 in chips) 
Seat 7: Alameda22 ($30.25 in chips) 
Seat 8: Joe1973 ($18.85 in chips) 
Seat 9: Kevinvdv ($18.40 in chips) 
nick phlegm: posts small blind $0.10
Mrinaldi: posts big blind $0.25
*** HOLE CARDS ***
Dealt to Alameda22 [Kd 7d]
Alameda22: folds 
Joe1973: calls $0.25
Kevinvdv: folds 
HammettBets: raises $0.50 to $0.75
Poker Barrie: folds 
TheigerLIly: folds 
LuckyGeo1: folds 
nick phlegm: folds 
Mrinaldi: folds 
Joe1973: calls $0.50
*** FLOP *** [Jc 6d Kh]
Joe1973: bets $0.75
HammettBets: calls $0.75
*** TURN *** [Jc 6d Kh] [6h]
Joe1973: bets $1
HammettBets: calls $1
*** RIVER *** [Jc 6d Kh 6h] [3d]
Joe1973: bets $1.50
HammettBets: calls $1.50
*** SHOW DOWN ***
Joe1973: shows [Kc Tc] (two pair, Kings and Sixes)
HammettBets: mucks hand 
Joe1973 collected $7.95 from pot
*** SUMMARY ***
Total pot $8.35 | Rake $0.40 
Board [Jc 6d Kh 6h 3d]
Seat 1: HammettBets mucked [Qs Qc]
Seat 2: Poker Barrie folded before Flop (didn't bet)
Seat 3: TheigerLIly folded before Flop (didn't bet)
Seat 4: LuckyGeo1 (button) folded before Flop (didn't bet)
Seat 5: nick phlegm (small blind) folded before Flop
Seat 6: Mrinaldi (big blind) folded before Flop
Seat 7: Alameda22 folded before Flop (didn't bet)
Seat 8: Joe1973 showed [Kc Tc] and won ($7.95) with two pair, Kings and Sixes
Seat 9: Kevinvdv folded before Flop (didn't bet)



PokerStars Game #19975554912:  Hold'em No Limit ($0.10/$0.25) - 2008/08/28 - 20:29:00 (ET)
Table 'Hippasos IV' 9-max Seat #5 is the button
Seat 1: HammettBets ($6.85 in chips) 
Seat 2: Poker Barrie ($18.15 in chips) 
Seat 3: TheigerLIly ($13.50 in chips) 
Seat 4: LuckyGeo1 ($26.70 in chips) 
Seat 5: nick phlegm ($13.65 in chips) 
Seat 6: Mrinaldi ($28.55 in chips) 
Seat 7: Alameda22 ($30.25 in chips) 
Seat 8: Joe1973 ($22.80 in chips) 
Seat 9: Kevinvdv ($18.40 in chips) 
Mrinaldi: posts small blind $0.10
Alameda22: posts big blind $0.25
*** HOLE CARDS ***
Dealt to Alameda22 [Ts 3d]
Joe1973: folds 
Kevinvdv: folds 
HammettBets: folds 
Poker Barrie: raises $0.75 to $1
TheigerLIly: folds 
LuckyGeo1: folds 
nick phlegm: folds 
Mrinaldi: folds 
Alameda22: folds 
Uncalled bet ($0.75) returned to Poker Barrie
Poker Barrie collected $0.60 from pot
Poker Barrie: doesn't show hand 
*** SUMMARY ***
Total pot $0.60 | Rake $0 
Seat 1: HammettBets folded before Flop (didn't bet)
Seat 2: Poker Barrie collected ($0.60)
Seat 3: TheigerLIly folded before Flop (didn't bet)
Seat 4: LuckyGeo1 folded before Flop (didn't bet)
Seat 5: nick phlegm (button) folded before Flop (didn't bet)
Seat 6: Mrinaldi (small blind) folded before Flop
Seat 7: Alameda22 (big blind) folded before Flop
Seat 8: Joe1973 folded before Flop (didn't bet)
Seat 9: Kevinvdv folded before Flop (didn't bet)



PokerStars Game #19975573579:  Hold'em No Limit ($0.10/$0.25) - 2008/08/28 - 20:29:51 (ET)
Table 'Hippasos IV' 9-max Seat #6 is the button
Seat 1: HammettBets ($25 in chips) 
Seat 2: Poker Barrie ($18.50 in chips) 
Seat 3: TheigerLIly ($13.50 in chips) 
Seat 4: LuckyGeo1 ($26.70 in chips) 
Seat 5: nick phlegm ($13.65 in chips) 
Seat 6: Mrinaldi ($28.45 in chips) 
Seat 7: Alameda22 ($30 in chips) 
Seat 8: Joe1973 ($22.80 in chips) 
Seat 9: Kevinvdv ($18.40 in chips) 
Alameda22: posts small blind $0.10
Joe1973: posts big blind $0.25
*** HOLE CARDS ***
Dealt to Alameda22 [3s 6s]
Kevinvdv: calls $0.25
HammettBets: folds 
Poker Barrie: folds 
TheigerLIly: calls $0.25
LuckyGeo1: calls $0.25
nick phlegm: folds 
Mrinaldi: folds 
Alameda22: calls $0.15
Joe1973: checks 
*** FLOP *** [Ac 2c 6d]
Alameda22: checks 
Joe1973: checks 
Kevinvdv: bets $3
TheigerLIly: folds 
LuckyGeo1: calls $3
Alameda22: folds 
Joe1973: folds 
*** TURN *** [Ac 2c 6d] [9s]
Kevinvdv: bets $3.25
LuckyGeo1: calls $3.25
*** RIVER *** [Ac 2c 6d 9s] [Ah]
Kevinvdv: bets $11.90 and is all-in
nick phlegm said, "is that potsie?"
LuckyGeo1: folds 
Uncalled bet ($11.90) returned to Kevinvdv
Kevinvdv collected $13.10 from pot
Kevinvdv: doesn't show hand 
*** SUMMARY ***
Total pot $13.75 | Rake $0.65 
Board [Ac 2c 6d 9s Ah]
Seat 1: HammettBets folded before Flop (didn't bet)
Seat 2: Poker Barrie folded before Flop (didn't bet)
Seat 3: TheigerLIly folded on the Flop
Seat 4: LuckyGeo1 folded on the River
Seat 5: nick phlegm folded before Flop (didn't bet)
Seat 6: Mrinaldi (button) folded before Flop (didn't bet)
Seat 7: Alameda22 (small blind) folded on the Flop
Seat 8: Joe1973 (big blind) folded on the Flop
Seat 9: Kevinvdv collected ($13.10)



PokerStars Game #19975600426:  Hold'em No Limit ($0.10/$0.25) - 2008/08/28 - 20:31:05 (ET)
Table 'Hippasos IV' 9-max Seat #7 is the button
Seat 1: HammettBets ($25 in chips) 
Seat 2: Poker Barrie ($18.50 in chips) 
Seat 3: TheigerLIly ($13.25 in chips) 
Seat 4: LuckyGeo1 ($20.20 in chips) 
Seat 5: nick phlegm ($13.65 in chips) 
Seat 6: Mrinaldi ($28.45 in chips) 
Seat 7: Alameda22 ($29.75 in chips) 
Seat 8: Joe1973 ($22.55 in chips) 
Seat 9: Kevinvdv ($25 in chips) 
Joe1973: posts small blind $0.10
Kevinvdv: posts big blind $0.25
*** HOLE CARDS ***
Dealt to Alameda22 [Kd Tc]
HammettBets: folds 
Poker Barrie: folds 
nick phlegm said, "or dutch boyd?"
TheigerLIly: folds 
LuckyGeo1: calls $0.25
nick phlegm: calls $0.25
Mrinaldi: calls $0.25
Alameda22: folds 
Joe1973: calls $0.15
Kevinvdv: checks 
*** FLOP *** [6s 3d Ad]
Joe1973: checks 
Kevinvdv: checks 
LuckyGeo1: bets $0.50
nick phlegm: calls $0.50
Mrinaldi: folds 
Joe1973: folds 
Kevinvdv: calls $0.50
*** TURN *** [6s 3d Ad] [7h]
Kevinvdv: checks 
LuckyGeo1: checks 
nick phlegm: bets $1
Kevinvdv: raises $2 to $3
LuckyGeo1: folds 
nick phlegm: folds 
Uncalled bet ($2) returned to Kevinvdv
Kevinvdv collected $4.55 from pot
Kevinvdv: shows [5c 4h] (a straight, Three to Seven)
*** SUMMARY ***
Total pot $4.75 | Rake $0.20 
Board [6s 3d Ad 7h]
Seat 1: HammettBets folded before Flop (didn't bet)
Seat 2: Poker Barrie folded before Flop (didn't bet)
Seat 3: TheigerLIly folded before Flop (didn't bet)
Seat 4: LuckyGeo1 folded on the Turn
Seat 5: nick phlegm folded on the Turn
Seat 6: Mrinaldi folded on the Flop
Seat 7: Alameda22 (button) folded before Flop (didn't bet)
Seat 8: Joe1973 (small blind) folded on the Flop
Seat 9: Kevinvdv (big blind) collected ($4.55)



PokerStars Game #19975630191:  Hold'em No Limit ($0.10/$0.25) - 2008/08/28 - 20:32:22 (ET)
Table 'Hippasos IV' 9-max Seat #8 is the button
Seat 1: HammettBets ($25 in chips) 
Seat 2: Poker Barrie ($18.50 in chips) 
Seat 3: TheigerLIly ($13.25 in chips) 
Seat 4: LuckyGeo1 ($19.45 in chips) 
Seat 5: nick phlegm ($11.90 in chips) 
Seat 6: Mrinaldi ($28.20 in chips) 
Seat 7: Alameda22 ($29.75 in chips) 
Seat 8: Joe1973 ($22.30 in chips) 
Seat 9: Kevinvdv ($27.80 in chips) 
Kevinvdv: posts small blind $0.10
HammettBets: posts big blind $0.25
*** HOLE CARDS ***
Dealt to Alameda22 [6s 2d]
nick phlegm said, "nh"
Poker Barrie: folds 
Poker Barrie leaves the table
TheigerLIly: folds 
LuckyGeo1: folds 
nick phlegm: folds 
nick phlegm leaves the table
Mrinaldi: raises $0.50 to $0.75
Le gros pic joins the table at seat #5 
wasserss joins the table at seat #2 
Alameda22: folds 
Joe1973: folds 
Kevinvdv: folds 
HammettBets: folds 
Uncalled bet ($0.50) returned to Mrinaldi
Mrinaldi collected $0.60 from pot
Mrinaldi: doesn't show hand 
*** SUMMARY ***
Total pot $0.60 | Rake $0 
Seat 1: HammettBets (big blind) folded before Flop
Seat 2: Poker Barrie folded before Flop (didn't bet)
Seat 3: TheigerLIly folded before Flop (didn't bet)
Seat 4: LuckyGeo1 folded before Flop (didn't bet)
Seat 5: nick phlegm folded before Flop (didn't bet)
Seat 6: Mrinaldi collected ($0.60)
Seat 7: Alameda22 folded before Flop (didn't bet)
Seat 8: Joe1973 (button) folded before Flop (didn't bet)
Seat 9: Kevinvdv (small blind) folded before Flop



PokerStars Game #19975643728:  Hold'em No Limit ($0.10/$0.25) - 2008/08/28 - 20:32:58 (ET)
Table 'Hippasos IV' 9-max Seat #9 is the button
Seat 1: HammettBets ($24.75 in chips) 
Seat 2: wasserss ($5 in chips) 
Seat 3: TheigerLIly ($13.25 in chips) 
Seat 4: LuckyGeo1 ($19.45 in chips) 
Seat 6: Mrinaldi ($28.55 in chips) 
Seat 7: Alameda22 ($29.75 in chips) 
Seat 8: Joe1973 ($22.30 in chips) 
Seat 9: Kevinvdv ($27.70 in chips) 
HammettBets: posts small blind $0.10
wasserss: posts big blind $0.25
Le gros pic: sits out 
*** HOLE CARDS ***
Dealt to Alameda22 [Qh 7h]
TheigerLIly: calls $0.25
LuckyGeo1: calls $0.25
Mrinaldi: folds 
Alameda22: folds 
Joe1973 is disconnected 
Joe1973 is connected 
Joe1973: calls $0.25
Kevinvdv: calls $0.25
HammettBets: folds 
wasserss: checks 
*** FLOP *** [Th Jh Ks]
wasserss: checks 
TheigerLIly: checks 
LuckyGeo1: checks 
Joe1973: checks 
Kevinvdv: checks 
*** TURN *** [Th Jh Ks] [Qs]
wasserss: checks 
TheigerLIly: checks 
LuckyGeo1: bets $0.75
Joe1973: folds 
Kevinvdv: folds 
wasserss: folds 
TheigerLIly: folds 
Uncalled bet ($0.75) returned to LuckyGeo1
LuckyGeo1 collected $1.30 from pot
LuckyGeo1: doesn't show hand 
*** SUMMARY ***
Total pot $1.35 | Rake $0.05 
Board [Th Jh Ks Qs]
Seat 1: HammettBets (small blind) folded before Flop
Seat 2: wasserss (big blind) folded on the Turn
Seat 3: TheigerLIly folded on the Turn
Seat 4: LuckyGeo1 collected ($1.30)
Seat 6: Mrinaldi folded before Flop (didn't bet)
Seat 7: Alameda22 folded before Flop (didn't bet)
Seat 8: Joe1973 folded on the Turn
Seat 9: Kevinvdv (button) folded on the Turn



PokerStars Game #19975674027:  Hold'em No Limit ($0.10/$0.25) - 2008/08/28 - 20:34:19 (ET)
Table 'Hippasos IV' 9-max Seat #1 is the button
Seat 1: HammettBets ($24.65 in chips) 
Seat 2: wasserss ($4.75 in chips) 
Seat 3: TheigerLIly ($13 in chips) 
Seat 4: LuckyGeo1 ($20.50 in chips) 
Seat 6: Mrinaldi ($28.55 in chips) 
Seat 7: Alameda22 ($29.75 in chips) 
Seat 8: Joe1973 ($22.05 in chips) 
Seat 9: Kevinvdv ($27.45 in chips) 
wasserss: posts small blind $0.10
TheigerLIly: posts big blind $0.25
Le gros pic: sits out 
*** HOLE CARDS ***
Dealt to Alameda22 [Td 7s]
LuckyGeo1: raises $0.50 to $0.75
Mrinaldi: folds 
Alameda22: folds 
Joe1973: folds 
Kevinvdv: folds 
HammettBets: folds 
wasserss: folds 
TheigerLIly: folds 
Uncalled bet ($0.50) returned to LuckyGeo1
LuckyGeo1 collected $0.60 from pot
LuckyGeo1: doesn't show hand 
*** SUMMARY ***
Total pot $0.60 | Rake $0 
Seat 1: HammettBets (button) folded before Flop (didn't bet)
Seat 2: wasserss (small blind) folded before Flop
Seat 3: TheigerLIly (big blind) folded before Flop
Seat 4: LuckyGeo1 collected ($0.60)
Seat 6: Mrinaldi folded before Flop (didn't bet)
Seat 7: Alameda22 folded before Flop (didn't bet)
Seat 8: Joe1973 folded before Flop (didn't bet)
Seat 9: Kevinvdv folded before Flop (didn't bet)



PokerStars Game #19975688429:  Hold'em No Limit ($0.10/$0.25) - 2008/08/28 - 20:34:57 (ET)
Table 'Hippasos IV' 9-max Seat #2 is the button
Seat 1: HammettBets ($24.65 in chips) 
Seat 2: wasserss ($4.65 in chips) 
Seat 3: TheigerLIly ($12.75 in chips) 
Seat 4: LuckyGeo1 ($20.85 in chips) 
Seat 6: Mrinaldi ($28.55 in chips) 
Seat 7: Alameda22 ($29.75 in chips) 
Seat 8: Joe1973 ($22.05 in chips) 
Seat 9: Kevinvdv ($27.45 in chips) 
TheigerLIly: posts small blind $0.10
LuckyGeo1: posts big blind $0.25
Le gros pic: sits out 
*** HOLE CARDS ***
Dealt to Alameda22 [4s Qs]
Mrinaldi: folds 
Alameda22: folds 
Joe1973: folds 
Kevinvdv: raises $0.50 to $0.75
HammettBets: folds 
wasserss: folds 
TheigerLIly: calls $0.65
LuckyGeo1: folds 
*** FLOP *** [Jc 5d 6d]
TheigerLIly: checks 
Kevinvdv: checks 
*** TURN *** [Jc 5d 6d] [3s]
TheigerLIly: checks 
Kevinvdv: bets $1.75
TheigerLIly: folds 
Uncalled bet ($1.75) returned to Kevinvdv
Kevinvdv collected $1.70 from pot
Kevinvdv: doesn't show hand 
*** SUMMARY ***
Total pot $1.75 | Rake $0.05 
Board [Jc 5d 6d 3s]
Seat 1: HammettBets folded before Flop (didn't bet)
Seat 2: wasserss (button) folded before Flop (didn't bet)
Seat 3: TheigerLIly (small blind) folded on the Turn
Seat 4: LuckyGeo1 (big blind) folded before Flop
Seat 6: Mrinaldi folded before Flop (didn't bet)
Seat 7: Alameda22 folded before Flop (didn't bet)
Seat 8: Joe1973 folded before Flop (didn't bet)
Seat 9: Kevinvdv collected ($1.70)



PokerStars Game #19975716203:  Hold'em No Limit ($0.10/$0.25) - 2008/08/28 - 20:36:12 (ET)
Table 'Hippasos IV' 9-max Seat #3 is the button
Seat 1: HammettBets ($24.65 in chips) 
Seat 2: wasserss ($4.65 in chips) 
Seat 3: TheigerLIly ($12 in chips) 
Seat 4: LuckyGeo1 ($20.60 in chips) 
Seat 5: Le gros pic ($25 in chips) 
Seat 6: Mrinaldi ($28.55 in chips) 
Seat 7: Alameda22 ($29.75 in chips) 
Seat 8: Joe1973 ($22.05 in chips) 
Seat 9: Kevinvdv ($28.40 in chips) 
LuckyGeo1: posts small blind $0.10
Le gros pic: posts big blind $0.25
*** HOLE CARDS ***
Dealt to Alameda22 [7s 3c]
Mrinaldi: folds 
Alameda22: folds 
Joe1973: folds 
Kevinvdv: calls $0.25
HammettBets: calls $0.25
wasserss: folds 
TheigerLIly: raises $0.75 to $1
LuckyGeo1: calls $0.90
Le gros pic: raises $24 to $25 and is all-in
Kevinvdv: folds 
HammettBets: folds 
TheigerLIly: calls $11 and is all-in
LuckyGeo1: folds 
Uncalled bet ($13) returned to Le gros pic
*** FLOP *** [2s 2h 3s]
*** TURN *** [2s 2h 3s] [8d]
*** RIVER *** [2s 2h 3s 8d] [6h]
*** SHOW DOWN ***
Le gros pic: shows [As Ad] (two pair, Aces and Deuces)
TheigerLIly: mucks hand 
Le gros pic collected $24.25 from pot
TheigerLIly leaves the table
*** SUMMARY ***
Total pot $25.50 | Rake $1.25 
Board [2s 2h 3s 8d 6h]
Seat 1: HammettBets folded before Flop
Seat 2: wasserss folded before Flop (didn't bet)
Seat 3: TheigerLIly (button) mucked [Qd Qs]
Seat 4: LuckyGeo1 (small blind) folded before Flop
Seat 5: Le gros pic (big blind) showed [As Ad] and won ($24.25) with two pair, Aces and Deuces
Seat 6: Mrinaldi folded before Flop (didn't bet)
Seat 7: Alameda22 folded before Flop (didn't bet)
Seat 8: Joe1973 folded before Flop (didn't bet)
Seat 9: Kevinvdv folded before Flop



PokerStars Game #19975741605:  Hold'em No Limit ($0.10/$0.25) - 2008/08/28 - 20:37:20 (ET)
Table 'Hippasos IV' 9-max Seat #4 is the button
Seat 1: HammettBets ($24.40 in chips) 
Seat 2: wasserss ($4.65 in chips) 
Seat 4: LuckyGeo1 ($19.60 in chips) 
Seat 5: Le gros pic ($37.25 in chips) 
Seat 6: Mrinaldi ($28.55 in chips) 
Seat 7: Alameda22 ($29.75 in chips) 
Seat 8: Joe1973 ($22.05 in chips) 
Seat 9: Kevinvdv ($28.15 in chips) 
Le gros pic: posts small blind $0.10
Mrinaldi: posts big blind $0.25
*** HOLE CARDS ***
Dealt to Alameda22 [Jd 4h]
Alameda22: folds 
Joe1973: folds 
Kevinvdv: folds 
HammettBets: folds 
wasserss: folds 
LuckyGeo1: calls $0.25
Le gros pic: folds 
Mrinaldi: checks 
*** FLOP *** [6d 4c 2d]
ehle11 joins the table at seat #3 
Mrinaldi: checks 
LuckyGeo1: bets $0.75
Mrinaldi: folds 
Uncalled bet ($0.75) returned to LuckyGeo1
LuckyGeo1 collected $0.60 from pot
LuckyGeo1: doesn't show hand 
*** SUMMARY ***
Total pot $0.60 | Rake $0 
Board [6d 4c 2d]
Seat 1: HammettBets folded before Flop (didn't bet)
Seat 2: wasserss folded before Flop (didn't bet)
Seat 4: LuckyGeo1 (button) collected ($0.60)
Seat 5: Le gros pic (small blind) folded before Flop
Seat 6: Mrinaldi (big blind) folded on the Flop
Seat 7: Alameda22 folded before Flop (didn't bet)
Seat 8: Joe1973 folded before Flop (didn't bet)
Seat 9: Kevinvdv folded before Flop (didn't bet)



PokerStars Game #19975752666:  Hold'em No Limit ($0.10/$0.25) - 2008/08/28 - 20:37:50 (ET)
Table 'Hippasos IV' 9-max Seat #5 is the button
Seat 1: HammettBets ($24.40 in chips) 
Seat 2: wasserss ($4.65 in chips) 
Seat 3: ehle11 ($25 in chips) 
Seat 4: LuckyGeo1 ($19.95 in chips) 
Seat 5: Le gros pic ($37.15 in chips) 
Seat 6: Mrinaldi ($28.30 in chips) 
Seat 7: Alameda22 ($29.75 in chips) 
Seat 8: Joe1973 ($22.05 in chips) 
Seat 9: Kevinvdv ($28.15 in chips) 
Mrinaldi: posts small blind $0.10
Alameda22: posts big blind $0.25
ehle11: posts big blind $0.25
*** HOLE CARDS ***
Dealt to Alameda22 [6c Ac]
Joe1973: folds 
Kevinvdv: folds 
HammettBets: folds 
wasserss: folds 
ehle11: checks 
LuckyGeo1: calls $0.25
Le gros pic: calls $0.25
Mrinaldi: calls $0.15
Alameda22: checks 
*** FLOP *** [Kd Qs As]
Mrinaldi: checks 
Alameda22: checks 
ehle11: checks 
LuckyGeo1: checks 
Le gros pic: checks 
*** TURN *** [Kd Qs As] [3s]
Mrinaldi: checks 
Alameda22: checks 
ehle11: checks 
LuckyGeo1: checks 
Le gros pic: checks 
*** RIVER *** [Kd Qs As 3s] [7d]
Mrinaldi: checks 
Alameda22: checks 
ehle11: checks 
LuckyGeo1: checks 
Le gros pic: checks 
*** SHOW DOWN ***
Mrinaldi: shows [Jh Kh] (a pair of Kings)
Alameda22: shows [6c Ac] (a pair of Aces)
ehle11: mucks hand 
LuckyGeo1: mucks hand 
Le gros pic: mucks hand 
Alameda22 collected $1.20 from pot
*** SUMMARY ***
Total pot $1.25 | Rake $0.05 
Board [Kd Qs As 3s 7d]
Seat 1: HammettBets folded before Flop (didn't bet)
Seat 2: wasserss folded before Flop (didn't bet)
Seat 3: ehle11 mucked [5c 4d]
Seat 4: LuckyGeo1 mucked [9h 7c]
Seat 5: Le gros pic (button) mucked [5h 4s]
Seat 6: Mrinaldi (small blind) showed [Jh Kh] and lost with a pair of Kings
Seat 7: Alameda22 (big blind) showed [6c Ac] and won ($1.20) with a pair of Aces
Seat 8: Joe1973 folded before Flop (didn't bet)
Seat 9: Kevinvdv folded before Flop (didn't bet)



PokerStars Game #19975796844:  Hold'em No Limit ($0.10/$0.25) - 2008/08/28 - 20:39:48 (ET)
Table 'Hippasos IV' 9-max Seat #6 is the button
Seat 1: HammettBets ($24.40 in chips) 
Seat 2: wasserss ($4.65 in chips) 
Seat 3: ehle11 ($24.75 in chips) 
Seat 4: LuckyGeo1 ($19.70 in chips) 
Seat 5: Le gros pic ($36.90 in chips) 
Seat 6: Mrinaldi ($28.05 in chips) 
Seat 7: Alameda22 ($30.70 in chips) 
Seat 8: Joe1973 ($22.05 in chips) 
Seat 9: Kevinvdv ($28.15 in chips) 
Alameda22: posts small blind $0.10
Joe1973: posts big blind $0.25
*** HOLE CARDS ***
Dealt to Alameda22 [4c 9d]
Kevinvdv: calls $0.25
HammettBets: folds 
wasserss: folds 
ehle11: folds 
LuckyGeo1: raises $0.25 to $0.50
Le gros pic: folds 
Mrinaldi: folds 
Alameda22: folds 
Joe1973: calls $0.25
Kevinvdv: calls $0.25
*** FLOP *** [7h Th As]
Joe1973: checks 
Kevinvdv: checks 
LuckyGeo1: checks 
*** TURN *** [7h Th As] [3h]
Joe1973: checks 
Kevinvdv: bets $1.25
LuckyGeo1: calls $1.25
Joe1973: folds 
*** RIVER *** [7h Th As 3h] [4d]
Kevinvdv: bets $5.50
LuckyGeo1: calls $5.50
*** SHOW DOWN ***
Kevinvdv: shows [9h Kh] (a flush, King high)
LuckyGeo1: mucks hand 
Kevinvdv collected $14.40 from pot
*** SUMMARY ***
Total pot $15.10 | Rake $0.70 
Board [7h Th As 3h 4d]
Seat 1: HammettBets folded before Flop (didn't bet)
Seat 2: wasserss folded before Flop (didn't bet)
Seat 3: ehle11 folded before Flop (didn't bet)
Seat 4: LuckyGeo1 mucked [5h 2h]
Seat 5: Le gros pic folded before Flop (didn't bet)
Seat 6: Mrinaldi (button) folded before Flop (didn't bet)
Seat 7: Alameda22 (small blind) folded before Flop
Seat 8: Joe1973 (big blind) folded on the Turn
Seat 9: Kevinvdv showed [9h Kh] and won ($14.40) with a flush, King high



PokerStars Game #19975821339:  Hold'em No Limit ($0.10/$0.25) - 2008/08/28 - 20:40:53 (ET)
Table 'Hippasos IV' 9-max Seat #7 is the button
Seat 1: HammettBets ($24.40 in chips) 
Seat 2: wasserss ($4.65 in chips) 
Seat 3: ehle11 ($24.75 in chips) 
Seat 4: LuckyGeo1 ($12.45 in chips) 
Seat 5: Le gros pic ($36.90 in chips) 
Seat 6: Mrinaldi ($28.05 in chips) 
Seat 7: Alameda22 ($30.60 in chips) 
Seat 8: Joe1973 ($21.55 in chips) 
Seat 9: Kevinvdv ($35.30 in chips) 
Joe1973: posts small blind $0.10
Kevinvdv: posts big blind $0.25
*** HOLE CARDS ***
Dealt to Alameda22 [Ad Td]
HammettBets: folds 
wasserss: folds 
ehle11: folds 
LuckyGeo1: calls $0.25
Le gros pic: folds 
Mrinaldi: folds 
Alameda22: folds 
Joe1973: calls $0.15
Kevinvdv: checks 
*** FLOP *** [7h 9s 8d]
Joe1973: bets $0.50
Kevinvdv: calls $0.50
LuckyGeo1: calls $0.50
*** TURN *** [7h 9s 8d] [7d]
Joe1973: bets $0.50
Kevinvdv: calls $0.50
LuckyGeo1: calls $0.50
*** RIVER *** [7h 9s 8d 7d] [Qc]
Joe1973: bets $0.50
Kevinvdv: folds 
LuckyGeo1: folds 
Uncalled bet ($0.50) returned to Joe1973
Joe1973 collected $3.60 from pot
Joe1973: doesn't show hand 
*** SUMMARY ***
Total pot $3.75 | Rake $0.15 
Board [7h 9s 8d 7d Qc]
Seat 1: HammettBets folded before Flop (didn't bet)
Seat 2: wasserss folded before Flop (didn't bet)
Seat 3: ehle11 folded before Flop (didn't bet)
Seat 4: LuckyGeo1 folded on the River
Seat 5: Le gros pic folded before Flop (didn't bet)
Seat 6: Mrinaldi folded before Flop (didn't bet)
Seat 7: Alameda22 (button) folded before Flop (didn't bet)
Seat 8: Joe1973 (small blind) collected ($3.60)
Seat 9: Kevinvdv (big blind) folded on the River



PokerStars Game #19975843623:  Hold'em No Limit ($0.10/$0.25) - 2008/08/28 - 20:41:53 (ET)
Table 'Hippasos IV' 9-max Seat #8 is the button
Seat 1: HammettBets ($24.40 in chips) 
Seat 2: wasserss ($4.65 in chips) 
Seat 3: ehle11 ($24.75 in chips) 
Seat 4: LuckyGeo1 ($11.20 in chips) 
Seat 5: Le gros pic ($36.90 in chips) 
Seat 6: Mrinaldi ($28.05 in chips) 
Seat 7: Alameda22 ($30.60 in chips) 
Seat 8: Joe1973 ($23.90 in chips) 
Seat 9: Kevinvdv ($34.05 in chips) 
Kevinvdv: posts small blind $0.10
HammettBets: posts big blind $0.25
*** HOLE CARDS ***
Dealt to Alameda22 [3c 9d]
wasserss: folds 
ehle11: folds 
LuckyGeo1: raises $0.25 to $0.50
Le gros pic: calls $0.50
Mrinaldi: calls $0.50
Alameda22: folds 
Joe1973: folds 
Kevinvdv: folds 
HammettBets: calls $0.25
*** FLOP *** [Kc 2d 7c]
HammettBets: checks 
LuckyGeo1: checks 
Le gros pic: checks 
Mrinaldi: bets $1
HammettBets: calls $1
LuckyGeo1: calls $1
Le gros pic: calls $1
*** TURN *** [Kc 2d 7c] [5h]
HammettBets: checks 
LuckyGeo1: checks 
Le gros pic: checks 
Mrinaldi: checks 
*** RIVER *** [Kc 2d 7c 5h] [As]
HammettBets: checks 
LuckyGeo1: bets $1.25
Le gros pic: folds 
Mrinaldi: folds 
HammettBets: calls $1.25
*** SHOW DOWN ***
LuckyGeo1: shows [Kd Kh] (three of a kind, Kings)
HammettBets: mucks hand 
LuckyGeo1 collected $8.20 from pot
*** SUMMARY ***
Total pot $8.60 | Rake $0.40 
Board [Kc 2d 7c 5h As]
Seat 1: HammettBets (big blind) mucked [Ac Qc]
Seat 2: wasserss folded before Flop (didn't bet)
Seat 3: ehle11 folded before Flop (didn't bet)
Seat 4: LuckyGeo1 showed [Kd Kh] and won ($8.20) with three of a kind, Kings
Seat 5: Le gros pic folded on the River
Seat 6: Mrinaldi folded on the River
Seat 7: Alameda22 folded before Flop (didn't bet)
Seat 8: Joe1973 (button) folded before Flop (didn't bet)
Seat 9: Kevinvdv (small blind) folded before Flop



PokerStars Game #19975869706:  Hold'em No Limit ($0.10/$0.25) - 2008/08/28 - 20:43:04 (ET)
Table 'Hippasos IV' 9-max Seat #9 is the button
Seat 1: HammettBets ($21.65 in chips) 
Seat 2: wasserss ($4.65 in chips) 
Seat 3: ehle11 ($24.75 in chips) 
Seat 4: LuckyGeo1 ($16.65 in chips) 
Seat 5: Le gros pic ($35.40 in chips) 
Seat 6: Mrinaldi ($26.55 in chips) 
Seat 7: Alameda22 ($30.60 in chips) 
Seat 8: Joe1973 ($23.90 in chips) 
Seat 9: Kevinvdv ($33.95 in chips) 
HammettBets: posts small blind $0.10
wasserss: posts big blind $0.25
*** HOLE CARDS ***
Dealt to Alameda22 [Qc Js]
ehle11: raises $1 to $1.25
LuckyGeo1: calls $1.25
Le gros pic: folds 
Mrinaldi: folds 
Alameda22: folds 
Joe1973: folds 
Kevinvdv: folds 
HammettBets: folds 
wasserss: folds 
*** FLOP *** [Qd Ad Qs]
ehle11: bets $1.50
LuckyGeo1: folds 
Uncalled bet ($1.50) returned to ehle11
ehle11 collected $2.75 from pot
ehle11: doesn't show hand 
*** SUMMARY ***
Total pot $2.85 | Rake $0.10 
Board [Qd Ad Qs]
Seat 1: HammettBets (small blind) folded before Flop
Seat 2: wasserss (big blind) folded before Flop
Seat 3: ehle11 collected ($2.75)
Seat 4: LuckyGeo1 folded on the Flop
Seat 5: Le gros pic folded before Flop (didn't bet)
Seat 6: Mrinaldi folded before Flop (didn't bet)
Seat 7: Alameda22 folded before Flop (didn't bet)
Seat 8: Joe1973 folded before Flop (didn't bet)
Seat 9: Kevinvdv (button) folded before Flop (didn't bet)



PokerStars Game #19975880770:  Hold'em No Limit ($0.10/$0.25) - 2008/08/28 - 20:43:34 (ET)
Table 'Hippasos IV' 9-max Seat #1 is the button
Seat 1: HammettBets ($21.55 in chips) 
Seat 2: wasserss ($4.40 in chips) 
Seat 3: ehle11 ($26.25 in chips) 
Seat 4: LuckyGeo1 ($15.40 in chips) 
Seat 5: Le gros pic ($35.40 in chips) 
Seat 6: Mrinaldi ($26.55 in chips) 
Seat 7: Alameda22 ($30.60 in chips) 
Seat 8: Joe1973 ($23.90 in chips) 
Seat 9: Kevinvdv ($33.95 in chips) 
wasserss: posts small blind $0.10
ehle11: posts big blind $0.25
*** HOLE CARDS ***
Dealt to Alameda22 [Qd 4c]
LuckyGeo1: raises $0.25 to $0.50
Le gros pic: folds 
Mrinaldi: folds 
Alameda22: folds 
Joe1973: folds 
Kevinvdv: folds 
HammettBets: folds 
wasserss: folds 
ehle11: calls $0.25
*** FLOP *** [Qc Ts Th]
ehle11: checks 
LuckyGeo1: bets $0.50
ehle11: raises $1 to $1.50
LuckyGeo1: folds 
Uncalled bet ($1) returned to ehle11
ehle11 collected $2 from pot
ehle11: doesn't show hand 
*** SUMMARY ***
Total pot $2.10 | Rake $0.10 
Board [Qc Ts Th]
Seat 1: HammettBets (button) folded before Flop (didn't bet)
Seat 2: wasserss (small blind) folded before Flop
Seat 3: ehle11 (big blind) collected ($2)
Seat 4: LuckyGeo1 folded on the Flop
Seat 5: Le gros pic folded before Flop (didn't bet)
Seat 6: Mrinaldi folded before Flop (didn't bet)
Seat 7: Alameda22 folded before Flop (didn't bet)
Seat 8: Joe1973 folded before Flop (didn't bet)
Seat 9: Kevinvdv folded before Flop (didn't bet)



PokerStars Game #19975894944:  Hold'em No Limit ($0.10/$0.25) - 2008/08/28 - 20:44:12 (ET)
Table 'Hippasos IV' 9-max Seat #2 is the button
Seat 1: HammettBets ($21.55 in chips) 
Seat 2: wasserss ($4.30 in chips) 
Seat 3: ehle11 ($27.25 in chips) 
Seat 4: LuckyGeo1 ($14.40 in chips) 
Seat 5: Le gros pic ($35.40 in chips) 
Seat 6: Mrinaldi ($26.55 in chips) 
Seat 7: Alameda22 ($30.60 in chips) 
Seat 8: Joe1973 ($23.90 in chips) 
Seat 9: Kevinvdv ($33.95 in chips) 
ehle11: posts small blind $0.10
LuckyGeo1: posts big blind $0.25
*** HOLE CARDS ***
Dealt to Alameda22 [3c 5h]
Le gros pic: folds 
Mrinaldi: folds 
Alameda22: folds 
Joe1973: folds 
Kevinvdv: folds 
HammettBets: raises $0.50 to $0.75
wasserss: folds 
ehle11: folds 
LuckyGeo1: calls $0.50
*** FLOP *** [6d As Kc]
LuckyGeo1: checks 
HammettBets: bets $1
LuckyGeo1: calls $1
*** TURN *** [6d As Kc] [5s]
LuckyGeo1: checks 
HammettBets: bets $1.25
LuckyGeo1: calls $1.25
*** RIVER *** [6d As Kc 5s] [Ts]
LuckyGeo1: checks 
HammettBets: checks 
*** SHOW DOWN ***
LuckyGeo1: shows [7c 6c] (a pair of Sixes)
HammettBets: shows [Jc Ah] (a pair of Aces)
HammettBets collected $5.85 from pot
*** SUMMARY ***
Total pot $6.10 | Rake $0.25 
Board [6d As Kc 5s Ts]
Seat 1: HammettBets showed [Jc Ah] and won ($5.85) with a pair of Aces
Seat 2: wasserss (button) folded before Flop (didn't bet)
Seat 3: ehle11 (small blind) folded before Flop
Seat 4: LuckyGeo1 (big blind) showed [7c 6c] and lost with a pair of Sixes
Seat 5: Le gros pic folded before Flop (didn't bet)
Seat 6: Mrinaldi folded before Flop (didn't bet)
Seat 7: Alameda22 folded before Flop (didn't bet)
Seat 8: Joe1973 folded before Flop (didn't bet)
Seat 9: Kevinvdv folded before Flop (didn't bet)



PokerStars Game #19975922466:  Hold'em No Limit ($0.10/$0.25) - 2008/08/28 - 20:45:27 (ET)
Table 'Hippasos IV' 9-max Seat #3 is the button
Seat 1: HammettBets ($24.40 in chips) 
Seat 2: wasserss ($4.30 in chips) 
Seat 3: ehle11 ($27.15 in chips) 
Seat 4: LuckyGeo1 ($11.40 in chips) 
Seat 5: Le gros pic ($35.40 in chips) 
Seat 6: Mrinaldi ($26.55 in chips) 
Seat 7: Alameda22 ($30.60 in chips) 
Seat 8: Joe1973 ($23.90 in chips) 
Seat 9: Kevinvdv ($33.95 in chips) 
LuckyGeo1: posts small blind $0.10
Le gros pic: posts big blind $0.25
*** HOLE CARDS ***
Dealt to Alameda22 [Ts As]
Mrinaldi: folds 
Alameda22: folds 
Joe1973: folds 
Kevinvdv: folds 
HammettBets: folds 
wasserss: folds 
ehle11: folds 
LuckyGeo1: calls $0.15
Le gros pic: checks 
*** FLOP *** [8h Ad Kd]
LuckyGeo1: bets $0.75
Le gros pic: folds 
Uncalled bet ($0.75) returned to LuckyGeo1
LuckyGeo1 collected $0.50 from pot
*** SUMMARY ***
Total pot $0.50 | Rake $0 
Board [8h Ad Kd]
Seat 1: HammettBets folded before Flop (didn't bet)
Seat 2: wasserss folded before Flop (didn't bet)
Seat 3: ehle11 (button) folded before Flop (didn't bet)
Seat 4: LuckyGeo1 (small blind) collected ($0.50)
Seat 5: Le gros pic (big blind) folded on the Flop
Seat 6: Mrinaldi folded before Flop (didn't bet)
Seat 7: Alameda22 folded before Flop (didn't bet)
Seat 8: Joe1973 folded before Flop (didn't bet)
Seat 9: Kevinvdv folded before Flop (didn't bet)



PokerStars Game #19975938707:  Hold'em No Limit ($0.10/$0.25) - 2008/08/28 - 20:46:12 (ET)
Table 'Hippasos IV' 9-max Seat #4 is the button
Seat 1: HammettBets ($24.40 in chips) 
Seat 2: wasserss ($4.30 in chips) 
Seat 3: ehle11 ($27.15 in chips) 
Seat 4: LuckyGeo1 ($11.65 in chips) 
Seat 5: Le gros pic ($35.15 in chips) 
Seat 6: Mrinaldi ($26.55 in chips) 
Seat 7: Alameda22 ($30.60 in chips) 
Seat 8: Joe1973 ($23.90 in chips) 
Seat 9: Kevinvdv ($33.95 in chips) 
Le gros pic: posts small blind $0.10
Mrinaldi: posts big blind $0.25
*** HOLE CARDS ***
Dealt to Alameda22 [3s 7d]
Alameda22: folds 
Joe1973: folds 
Kevinvdv: folds 
HammettBets: folds 
wasserss: folds 
ehle11: folds 
LuckyGeo1: calls $0.25
Le gros pic: folds 
Mrinaldi: checks 
*** FLOP *** [2s Kc 8c]
Mrinaldi: checks 
LuckyGeo1: bets $0.50
Mrinaldi: folds 
Uncalled bet ($0.50) returned to LuckyGeo1
LuckyGeo1 collected $0.60 from pot
LuckyGeo1: doesn't show hand 
*** SUMMARY ***
Total pot $0.60 | Rake $0 
Board [2s Kc 8c]
Seat 1: HammettBets folded before Flop (didn't bet)
Seat 2: wasserss folded before Flop (didn't bet)
Seat 3: ehle11 folded before Flop (didn't bet)
Seat 4: LuckyGeo1 (button) collected ($0.60)
Seat 5: Le gros pic (small blind) folded before Flop
Seat 6: Mrinaldi (big blind) folded on the Flop
Seat 7: Alameda22 folded before Flop (didn't bet)
Seat 8: Joe1973 folded before Flop (didn't bet)
Seat 9: Kevinvdv folded before Flop (didn't bet)



PokerStars Game #19975962181:  Hold'em No Limit ($0.10/$0.25) - 2008/08/28 - 20:47:16 (ET)
Table 'Hippasos IV' 9-max Seat #5 is the button
Seat 1: HammettBets ($24.40 in chips) 
Seat 2: wasserss ($4.30 in chips) 
Seat 3: ehle11 ($27.15 in chips) 
Seat 4: LuckyGeo1 ($12 in chips) 
Seat 5: Le gros pic ($35.05 in chips) 
Seat 6: Mrinaldi ($26.30 in chips) 
Seat 7: Alameda22 ($30.60 in chips) 
Seat 8: Joe1973 ($23.90 in chips) 
Seat 9: Kevinvdv ($33.95 in chips) 
Mrinaldi: posts small blind $0.10
Alameda22: posts big blind $0.25
*** HOLE CARDS ***
Dealt to Alameda22 [7s 6s]
Joe1973: folds 
Kevinvdv: folds 
Joe1973 is sitting out
HammettBets: raises $0.50 to $0.75
Joe1973 leaves the table
wasserss: folds 
ehle11: folds 
LuckyGeo1: calls $0.75
Le gros pic: folds 
Mrinaldi: folds 
Alameda22: calls $0.50
*** FLOP *** [3c Ks 6c]
Alameda22: checks 
HammettBets: checks 
LuckyGeo1: checks 
*** TURN *** [3c Ks 6c] [8d]
Alameda22: checks 
HammettBets: checks 
LuckyGeo1: checks 
*** RIVER *** [3c Ks 6c 8d] [Jh]
Alameda22: checks 
HammettBets: checks 
LuckyGeo1: checks 
*** SHOW DOWN ***
Alameda22: shows [7s 6s] (a pair of Sixes)
HammettBets: mucks hand 
LuckyGeo1: mucks hand 
Alameda22 collected $2.25 from pot
*** SUMMARY ***
Total pot $2.35 | Rake $0.10 
Board [3c Ks 6c 8d Jh]
Seat 1: HammettBets mucked [Th Ad]
Seat 2: wasserss folded before Flop (didn't bet)
Seat 3: ehle11 folded before Flop (didn't bet)
Seat 4: LuckyGeo1 mucked [7c 5d]
Seat 5: Le gros pic (button) folded before Flop (didn't bet)
Seat 6: Mrinaldi (small blind) folded before Flop
Seat 7: Alameda22 (big blind) showed [7s 6s] and won ($2.25) with a pair of Sixes
Seat 8: Joe1973 folded before Flop (didn't bet)
Seat 9: Kevinvdv folded before Flop (didn't bet)



PokerStars Game #19975996454:  Hold'em No Limit ($0.10/$0.25) - 2008/08/28 - 20:48:50 (ET)
Table 'Hippasos IV' 9-max Seat #6 is the button
Seat 1: HammettBets ($23.65 in chips) 
Seat 2: wasserss ($4.30 in chips) 
Seat 3: ehle11 ($27.15 in chips) 
Seat 4: LuckyGeo1 ($11.25 in chips) 
Seat 5: Le gros pic ($35.05 in chips) 
Seat 6: Mrinaldi ($26.20 in chips) 
Seat 7: Alameda22 ($32.10 in chips) 
Seat 9: Kevinvdv ($33.95 in chips) 
Alameda22: posts small blind $0.10
Kevinvdv: posts big blind $0.25
*** HOLE CARDS ***
Dealt to Alameda22 [Tc Td]
HammettBets: folds 
wasserss: folds 
ehle11: raises $1 to $1.25
LuckyGeo1: calls $1.25
Le gros pic: folds 
Mrinaldi: folds 
HammettBets leaves the table
Alameda22: calls $1.15
Kevinvdv: calls $1
*** FLOP *** [7c 2c Kc]
ty890 joins the table at seat #1 
Alameda22: checks 
Kevinvdv: checks 
ehle11: checks 
LuckyGeo1: checks 
*** TURN *** [7c 2c Kc] [Jd]
Alameda22: checks 
Kevinvdv: checks 
ehle11: checks 
LuckyGeo1: checks 
*** RIVER *** [7c 2c Kc Jd] [Qd]
Alameda22: checks 
Kevinvdv: bets $2
ehle11: folds 
LuckyGeo1: folds 
Alameda22: folds 
Uncalled bet ($2) returned to Kevinvdv
doom069 joins the table at seat #8 
Kevinvdv collected $4.75 from pot
Kevinvdv: shows [Ah Th] (a straight, Ten to Ace)
*** SUMMARY ***
Total pot $5 | Rake $0.25 
Board [7c 2c Kc Jd Qd]
Seat 1: HammettBets folded before Flop (didn't bet)
Seat 2: wasserss folded before Flop (didn't bet)
Seat 3: ehle11 folded on the River
Seat 4: LuckyGeo1 folded on the River
Seat 5: Le gros pic folded before Flop (didn't bet)
Seat 6: Mrinaldi (button) folded before Flop (didn't bet)
Seat 7: Alameda22 (small blind) folded on the River
Seat 9: Kevinvdv (big blind) collected ($4.75)



PokerStars Game #19976031490:  Hold'em No Limit ($0.10/$0.25) - 2008/08/28 - 20:50:26 (ET)
Table 'Hippasos IV' 9-max Seat #7 is the button
Seat 1: ty890 ($5 in chips) 
Seat 2: wasserss ($4.30 in chips) 
Seat 3: ehle11 ($25.90 in chips) 
Seat 4: LuckyGeo1 ($10 in chips) 
Seat 5: Le gros pic ($35.05 in chips) 
Seat 6: Mrinaldi ($26.20 in chips) 
Seat 7: Alameda22 ($30.85 in chips) 
Seat 9: Kevinvdv ($37.45 in chips) 
doom069 will be allowed to play after the button
Kevinvdv: posts small blind $0.10
ty890: posts big blind $0.25
*** HOLE CARDS ***
Dealt to Alameda22 [Tc 8d]
wasserss: folds 
ehle11: folds 
LuckyGeo1: calls $0.25
Le gros pic: folds 
Mrinaldi: folds 
Alameda22: folds 
Kevinvdv: calls $0.15
ty890: checks 
*** FLOP *** [3s Qd 9h]
Kevinvdv: checks 
ty890: checks 
LuckyGeo1: checks 
*** TURN *** [3s Qd 9h] [As]
Kevinvdv: bets $1
ty890: calls $1
LuckyGeo1: folds 
*** RIVER *** [3s Qd 9h As] [2c]
Kevinvdv: checks 
ty890: bets $1.50
Kevinvdv: folds 
Uncalled bet ($1.50) returned to ty890
ty890 collected $2.65 from pot
*** SUMMARY ***
Total pot $2.75 | Rake $0.10 
Board [3s Qd 9h As 2c]
Seat 1: ty890 (big blind) collected ($2.65)
Seat 2: wasserss folded before Flop (didn't bet)
Seat 3: ehle11 folded before Flop (didn't bet)
Seat 4: LuckyGeo1 folded on the Turn
Seat 5: Le gros pic folded before Flop (didn't bet)
Seat 6: Mrinaldi folded before Flop (didn't bet)
Seat 7: Alameda22 (button) folded before Flop (didn't bet)
Seat 9: Kevinvdv (small blind) folded on the River



PokerStars Game #19976057311:  Hold'em No Limit ($0.10/$0.25) - 2008/08/28 - 20:51:36 (ET)
Table 'Hippasos IV' 9-max Seat #9 is the button
Seat 1: ty890 ($6.40 in chips) 
Seat 2: wasserss ($4.30 in chips) 
Seat 3: ehle11 ($25.90 in chips) 
Seat 4: LuckyGeo1 ($9.75 in chips) 
Seat 5: Le gros pic ($35.05 in chips) 
Seat 6: Mrinaldi ($26.20 in chips) 
Seat 7: Alameda22 ($30.85 in chips) 
Seat 8: doom069 ($25 in chips) 
Seat 9: Kevinvdv ($36.20 in chips) 
ty890: posts small blind $0.10
wasserss: posts big blind $0.25
doom069: posts big blind $0.25
*** HOLE CARDS ***
Dealt to Alameda22 [Ac Jd]
ehle11: folds 
LuckyGeo1: raises $0.50 to $0.75
Le gros pic: folds 
Mrinaldi: folds 
Alameda22: folds 
doom069: folds 
Kevinvdv: folds 
ty890: folds 
wasserss: folds 
Uncalled bet ($0.50) returned to LuckyGeo1
LuckyGeo1 collected $0.85 from pot
LuckyGeo1: doesn't show hand 
*** SUMMARY ***
Total pot $0.85 | Rake $0 
Seat 1: ty890 (small blind) folded before Flop
Seat 2: wasserss (big blind) folded before Flop
Seat 3: ehle11 folded before Flop (didn't bet)
Seat 4: LuckyGeo1 collected ($0.85)
Seat 5: Le gros pic folded before Flop (didn't bet)
Seat 6: Mrinaldi folded before Flop (didn't bet)
Seat 7: Alameda22 folded before Flop (didn't bet)
Seat 8: doom069 folded before Flop
Seat 9: Kevinvdv (button) folded before Flop (didn't bet)



PokerStars Game #19976078339:  Hold'em No Limit ($0.10/$0.25) - 2008/08/28 - 20:52:34 (ET)
Table 'Hippasos IV' 9-max Seat #1 is the button
Seat 1: ty890 ($6.30 in chips) 
Seat 2: wasserss ($4.05 in chips) 
Seat 3: ehle11 ($25.90 in chips) 
Seat 4: LuckyGeo1 ($10.35 in chips) 
Seat 5: Le gros pic ($35.05 in chips) 
Seat 6: Mrinaldi ($26.20 in chips) 
Seat 7: Alameda22 ($30.85 in chips) 
Seat 8: doom069 ($24.75 in chips) 
Seat 9: Kevinvdv ($36.20 in chips) 
wasserss: posts small blind $0.10
ehle11: posts big blind $0.25
*** HOLE CARDS ***
Dealt to Alameda22 [9s Qs]
LuckyGeo1: folds 
Le gros pic: folds 
Mrinaldi: folds 
Alameda22: folds 
doom069: raises $0.75 to $1
Kevinvdv: folds 
ty890: folds 
wasserss: folds 
ehle11: calls $0.75
*** FLOP *** [4c Kd 6c]
ehle11: bets $1.50
doom069: folds 
Uncalled bet ($1.50) returned to ehle11
ehle11 collected $2 from pot
ehle11: doesn't show hand 
*** SUMMARY ***
Total pot $2.10 | Rake $0.10 
Board [4c Kd 6c]
Seat 1: ty890 (button) folded before Flop (didn't bet)
Seat 2: wasserss (small blind) folded before Flop
Seat 3: ehle11 (big blind) collected ($2)
Seat 4: LuckyGeo1 folded before Flop (didn't bet)
Seat 5: Le gros pic folded before Flop (didn't bet)
Seat 6: Mrinaldi folded before Flop (didn't bet)
Seat 7: Alameda22 folded before Flop (didn't bet)
Seat 8: doom069 folded on the Flop
Seat 9: Kevinvdv folded before Flop (didn't bet)



PokerStars Game #19976091851:  Hold'em No Limit ($0.10/$0.25) - 2008/08/28 - 20:53:12 (ET)
Table 'Hippasos IV' 9-max Seat #2 is the button
Seat 1: ty890 ($6.30 in chips) 
Seat 2: wasserss ($3.95 in chips) 
Seat 3: ehle11 ($26.90 in chips) 
Seat 4: LuckyGeo1 ($10.35 in chips) 
Seat 5: Le gros pic ($35.05 in chips) 
Seat 6: Mrinaldi ($26.20 in chips) 
Seat 7: Alameda22 ($30.85 in chips) 
Seat 8: doom069 ($23.75 in chips) 
Seat 9: Kevinvdv ($36.20 in chips) 
ehle11: posts small blind $0.10
LuckyGeo1: posts big blind $0.25
*** HOLE CARDS ***
Dealt to Alameda22 [3s 8c]
Le gros pic: raises $0.50 to $0.75
Mrinaldi: folds 
Alameda22: folds 
doom069: folds 
Kevinvdv: folds 
ty890: folds 
wasserss: folds 
ehle11: folds 
LuckyGeo1: raises $0.50 to $1.25
Le gros pic: calls $0.50
*** FLOP *** [Qs 5h 4s]
LuckyGeo1: checks 
Le gros pic: checks 
*** TURN *** [Qs 5h 4s] [6d]
LuckyGeo1: checks 
Le gros pic: bets $2
LuckyGeo1: calls $2
*** RIVER *** [Qs 5h 4s 6d] [6s]
LuckyGeo1: checks 
Le gros pic: bets $5.50
LuckyGeo1: calls $5.50
*** SHOW DOWN ***
Le gros pic: shows [Kh Jh] (a pair of Sixes)
LuckyGeo1: shows [Ah Kd] (a pair of Sixes - Ace kicker)
LuckyGeo1 collected $16.75 from pot
*** SUMMARY ***
Total pot $17.60 | Rake $0.85 
Board [Qs 5h 4s 6d 6s]
Seat 1: ty890 folded before Flop (didn't bet)
Seat 2: wasserss (button) folded before Flop (didn't bet)
Seat 3: ehle11 (small blind) folded before Flop
Seat 4: LuckyGeo1 (big blind) showed [Ah Kd] and won ($16.75) with a pair of Sixes
Seat 5: Le gros pic showed [Kh Jh] and lost with a pair of Sixes
Seat 6: Mrinaldi folded before Flop (didn't bet)
Seat 7: Alameda22 folded before Flop (didn't bet)
Seat 8: doom069 folded before Flop (didn't bet)
Seat 9: Kevinvdv folded before Flop (didn't bet)



PokerStars Game #19976121452:  Hold'em No Limit ($0.10/$0.25) - 2008/08/28 - 20:54:34 (ET)
Table 'Hippasos IV' 9-max Seat #3 is the button
Seat 1: ty890 ($6.30 in chips) 
Seat 2: wasserss ($3.95 in chips) 
Seat 3: ehle11 ($26.80 in chips) 
Seat 4: LuckyGeo1 ($18.35 in chips) 
Seat 5: Le gros pic ($26.30 in chips) 
Seat 6: Mrinaldi ($26.20 in chips) 
Seat 7: Alameda22 ($30.85 in chips) 
Seat 8: doom069 ($23.75 in chips) 
Seat 9: Kevinvdv ($36.20 in chips) 
LuckyGeo1: posts small blind $0.10
Le gros pic: posts big blind $0.25
*** HOLE CARDS ***
Dealt to Alameda22 [Jc 5h]
Mrinaldi: folds 
Alameda22: folds 
doom069: folds 
Kevinvdv: folds 
ty890: calls $0.25
wasserss: folds 
ehle11: raises $1 to $1.25
LuckyGeo1: folds 
Le gros pic: folds 
ty890: folds 
Uncalled bet ($1) returned to ehle11
ehle11 collected $0.85 from pot
ehle11: doesn't show hand 
*** SUMMARY ***
Total pot $0.85 | Rake $0 
Seat 1: ty890 folded before Flop
Seat 2: wasserss folded before Flop (didn't bet)
Seat 3: ehle11 (button) collected ($0.85)
Seat 4: LuckyGeo1 (small blind) folded before Flop
Seat 5: Le gros pic (big blind) folded before Flop
Seat 6: Mrinaldi folded before Flop (didn't bet)
Seat 7: Alameda22 folded before Flop (didn't bet)
Seat 8: doom069 folded before Flop (didn't bet)
Seat 9: Kevinvdv folded before Flop (didn't bet)



PokerStars Game #19976132159:  Hold'em No Limit ($0.10/$0.25) - 2008/08/28 - 20:55:04 (ET)
Table 'Hippasos IV' 9-max Seat #4 is the button
Seat 1: ty890 ($6.05 in chips) 
Seat 2: wasserss ($3.95 in chips) 
Seat 3: ehle11 ($27.40 in chips) 
Seat 4: LuckyGeo1 ($18.25 in chips) 
Seat 5: Le gros pic ($26.05 in chips) 
Seat 6: Mrinaldi ($26.20 in chips) 
Seat 7: Alameda22 ($30.85 in chips) 
Seat 8: doom069 ($23.75 in chips) 
Seat 9: Kevinvdv ($36.20 in chips) 
Le gros pic: posts small blind $0.10
Mrinaldi: posts big blind $0.25
*** HOLE CARDS ***
Dealt to Alameda22 [Ks 7d]
Alameda22: folds 
doom069: folds 
Kevinvdv: folds 
ty890: calls $0.25
wasserss: folds 
ehle11: folds 
LuckyGeo1: raises $0.25 to $0.50
Le gros pic: folds 
Mrinaldi: calls $0.25
ty890: calls $0.25
*** FLOP *** [5d 7c Jd]
Mrinaldi: checks 
ty890: bets $0.75
LuckyGeo1: calls $0.75
Mrinaldi: folds 
*** TURN *** [5d 7c Jd] [3c]
ty890: checks 
LuckyGeo1: bets $0.75
ty890: folds 
Uncalled bet ($0.75) returned to LuckyGeo1
LuckyGeo1 collected $2.95 from pot
LuckyGeo1: doesn't show hand 
*** SUMMARY ***
Total pot $3.10 | Rake $0.15 
Board [5d 7c Jd 3c]
Seat 1: ty890 folded on the Turn
Seat 2: wasserss folded before Flop (didn't bet)
Seat 3: ehle11 folded before Flop (didn't bet)
Seat 4: LuckyGeo1 (button) collected ($2.95)
Seat 5: Le gros pic (small blind) folded before Flop
Seat 6: Mrinaldi (big blind) folded on the Flop
Seat 7: Alameda22 folded before Flop (didn't bet)
Seat 8: doom069 folded before Flop (didn't bet)
Seat 9: Kevinvdv folded before Flop (didn't bet)



PokerStars Game #19976162043:  Hold'em No Limit ($0.10/$0.25) - 2008/08/28 - 20:56:27 (ET)
Table 'Hippasos IV' 9-max Seat #5 is the button
Seat 1: ty890 ($4.80 in chips) 
Seat 2: wasserss ($3.95 in chips) 
Seat 3: ehle11 ($27.40 in chips) 
Seat 4: LuckyGeo1 ($19.95 in chips) 
Seat 5: Le gros pic ($25.95 in chips) 
Seat 6: Mrinaldi ($25.70 in chips) 
Seat 7: Alameda22 ($30.85 in chips) 
Seat 8: doom069 ($23.75 in chips) 
Seat 9: Kevinvdv ($36.20 in chips) 
Mrinaldi: posts small blind $0.10
Alameda22: posts big blind $0.25
*** HOLE CARDS ***
Dealt to Alameda22 [Ah Ad]
doom069: folds 
Kevinvdv: folds 
ty890: folds 
wasserss: folds 
ehle11: raises $1 to $1.25
LuckyGeo1: folds 
Le gros pic: calls $1.25
Mrinaldi: folds 
Alameda22: raises $2 to $3.25
ehle11: calls $2
Le gros pic: calls $2
*** FLOP *** [Ts Jc 5s]
Alameda22: bets $6
ehle11: folds 
Le gros pic: folds 
Uncalled bet ($6) returned to Alameda22
Alameda22 collected $9.40 from pot
Alameda22: doesn't show hand 
*** SUMMARY ***
Total pot $9.85 | Rake $0.45 
Board [Ts Jc 5s]
Seat 1: ty890 folded before Flop (didn't bet)
Seat 2: wasserss folded before Flop (didn't bet)
Seat 3: ehle11 folded on the Flop
Seat 4: LuckyGeo1 folded before Flop (didn't bet)
Seat 5: Le gros pic (button) folded on the Flop
Seat 6: Mrinaldi (small blind) folded before Flop
Seat 7: Alameda22 (big blind) collected ($9.40)
Seat 8: doom069 folded before Flop (didn't bet)
Seat 9: Kevinvdv folded before Flop (didn't bet)



PokerStars Game #19976184494:  Hold'em No Limit ($0.10/$0.25) - 2008/08/28 - 20:57:29 (ET)
Table 'Hippasos IV' 9-max Seat #6 is the button
Seat 1: ty890 ($4.80 in chips) 
Seat 2: wasserss ($3.95 in chips) 
Seat 3: ehle11 ($24.15 in chips) 
Seat 4: LuckyGeo1 ($19.95 in chips) 
Seat 5: Le gros pic ($22.70 in chips) 
Seat 6: Mrinaldi ($25.60 in chips) 
Seat 7: Alameda22 ($37 in chips) 
Seat 8: doom069 ($23.75 in chips) 
Seat 9: Kevinvdv ($36.20 in chips) 
Alameda22: posts small blind $0.10
doom069: posts big blind $0.25
*** HOLE CARDS ***
Dealt to Alameda22 [As 2c]
Kevinvdv: folds 
ty890: folds 
wasserss: folds 
ehle11: folds 
LuckyGeo1: folds 
Le gros pic: folds 
Mrinaldi: folds 
Alameda22: folds 
Uncalled bet ($0.15) returned to doom069
doom069 collected $0.20 from pot
doom069: doesn't show hand 
*** SUMMARY ***
Total pot $0.20 | Rake $0 
Seat 1: ty890 folded before Flop (didn't bet)
Seat 2: wasserss folded before Flop (didn't bet)
Seat 3: ehle11 folded before Flop (didn't bet)
Seat 4: LuckyGeo1 folded before Flop (didn't bet)
Seat 5: Le gros pic folded before Flop (didn't bet)
Seat 6: Mrinaldi (button) folded before Flop (didn't bet)
Seat 7: Alameda22 (small blind) folded before Flop
Seat 8: doom069 (big blind) collected ($0.20)
Seat 9: Kevinvdv folded before Flop (didn't bet)



PokerStars Game #19976192705:  Hold'em No Limit ($0.10/$0.25) - 2008/08/28 - 20:57:52 (ET)
Table 'Hippasos IV' 9-max Seat #7 is the button
Seat 1: ty890 ($4.80 in chips) 
Seat 2: wasserss ($3.95 in chips) 
Seat 3: ehle11 ($24.15 in chips) 
Seat 4: LuckyGeo1 ($19.95 in chips) 
Seat 5: Le gros pic ($22.70 in chips) 
Seat 6: Mrinaldi ($25.60 in chips) 
Seat 7: Alameda22 ($36.90 in chips) 
Seat 8: doom069 ($23.85 in chips) 
Seat 9: Kevinvdv ($36.20 in chips) 
doom069: posts small blind $0.10
Kevinvdv: posts big blind $0.25
*** HOLE CARDS ***
Dealt to Alameda22 [2d 7h]
ty890: folds 
wasserss: folds 
ehle11: folds 
LuckyGeo1: folds 
Le gros pic: folds 
Mrinaldi: folds 
Alameda22: folds 
doom069: folds 
Uncalled bet ($0.15) returned to Kevinvdv
Kevinvdv collected $0.20 from pot
Kevinvdv: doesn't show hand 
*** SUMMARY ***
Total pot $0.20 | Rake $0 
Seat 1: ty890 folded before Flop (didn't bet)
Seat 2: wasserss folded before Flop (didn't bet)
Seat 3: ehle11 folded before Flop (didn't bet)
Seat 4: LuckyGeo1 folded before Flop (didn't bet)
Seat 5: Le gros pic folded before Flop (didn't bet)
Seat 6: Mrinaldi folded before Flop (didn't bet)
Seat 7: Alameda22 (button) folded before Flop (didn't bet)
Seat 8: doom069 (small blind) folded before Flop
Seat 9: Kevinvdv (big blind) collected ($0.20)



PokerStars Game #19976206331:  Hold'em No Limit ($0.10/$0.25) - 2008/08/28 - 20:58:30 (ET)
Table 'Hippasos IV' 9-max Seat #8 is the button
Seat 1: ty890 ($4.80 in chips) 
Seat 2: wasserss ($3.95 in chips) 
Seat 3: ehle11 ($24.15 in chips) 
Seat 4: LuckyGeo1 ($19.95 in chips) 
Seat 5: Le gros pic ($22.70 in chips) 
Seat 6: Mrinaldi ($25.60 in chips) 
Seat 7: Alameda22 ($36.90 in chips) 
Seat 8: doom069 ($23.75 in chips) 
Seat 9: Kevinvdv ($36.30 in chips) 
Kevinvdv: posts small blind $0.10
ty890: posts big blind $0.25
*** HOLE CARDS ***
Dealt to Alameda22 [Kc 3c]
wasserss: folds 
ehle11: folds 
LuckyGeo1: folds 
Le gros pic: raises $0.25 to $0.50
Mrinaldi: folds 
Alameda22: folds 
doom069: folds 
Kevinvdv: folds 
ty890: calls $0.25
*** FLOP *** [5h 9d 9h]
ty890: checks 
Le gros pic: bets $0.75
ty890: calls $0.75
*** TURN *** [5h 9d 9h] [Jc]
ty890: bets $1
Le gros pic: calls $1
*** RIVER *** [5h 9d 9h Jc] [8c]
ty890: checks 
Le gros pic: bets $2.75
ty890: folds 
Uncalled bet ($2.75) returned to Le gros pic
Le gros pic collected $4.40 from pot
Le gros pic: doesn't show hand 
*** SUMMARY ***
Total pot $4.60 | Rake $0.20 
Board [5h 9d 9h Jc 8c]
Seat 1: ty890 (big blind) folded on the River
Seat 2: wasserss folded before Flop (didn't bet)
Seat 3: ehle11 folded before Flop (didn't bet)
Seat 4: LuckyGeo1 folded before Flop (didn't bet)
Seat 5: Le gros pic collected ($4.40)
Seat 6: Mrinaldi folded before Flop (didn't bet)
Seat 7: Alameda22 folded before Flop (didn't bet)
Seat 8: doom069 (button) folded before Flop (didn't bet)
Seat 9: Kevinvdv (small blind) folded before Flop



PokerStars Game #19976228692:  Hold'em No Limit ($0.10/$0.25) - 2008/08/28 - 20:59:31 (ET)
Table 'Hippasos IV' 9-max Seat #9 is the button
Seat 1: ty890 ($2.55 in chips) 
Seat 4: LuckyGeo1 ($19.95 in chips) 
Seat 5: Le gros pic ($24.85 in chips) 
Seat 6: Mrinaldi ($25.60 in chips) 
Seat 7: Alameda22 ($36.90 in chips) 
Seat 8: doom069 ($23.75 in chips) 
Seat 9: Kevinvdv ($36.20 in chips) 
ty890: posts small blind $0.10
wasserss: is sitting out 
wasserss leaves the table
ehle11: is sitting out 
LuckyGeo1: posts big blind $0.25
*** HOLE CARDS ***
Dealt to Alameda22 [7c Ah]
Le gros pic: folds 
Mrinaldi: folds 
ehle11 leaves the table
Alameda22: folds 
doom069: folds 
Kevinvdv: raises $0.50 to $0.75
ty890: folds 
Hauskater joins the table at seat #3 
LuckyGeo1: calls $0.50
*** FLOP *** [Jc Ks 5h]
LuckyGeo1: bets $0.75
Kevinvdv: folds 
Uncalled bet ($0.75) returned to LuckyGeo1
LuckyGeo1 collected $1.55 from pot
LuckyGeo1: doesn't show hand 
*** SUMMARY ***
Total pot $1.60 | Rake $0.05 
Board [Jc Ks 5h]
Seat 1: ty890 (small blind) folded before Flop
Seat 4: LuckyGeo1 (big blind) collected ($1.55)
Seat 5: Le gros pic folded before Flop (didn't bet)
Seat 6: Mrinaldi folded before Flop (didn't bet)
Seat 7: Alameda22 folded before Flop (didn't bet)
Seat 8: doom069 folded before Flop (didn't bet)
Seat 9: Kevinvdv (button) folded on the Flop



PokerStars Game #19976240344:  Hold'em No Limit ($0.10/$0.25) - 2008/08/28 - 21:00:03 (ET)
Table 'Hippasos IV' 9-max Seat #1 is the button
Seat 1: ty890 ($2.45 in chips) 
Seat 4: LuckyGeo1 ($20.75 in chips) 
Seat 5: Le gros pic ($24.85 in chips) 
Seat 6: Mrinaldi ($25.60 in chips) 
Seat 7: Alameda22 ($36.90 in chips) 
Seat 8: doom069 ($23.75 in chips) 
Seat 9: Kevinvdv ($35.45 in chips) 
Hauskater will be allowed to play after the button
LuckyGeo1: posts small blind $0.10
Le gros pic: posts big blind $0.25
*** HOLE CARDS ***
Dealt to Alameda22 [Kc 3d]
Mrinaldi: raises $0.50 to $0.75
Alameda22: folds 
doom069: folds 
Kevinvdv: folds 
ty890: folds 
LuckyGeo1: calls $0.65
Le gros pic: folds 
*** FLOP *** [Jd As 6s]
LuckyGeo1: checks 
Mrinaldi: bets $1.50
LuckyGeo1: folds 
Uncalled bet ($1.50) returned to Mrinaldi
Mrinaldi collected $1.70 from pot
Mrinaldi: doesn't show hand 
*** SUMMARY ***
Total pot $1.75 | Rake $0.05 
Board [Jd As 6s]
Seat 1: ty890 (button) folded before Flop (didn't bet)
Seat 4: LuckyGeo1 (small blind) folded on the Flop
Seat 5: Le gros pic (big blind) folded before Flop
Seat 6: Mrinaldi collected ($1.70)
Seat 7: Alameda22 folded before Flop (didn't bet)
Seat 8: doom069 folded before Flop (didn't bet)
Seat 9: Kevinvdv folded before Flop (didn't bet)



PokerStars Game #19976252795:  Hold'em No Limit ($0.10/$0.25) - 2008/08/28 - 21:00:39 (ET)
Table 'Hippasos IV' 9-max Seat #4 is the button
Seat 1: ty890 ($2.45 in chips) 
Seat 4: LuckyGeo1 ($20 in chips) 
Seat 5: Le gros pic ($24.60 in chips) 
Seat 6: Mrinaldi ($26.55 in chips) 
Seat 7: Alameda22 ($36.90 in chips) 
Seat 8: doom069 ($25 in chips) 
Seat 9: Kevinvdv ($35.45 in chips) 
Le gros pic: posts small blind $0.10
Mrinaldi: posts big blind $0.25
Hauskater: sits out 
*** HOLE CARDS ***
Dealt to Alameda22 [Qs 2c]
Alameda22: folds 
doom069: folds 
Kevinvdv: calls $0.25
ty890: folds 
LuckyGeo1: folds 
Le gros pic: calls $0.15
Mrinaldi: checks 
*** FLOP *** [9h 9s As]
Le gros pic: bets $0.50
Mrinaldi: folds 
Kevinvdv: folds 
Uncalled bet ($0.50) returned to Le gros pic
Le gros pic collected $0.75 from pot
Le gros pic: doesn't show hand 
*** SUMMARY ***
Total pot $0.75 | Rake $0 
Board [9h 9s As]
Seat 1: ty890 folded before Flop (didn't bet)
Seat 4: LuckyGeo1 (button) folded before Flop (didn't bet)
Seat 5: Le gros pic (small blind) collected ($0.75)
Seat 6: Mrinaldi (big blind) folded on the Flop
Seat 7: Alameda22 folded before Flop (didn't bet)
Seat 8: doom069 folded before Flop (didn't bet)
Seat 9: Kevinvdv folded on the Flop



PokerStars Game #19976273637:  Hold'em No Limit ($0.10/$0.25) - 2008/08/28 - 21:01:36 (ET)
Table 'Hippasos IV' 9-max Seat #5 is the button
Seat 1: ty890 ($2.45 in chips) 
Seat 4: LuckyGeo1 ($20 in chips) 
Seat 5: Le gros pic ($25.10 in chips) 
Seat 6: Mrinaldi ($26.30 in chips) 
Seat 7: Alameda22 ($36.90 in chips) 
Seat 8: doom069 ($25 in chips) 
Seat 9: Kevinvdv ($35.20 in chips) 
Mrinaldi: posts small blind $0.10
Alameda22: posts big blind $0.25
Hauskater: sits out 
*** HOLE CARDS ***
Dealt to Alameda22 [3h 6s]
doom069: folds 
Kevinvdv: folds 
ty890: folds 
LuckyGeo1: raises $0.25 to $0.50
Le gros pic: folds 
Mrinaldi: calls $0.40
gong4da joins the table at seat #2 
Alameda22: folds 
*** FLOP *** [7c 6d Qs]
Mrinaldi: checks 
LuckyGeo1: checks 
*** TURN *** [7c 6d Qs] [Ad]
Mrinaldi: checks 
LuckyGeo1: checks 
*** RIVER *** [7c 6d Qs Ad] [As]
Mrinaldi: checks 
LuckyGeo1: bets $0.75
Mrinaldi: folds 
Uncalled bet ($0.75) returned to LuckyGeo1
LuckyGeo1 collected $1.20 from pot
LuckyGeo1: doesn't show hand 
*** SUMMARY ***
Total pot $1.25 | Rake $0.05 
Board [7c 6d Qs Ad As]
Seat 1: ty890 folded before Flop (didn't bet)
Seat 4: LuckyGeo1 collected ($1.20)
Seat 5: Le gros pic (button) folded before Flop (didn't bet)
Seat 6: Mrinaldi (small blind) folded on the River
Seat 7: Alameda22 (big blind) folded before Flop
Seat 8: doom069 folded before Flop (didn't bet)
Seat 9: Kevinvdv folded before Flop (didn't bet)



PokerStars Game #19976297699:  Hold'em No Limit ($0.10/$0.25) - 2008/08/28 - 21:02:44 (ET)
Table 'Hippasos IV' 9-max Seat #6 is the button
Seat 1: ty890 ($2.45 in chips) 
Seat 4: LuckyGeo1 ($20.70 in chips) 
Seat 5: Le gros pic ($25.10 in chips) 
Seat 6: Mrinaldi ($25.80 in chips) 
Seat 7: Alameda22 ($36.65 in chips) 
Seat 8: doom069 ($25 in chips) 
Seat 9: Kevinvdv ($35.20 in chips) 
Alameda22: posts small blind $0.10
doom069: posts big blind $0.25
gong4da: sits out 
Hauskater: sits out 
*** HOLE CARDS ***
Dealt to Alameda22 [4c 6d]
Kevinvdv: folds 
ty890: folds 
LuckyGeo1: raises $0.25 to $0.50
Le gros pic: folds 
Mrinaldi: calls $0.50
Alameda22: folds 
doom069: calls $0.25
*** FLOP *** [9s 8s 5s]
doom069: checks 
LuckyGeo1: checks 
Mrinaldi: checks 
*** TURN *** [9s 8s 5s] [9h]
doom069: bets $0.75
LuckyGeo1: calls $0.75
Mrinaldi: folds 
*** RIVER *** [9s 8s 5s 9h] [6h]
doom069: bets $2.20
LuckyGeo1: folds 
Uncalled bet ($2.20) returned to doom069
doom069 collected $2.95 from pot
*** SUMMARY ***
Total pot $3.10 | Rake $0.15 
Board [9s 8s 5s 9h 6h]
Seat 1: ty890 folded before Flop (didn't bet)
Seat 4: LuckyGeo1 folded on the River
Seat 5: Le gros pic folded before Flop (didn't bet)
Seat 6: Mrinaldi (button) folded on the Turn
Seat 7: Alameda22 (small blind) folded before Flop
Seat 8: doom069 (big blind) collected ($2.95)
Seat 9: Kevinvdv folded before Flop (didn't bet)



PokerStars Game #19976329315:  Hold'em No Limit ($0.10/$0.25) - 2008/08/28 - 21:04:11 (ET)
Table 'Hippasos IV' 9-max Seat #7 is the button
Seat 1: ty890 ($2.45 in chips) 
Seat 4: LuckyGeo1 ($19.45 in chips) 
Seat 5: Le gros pic ($25.10 in chips) 
Seat 6: Mrinaldi ($25.30 in chips) 
Seat 7: Alameda22 ($36.55 in chips) 
Seat 8: doom069 ($26.70 in chips) 
Seat 9: Kevinvdv ($35.20 in chips) 
doom069: posts small blind $0.10
Kevinvdv: posts big blind $0.25
gong4da: sits out 
Hauskater: sits out 
*** HOLE CARDS ***
Dealt to Alameda22 [5d 9c]
ty890: folds 
LuckyGeo1: calls $0.25
Le gros pic: folds 
Mrinaldi: folds 
Alameda22: folds 
doom069: folds 
Kevinvdv: checks 
*** FLOP *** [5c Ah 5h]
Kevinvdv: checks 
LuckyGeo1: checks 
*** TURN *** [5c Ah 5h] [2s]
Kevinvdv: checks 
LuckyGeo1: checks 
*** RIVER *** [5c Ah 5h 2s] [6s]
Kevinvdv: checks 
LuckyGeo1: checks 
*** SHOW DOWN ***
Kevinvdv: shows [Ts 6h] (two pair, Sixes and Fives)
LuckyGeo1: mucks hand 
Kevinvdv collected $0.60 from pot
*** SUMMARY ***
Total pot $0.60 | Rake $0 
Board [5c Ah 5h 2s 6s]
Seat 1: ty890 folded before Flop (didn't bet)
Seat 4: LuckyGeo1 mucked [4s 7h]
Seat 5: Le gros pic folded before Flop (didn't bet)
Seat 6: Mrinaldi folded before Flop (didn't bet)
Seat 7: Alameda22 (button) folded before Flop (didn't bet)
Seat 8: doom069 (small blind) folded before Flop
Seat 9: Kevinvdv (big blind) showed [Ts 6h] and won ($0.60) with two pair, Sixes and Fives



PokerStars Game #19976343650:  Hold'em No Limit ($0.10/$0.25) - 2008/08/28 - 21:04:51 (ET)
Table 'Hippasos IV' 9-max Seat #8 is the button
Seat 1: ty890 ($2.45 in chips) 
Seat 4: LuckyGeo1 ($19.20 in chips) 
Seat 5: Le gros pic ($25.10 in chips) 
Seat 6: Mrinaldi ($25.30 in chips) 
Seat 7: Alameda22 ($36.55 in chips) 
Seat 8: doom069 ($26.60 in chips) 
Seat 9: Kevinvdv ($35.55 in chips) 
Kevinvdv: posts small blind $0.10
ty890: posts big blind $0.25
gong4da: sits out 
Hauskater: sits out 
*** HOLE CARDS ***
Dealt to Alameda22 [Td Kd]
LuckyGeo1: raises $0.50 to $0.75
Le gros pic: folds 
Mrinaldi: folds 
Alameda22: folds 
doom069: folds 
Kevinvdv: folds 
ty890: calls $0.50
*** FLOP *** [4h 2c Qc]
ty890: bets $1.70 and is all-in
LuckyGeo1: calls $1.70
*** TURN *** [4h 2c Qc] [Kh]
*** RIVER *** [4h 2c Qc Kh] [2d]
Kevinvdv is sitting out
*** SHOW DOWN ***
ty890: shows [5c 5s] (two pair, Fives and Deuces)
LuckyGeo1: shows [Ts Qs] (two pair, Queens and Deuces)
Kevinvdv leaves the table
LuckyGeo1 collected $4.80 from pot
*** SUMMARY ***
Total pot $5 | Rake $0.20 
Board [4h 2c Qc Kh 2d]
Seat 1: ty890 (big blind) showed [5c 5s] and lost with two pair, Fives and Deuces
Seat 4: LuckyGeo1 showed [Ts Qs] and won ($4.80) with two pair, Queens and Deuces
Seat 5: Le gros pic folded before Flop (didn't bet)
Seat 6: Mrinaldi folded before Flop (didn't bet)
Seat 7: Alameda22 folded before Flop (didn't bet)
Seat 8: doom069 (button) folded before Flop (didn't bet)
Seat 9: Kevinvdv (small blind) folded before Flop



PokerStars Game #19976360251:  Hold'em No Limit ($0.10/$0.25) - 2008/08/28 - 21:05:37 (ET)
Table 'Hippasos IV' 9-max Seat #4 is the button
Seat 4: LuckyGeo1 ($21.55 in chips) 
Seat 5: Le gros pic ($25.10 in chips) 
Seat 6: Mrinaldi ($25.30 in chips) 
Seat 7: Alameda22 ($36.55 in chips) 
Seat 8: doom069 ($26.60 in chips) 
Le gros pic: posts small blind $0.10
Mrinaldi: posts big blind $0.25
gong4da: sits out 
Hauskater: sits out 
*** HOLE CARDS ***
Dealt to Alameda22 [Jd Qh]
Alameda22: folds 
ty890 leaves the table
doom069: folds 
LuckyGeo1: raises $0.25 to $0.50
Le gros pic: folds 
Mrinaldi: calls $0.25
*** FLOP *** [Kd 5h Qc]
Mrinaldi: checks 
LuckyGeo1: bets $0.50
Mrinaldi: raises $0.75 to $1.25
LuckyGeo1: calls $0.75
*** TURN *** [Kd 5h Qc] [3h]
Mrinaldi: bets $1.50
LuckyGeo1: calls $1.50
*** RIVER *** [Kd 5h Qc 3h] [5d]
Mrinaldi: checks 
LuckyGeo1: checks 
*** SHOW DOWN ***
Mrinaldi: shows [Js 8d] (a pair of Fives)
LuckyGeo1: shows [6c 6h] (two pair, Sixes and Fives)
LuckyGeo1 collected $6.30 from pot
*** SUMMARY ***
Total pot $6.60 | Rake $0.30 
Board [Kd 5h Qc 3h 5d]
Seat 4: LuckyGeo1 (button) showed [6c 6h] and won ($6.30) with two pair, Sixes and Fives
Seat 5: Le gros pic (small blind) folded before Flop
Seat 6: Mrinaldi (big blind) showed [Js 8d] and lost with a pair of Fives
Seat 7: Alameda22 folded before Flop (didn't bet)
Seat 8: doom069 folded before Flop (didn't bet)



PokerStars Game #19976382495:  Hold'em No Limit ($0.10/$0.25) - 2008/08/28 - 21:06:38 (ET)
Table 'Hippasos IV' 9-max Seat #5 is the button
Seat 4: LuckyGeo1 ($24.60 in chips) 
Seat 5: Le gros pic ($25 in chips) 
Seat 6: Mrinaldi ($22.05 in chips) 
Seat 7: Alameda22 ($36.55 in chips) 
Seat 8: doom069 ($26.60 in chips) 
Mrinaldi: posts small blind $0.10
Alameda22: posts big blind $0.25
gong4da: sits out 
Hauskater: sits out 
*** HOLE CARDS ***
Dealt to Alameda22 [2d 3d]
doom069: folds 
LuckyGeo1: calls $0.25
Le gros pic: folds 
Mrinaldi: calls $0.15
Alameda22: checks 
*** FLOP *** [5h 6c 8h]
Mrinaldi: bets $0.75
Alameda22: folds 
LuckyGeo1: calls $0.75
*** TURN *** [5h 6c 8h] [9c]
Mrinaldi: checks 
LuckyGeo1: checks 
*** RIVER *** [5h 6c 8h 9c] [8s]
Mrinaldi: checks 
LuckyGeo1: checks 
*** SHOW DOWN ***
Mrinaldi: shows [4c 5d] (two pair, Eights and Fives)
LuckyGeo1: shows [Kc 6h] (two pair, Eights and Sixes)
LuckyGeo1 collected $2.15 from pot
*** SUMMARY ***
Total pot $2.25 | Rake $0.10 
Board [5h 6c 8h 9c 8s]
Seat 4: LuckyGeo1 showed [Kc 6h] and won ($2.15) with two pair, Eights and Sixes
Seat 5: Le gros pic (button) folded before Flop (didn't bet)
Seat 6: Mrinaldi (small blind) showed [4c 5d] and lost with two pair, Eights and Fives
Seat 7: Alameda22 (big blind) folded on the Flop
Seat 8: doom069 folded before Flop (didn't bet)



PokerStars Game #19976406430:  Hold'em No Limit ($0.10/$0.25) - 2008/08/28 - 21:07:45 (ET)
Table 'Hippasos IV' 9-max Seat #6 is the button
Seat 4: LuckyGeo1 ($25.75 in chips) 
Seat 5: Le gros pic ($25 in chips) 
Seat 6: Mrinaldi ($21.05 in chips) 
Seat 7: Alameda22 ($36.30 in chips) 
Seat 8: doom069 ($26.60 in chips) 
Alameda22: posts small blind $0.10
doom069: posts big blind $0.25
gong4da: sits out 
Hauskater: sits out 
*** HOLE CARDS ***
Dealt to Alameda22 [6d 2d]
LuckyGeo1: raises $0.25 to $0.50
Le gros pic: folds 
Mrinaldi: folds 
Alameda22: folds 
doom069: folds 
Uncalled bet ($0.25) returned to LuckyGeo1
LuckyGeo1 collected $0.60 from pot
LuckyGeo1: doesn't show hand 
*** SUMMARY ***
Total pot $0.60 | Rake $0 
Seat 4: LuckyGeo1 collected ($0.60)
Seat 5: Le gros pic folded before Flop (didn't bet)
Seat 6: Mrinaldi (button) folded before Flop (didn't bet)
Seat 7: Alameda22 (small blind) folded before Flop
Seat 8: doom069 (big blind) folded before Flop



PokerStars Game #19976415239:  Hold'em No Limit ($0.10/$0.25) - 2008/08/28 - 21:08:09 (ET)
Table 'Hippasos IV' 9-max Seat #7 is the button
Seat 2: gong4da ($5 in chips) 
Seat 4: LuckyGeo1 ($26.10 in chips) 
Seat 5: Le gros pic ($25 in chips) 
Seat 6: Mrinaldi ($21.05 in chips) 
Seat 7: Alameda22 ($36.20 in chips) 
Seat 8: doom069 ($26.35 in chips) 
doom069: posts small blind $0.10
gong4da: posts big blind $0.25
Hauskater: sits out 
*** HOLE CARDS ***
Dealt to Alameda22 [Kc 3s]
LuckyGeo1: calls $0.25
Le gros pic: folds 
Mrinaldi: folds 
Alameda22: folds 
doom069: folds 
gong4da: raises $1 to $1.25
LuckyGeo1: calls $1
*** FLOP *** [6s 7s Jh]
gong4da: bets $1.25
LuckyGeo1: calls $1.25
*** TURN *** [6s 7s Jh] [6d]
gong4da: checks 
LuckyGeo1: bets $1
Applenut joins the table at seat #9 
fantasyguy joins the table at seat #1 
gong4da: calls $1
*** RIVER *** [6s 7s Jh 6d] [8s]
gong4da: checks 
LuckyGeo1: checks 
*** SHOW DOWN ***
gong4da: shows [As Kd] (a pair of Sixes)
LuckyGeo1: shows [3d 7d] (two pair, Sevens and Sixes)
LuckyGeo1 collected $6.80 from pot
*** SUMMARY ***
Total pot $7.10 | Rake $0.30 
Board [6s 7s Jh 6d 8s]
Seat 2: gong4da (big blind) showed [As Kd] and lost with a pair of Sixes
Seat 4: LuckyGeo1 showed [3d 7d] and won ($6.80) with two pair, Sevens and Sixes
Seat 5: Le gros pic folded before Flop (didn't bet)
Seat 6: Mrinaldi folded before Flop (didn't bet)
Seat 7: Alameda22 (button) folded before Flop (didn't bet)
Seat 8: doom069 (small blind) folded before Flop



PokerStars Game #19976442562:  Hold'em No Limit ($0.10/$0.25) - 2008/08/28 - 21:09:24 (ET)
Table 'Hippasos IV' 9-max Seat #8 is the button
Seat 2: gong4da ($5.50 in chips) 
Seat 3: Hauskater ($7 in chips) 
Seat 4: LuckyGeo1 ($29.40 in chips) 
Seat 5: Le gros pic ($25 in chips) 
Seat 6: Mrinaldi ($21.05 in chips) 
Seat 7: Alameda22 ($36.20 in chips) 
Seat 8: doom069 ($26.25 in chips) 
Applenut will be allowed to play after the button
fantasyguy will be allowed to play after the button
gong4da: posts small blind $0.10
Hauskater: posts big blind $0.25
*** HOLE CARDS ***
Dealt to Alameda22 [3d 8c]
LuckyGeo1: raises $0.50 to $0.75
Le gros pic: folds 
Mrinaldi: folds 
Applenut is sitting out
Alameda22: folds 
doom069: folds 
gong4da: raises $4.75 to $5.50 and is all-in
Hauskater: folds 
LuckyGeo1: folds 
Uncalled bet ($4.75) returned to gong4da
gong4da collected $1.75 from pot
gong4da: doesn't show hand 
*** SUMMARY ***
Total pot $1.75 | Rake $0 
Seat 2: gong4da (small blind) collected ($1.75)
Seat 3: Hauskater (big blind) folded before Flop
Seat 4: LuckyGeo1 folded before Flop
Seat 5: Le gros pic folded before Flop (didn't bet)
Seat 6: Mrinaldi folded before Flop (didn't bet)
Seat 7: Alameda22 folded before Flop (didn't bet)
Seat 8: doom069 (button) folded before Flop (didn't bet)



PokerStars Game #19976463229:  Hold'em No Limit ($0.10/$0.25) - 2008/08/28 - 21:10:20 (ET)
Table 'Hippasos IV' 9-max Seat #2 is the button
Seat 2: gong4da ($6.50 in chips) 
Seat 3: Hauskater ($6.75 in chips) 
Seat 4: LuckyGeo1 ($28.65 in chips) 
Seat 5: Le gros pic ($25 in chips) 
Seat 6: Mrinaldi ($21.05 in chips) 
Seat 7: Alameda22 ($36.20 in chips) 
Seat 8: doom069 ($26.25 in chips) 
Hauskater: posts small blind $0.10
LuckyGeo1: posts big blind $0.25
fantasyguy: sits out 
*** HOLE CARDS ***
Dealt to Alameda22 [2h 9s]
Le gros pic: folds 
Mrinaldi: folds 
Alameda22: folds 
doom069: folds 
gong4da: folds 
Hauskater: calls $0.15
LuckyGeo1: checks 
*** FLOP *** [Qd 9c 2c]
Hauskater: checks 
LuckyGeo1: checks 
*** TURN *** [Qd 9c 2c] [4s]
Hauskater: checks 
LuckyGeo1: checks 
*** RIVER *** [Qd 9c 2c 4s] [3d]
Hauskater: checks 
LuckyGeo1: checks 
*** SHOW DOWN ***
Hauskater: shows [Ts 8h] (high card Queen)
LuckyGeo1: shows [7d Jd] (high card Queen - Jack kicker)
LuckyGeo1 collected $0.50 from pot
*** SUMMARY ***
Total pot $0.50 | Rake $0 
Board [Qd 9c 2c 4s 3d]
Seat 2: gong4da (button) folded before Flop (didn't bet)
Seat 3: Hauskater (small blind) showed [Ts 8h] and lost with high card Queen
Seat 4: LuckyGeo1 (big blind) showed [7d Jd] and won ($0.50) with high card Queen
Seat 5: Le gros pic folded before Flop (didn't bet)
Seat 6: Mrinaldi folded before Flop (didn't bet)
Seat 7: Alameda22 folded before Flop (didn't bet)
Seat 8: doom069 folded before Flop (didn't bet)



PokerStars Game #19976479338:  Hold'em No Limit ($0.10/$0.25) - 2008/08/28 - 21:11:05 (ET)
Table 'Hippasos IV' 9-max Seat #3 is the button
Seat 2: gong4da ($6.50 in chips) 
Seat 3: Hauskater ($6.50 in chips) 
Seat 4: LuckyGeo1 ($28.90 in chips) 
Seat 5: Le gros pic ($25 in chips) 
Seat 6: Mrinaldi ($21.05 in chips) 
Seat 7: Alameda22 ($36.20 in chips) 
Seat 8: doom069 ($26.25 in chips) 
LuckyGeo1: posts small blind $0.10
Le gros pic: posts big blind $0.25
fantasyguy: sits out 
*** HOLE CARDS ***
Dealt to Alameda22 [9c 6h]
Mrinaldi: folds 
Alameda22: folds 
doom069: folds 
gong4da: folds 
Hauskater: folds 
LuckyGeo1: calls $0.15
Le gros pic: checks 
*** FLOP *** [Kd Ts 2c]
LuckyGeo1: bets $0.50
Le gros pic: calls $0.50
*** TURN *** [Kd Ts 2c] [As]
LuckyGeo1: bets $0.75
Le gros pic: raises $1.50 to $2.25
LuckyGeo1: calls $1.50
*** RIVER *** [Kd Ts 2c As] [Ks]
LuckyGeo1: bets $1
Le gros pic: raises $3.25 to $4.25
LuckyGeo1: calls $3.25
*** SHOW DOWN ***
Le gros pic: shows [Qs Jd] (a straight, Ten to Ace)
LuckyGeo1: mucks hand 
Le gros pic collected $13.80 from pot
*** SUMMARY ***
Total pot $14.50 | Rake $0.70 
Board [Kd Ts 2c As Ks]
Seat 2: gong4da folded before Flop (didn't bet)
Seat 3: Hauskater (button) folded before Flop (didn't bet)
Seat 4: LuckyGeo1 (small blind) mucked [Ac 6d]
Seat 5: Le gros pic (big blind) showed [Qs Jd] and won ($13.80) with a straight, Ten to Ace
Seat 6: Mrinaldi folded before Flop (didn't bet)
Seat 7: Alameda22 folded before Flop (didn't bet)
Seat 8: doom069 folded before Flop (didn't bet)



PokerStars Game #19976498343:  Hold'em No Limit ($0.10/$0.25) - 2008/08/28 - 21:11:57 (ET)
Table 'Hippasos IV' 9-max Seat #4 is the button
Seat 2: gong4da ($6.50 in chips) 
Seat 3: Hauskater ($6.50 in chips) 
Seat 4: LuckyGeo1 ($21.65 in chips) 
Seat 5: Le gros pic ($31.55 in chips) 
Seat 6: Mrinaldi ($21.05 in chips) 
Seat 7: Alameda22 ($36.20 in chips) 
Seat 8: doom069 ($26.25 in chips) 
Le gros pic: posts small blind $0.10
Mrinaldi: posts big blind $0.25
fantasyguy: sits out 
*** HOLE CARDS ***
Dealt to Alameda22 [Td 9d]
Alameda22: folds 
doom069: folds 
gong4da: folds 
Hauskater: folds 
LuckyGeo1: raises $0.25 to $0.50
Le gros pic: folds 
Mrinaldi: folds 
Uncalled bet ($0.25) returned to LuckyGeo1
LuckyGeo1 collected $0.60 from pot
LuckyGeo1: doesn't show hand 
*** SUMMARY ***
Total pot $0.60 | Rake $0 
Seat 2: gong4da folded before Flop (didn't bet)
Seat 3: Hauskater folded before Flop (didn't bet)
Seat 4: LuckyGeo1 (button) collected ($0.60)
Seat 5: Le gros pic (small blind) folded before Flop
Seat 6: Mrinaldi (big blind) folded before Flop
Seat 7: Alameda22 folded before Flop (didn't bet)
Seat 8: doom069 folded before Flop (didn't bet)



PokerStars Game #19976512412:  Hold'em No Limit ($0.10/$0.25) - 2008/08/28 - 21:12:36 (ET)
Table 'Hippasos IV' 9-max Seat #5 is the button
Seat 2: gong4da ($6.50 in chips) 
Seat 3: Hauskater ($6.50 in chips) 
Seat 4: LuckyGeo1 ($22 in chips) 
Seat 5: Le gros pic ($31.45 in chips) 
Seat 6: Mrinaldi ($20.80 in chips) 
Seat 7: Alameda22 ($36.20 in chips) 
Seat 8: doom069 ($26.25 in chips) 
Mrinaldi: posts small blind $0.10
Alameda22: posts big blind $0.25
fantasyguy: sits out 
*** HOLE CARDS ***
Dealt to Alameda22 [Kd 5c]
doom069: folds 
gong4da: calls $0.25
Hauskater: folds 
LuckyGeo1: raises $0.25 to $0.50
Le gros pic: calls $0.50
Mrinaldi: folds 
Alameda22: folds 
gong4da: calls $0.25
*** FLOP *** [Qc 4c As]
gong4da: checks 
LuckyGeo1: bets $0.50
Le gros pic: folds 
gong4da: folds 
Uncalled bet ($0.50) returned to LuckyGeo1
LuckyGeo1 collected $1.80 from pot
LuckyGeo1: doesn't show hand 
*** SUMMARY ***
Total pot $1.85 | Rake $0.05 
Board [Qc 4c As]
Seat 2: gong4da folded on the Flop
Seat 3: Hauskater folded before Flop (didn't bet)
Seat 4: LuckyGeo1 collected ($1.80)
Seat 5: Le gros pic (button) folded on the Flop
Seat 6: Mrinaldi (small blind) folded before Flop
Seat 7: Alameda22 (big blind) folded before Flop
Seat 8: doom069 folded before Flop (didn't bet)



PokerStars Game #19976528298:  Hold'em No Limit ($0.10/$0.25) - 2008/08/28 - 21:13:19 (ET)
Table 'Hippasos IV' 9-max Seat #6 is the button
Seat 2: gong4da ($6 in chips) 
Seat 3: Hauskater ($6.50 in chips) 
Seat 4: LuckyGeo1 ($23.30 in chips) 
Seat 5: Le gros pic ($30.95 in chips) 
Seat 6: Mrinaldi ($20.70 in chips) 
Seat 7: Alameda22 ($35.95 in chips) 
Seat 8: doom069 ($26.25 in chips) 
Alameda22: posts small blind $0.10
doom069: posts big blind $0.25
fantasyguy: sits out 
*** HOLE CARDS ***
Dealt to Alameda22 [7c Kc]
gong4da: calls $0.25
Hauskater: folds 
LuckyGeo1: calls $0.25
Le gros pic: calls $0.25
Mrinaldi: folds 
Alameda22: folds 
Applenut has returned
doom069: raises $1.25 to $1.50
gong4da: calls $1.25
LuckyGeo1: calls $1.25
Le gros pic: calls $1.25
*** FLOP *** [Jc 4h 5s]
doom069: checks 
gong4da: checks 
LuckyGeo1: bets $3.25
Le gros pic: folds 
doom069: folds 
gong4da: raises $1.25 to $4.50 and is all-in
LuckyGeo1: calls $1.25
*** TURN *** [Jc 4h 5s] [9c]
*** RIVER *** [Jc 4h 5s 9c] [5h]
*** SHOW DOWN ***
gong4da: shows [9s 9h] (a full house, Nines full of Fives)
LuckyGeo1: mucks hand 
gong4da collected $14.40 from pot
*** SUMMARY ***
Total pot $15.10 | Rake $0.70 
Board [Jc 4h 5s 9c 5h]
Seat 2: gong4da showed [9s 9h] and won ($14.40) with a full house, Nines full of Fives
Seat 3: Hauskater folded before Flop (didn't bet)
Seat 4: LuckyGeo1 mucked [4c Jh]
Seat 5: Le gros pic folded on the Flop
Seat 6: Mrinaldi (button) folded before Flop (didn't bet)
Seat 7: Alameda22 (small blind) folded before Flop
Seat 8: doom069 (big blind) folded on the Flop



PokerStars Game #19976558539:  Hold'em No Limit ($0.10/$0.25) - 2008/08/28 - 21:14:43 (ET)
Table 'Hippasos IV' 9-max Seat #7 is the button
Seat 2: gong4da ($14.40 in chips) 
Seat 3: Hauskater ($6.50 in chips) 
Seat 4: LuckyGeo1 ($17.30 in chips) 
Seat 5: Le gros pic ($29.45 in chips) 
Seat 6: Mrinaldi ($20.70 in chips) 
Seat 7: Alameda22 ($35.85 in chips) 
Seat 8: doom069 ($24.75 in chips) 
Seat 9: Applenut ($5 in chips) 
doom069: posts small blind $0.10
Applenut: posts big blind $0.25
fantasyguy: sits out 
*** HOLE CARDS ***
Dealt to Alameda22 [3h 3d]
gong4da: folds 
Hauskater: folds 
LuckyGeo1: folds 
Le gros pic: calls $0.25
Mrinaldi: calls $0.25
Alameda22: calls $0.25
doom069: folds 
Applenut: checks 
*** FLOP *** [Qd 4h 5s]
Applenut: checks 
Le gros pic: checks 
Mrinaldi: checks 
Alameda22: checks 
*** TURN *** [Qd 4h 5s] [7c]
Applenut: checks 
Le gros pic: checks 
Mrinaldi: checks 
Alameda22: checks 
*** RIVER *** [Qd 4h 5s 7c] [2d]
Applenut: checks 
Le gros pic: bets $0.75
Mrinaldi: folds 
Alameda22: folds 
Applenut: folds 
Uncalled bet ($0.75) returned to Le gros pic
Le gros pic collected $1.05 from pot
Le gros pic: doesn't show hand 
*** SUMMARY ***
Total pot $1.10 | Rake $0.05 
Board [Qd 4h 5s 7c 2d]
Seat 2: gong4da folded before Flop (didn't bet)
Seat 3: Hauskater folded before Flop (didn't bet)
Seat 4: LuckyGeo1 folded before Flop (didn't bet)
Seat 5: Le gros pic collected ($1.05)
Seat 6: Mrinaldi folded on the River
Seat 7: Alameda22 (button) folded on the River
Seat 8: doom069 (small blind) folded before Flop
Seat 9: Applenut (big blind) folded on the River



PokerStars Game #19976584248:  Hold'em No Limit ($0.10/$0.25) - 2008/08/28 - 21:15:52 (ET)
Table 'Hippasos IV' 9-max Seat #8 is the button
Seat 1: fantasyguy ($10 in chips) 
Seat 2: gong4da ($14.40 in chips) 
Seat 3: Hauskater ($6.50 in chips) 
Seat 4: LuckyGeo1 ($17.30 in chips) 
Seat 5: Le gros pic ($30.25 in chips) 
Seat 6: Mrinaldi ($20.45 in chips) 
Seat 7: Alameda22 ($35.60 in chips) 
Seat 8: doom069 ($24.65 in chips) 
Seat 9: Applenut ($4.75 in chips) 
Applenut: posts small blind $0.10
fantasyguy: posts big blind $0.25
*** HOLE CARDS ***
Dealt to Alameda22 [Qs As]
gong4da: folds 
Hauskater: folds 
LuckyGeo1: folds 
LuckyGeo1 leaves the table
Le gros pic: folds 
Mrinaldi: folds 
gong4da leaves the table
Alameda22: raises $0.50 to $0.75
doom069: raises $1.50 to $2.25
Applenut: folds 
fantasyguy: folds 
Alameda22: folds 
Uncalled bet ($1.50) returned to doom069
doom069 collected $1.85 from pot
doom069: doesn't show hand 
*** SUMMARY ***
Total pot $1.85 | Rake $0 
Seat 1: fantasyguy (big blind) folded before Flop
Seat 2: gong4da folded before Flop (didn't bet)
Seat 3: Hauskater folded before Flop (didn't bet)
Seat 4: LuckyGeo1 folded before Flop (didn't bet)
Seat 5: Le gros pic folded before Flop (didn't bet)
Seat 6: Mrinaldi folded before Flop (didn't bet)
Seat 7: Alameda22 folded before Flop
Seat 8: doom069 (button) collected ($1.85)
Seat 9: Applenut (small blind) folded before Flop



PokerStars Game #19976605516:  Hold'em No Limit ($0.10/$0.25) - 2008/08/28 - 21:16:50 (ET)
Table 'Hippasos IV' 9-max Seat #9 is the button
Seat 1: fantasyguy ($9.75 in chips) 
Seat 3: Hauskater ($6.50 in chips) 
Seat 5: Le gros pic ($30.25 in chips) 
Seat 6: Mrinaldi ($20.45 in chips) 
Seat 7: Alameda22 ($34.85 in chips) 
Seat 8: doom069 ($25.75 in chips) 
Seat 9: Applenut ($4.65 in chips) 
fantasyguy: posts small blind $0.10
Hauskater: posts big blind $0.25
*** HOLE CARDS ***
Dealt to Alameda22 [2c 6c]
Le gros pic: folds 
Mrinaldi: folds 
Alameda22: folds 
doom069: raises $0.75 to $1
Applenut: folds 
fantasyguy: calls $0.90
Hauskater: folds 
*** FLOP *** [Jc 3h Th]
fantasyguy: checks 
doom069: bets $1.30
fantasyguy: raises $2.20 to $3.50
doom069: folds 
Uncalled bet ($2.20) returned to fantasyguy
fantasyguy collected $4.65 from pot
fantasyguy: doesn't show hand 
*** SUMMARY ***
Total pot $4.85 | Rake $0.20 
Board [Jc 3h Th]
Seat 1: fantasyguy (small blind) collected ($4.65)
Seat 3: Hauskater (big blind) folded before Flop
Seat 5: Le gros pic folded before Flop (didn't bet)
Seat 6: Mrinaldi folded before Flop (didn't bet)
Seat 7: Alameda22 folded before Flop (didn't bet)
Seat 8: doom069 folded on the Flop
Seat 9: Applenut (button) folded before Flop (didn't bet)



PokerStars Game #19976628749:  Hold'em No Limit ($0.10/$0.25) - 2008/08/28 - 21:17:53 (ET)
Table 'Hippasos IV' 9-max Seat #1 is the button
Seat 1: fantasyguy ($12.10 in chips) 
Seat 3: Hauskater ($6.25 in chips) 
Seat 5: Le gros pic ($30.25 in chips) 
Seat 6: Mrinaldi ($20.45 in chips) 
Seat 7: Alameda22 ($34.85 in chips) 
Seat 8: doom069 ($25 in chips) 
Seat 9: Applenut ($4.65 in chips) 
Hauskater: posts small blind $0.10
Le gros pic: posts big blind $0.25
*** HOLE CARDS ***
Dealt to Alameda22 [4d Ah]
Mrinaldi: folds 
Alameda22: folds 
doom069: folds 
Applenut: calls $0.25
fantasyguy: folds 
Hauskater: folds 
Le gros pic: checks 
*** FLOP *** [4h 5h 4s]
Le gros pic: checks 
Applenut: bets $0.25
Le gros pic: folds 
Uncalled bet ($0.25) returned to Applenut
Applenut collected $0.60 from pot
Applenut: doesn't show hand 
*** SUMMARY ***
Total pot $0.60 | Rake $0 
Board [4h 5h 4s]
Seat 1: fantasyguy (button) folded before Flop (didn't bet)
Seat 3: Hauskater (small blind) folded before Flop
Seat 5: Le gros pic (big blind) folded on the Flop
Seat 6: Mrinaldi folded before Flop (didn't bet)
Seat 7: Alameda22 folded before Flop (didn't bet)
Seat 8: doom069 folded before Flop (didn't bet)
Seat 9: Applenut collected ($0.60)



PokerStars Game #19976642953:  Hold'em No Limit ($0.10/$0.25) - 2008/08/28 - 21:18:32 (ET)
Table 'Hippasos IV' 9-max Seat #3 is the button
Seat 1: fantasyguy ($12.10 in chips) 
Seat 3: Hauskater ($6.15 in chips) 
Seat 5: Le gros pic ($30 in chips) 
Seat 6: Mrinaldi ($20.45 in chips) 
Seat 7: Alameda22 ($34.85 in chips) 
Seat 8: doom069 ($25 in chips) 
Seat 9: Applenut ($5 in chips) 
Le gros pic: posts small blind $0.10
Mrinaldi: posts big blind $0.25
*** HOLE CARDS ***
Dealt to Alameda22 [Td 9h]
Alameda22: folds 
doom069: folds 
Applenut: calls $0.25
fantasyguy: folds 
Hauskater: calls $0.25
Le gros pic: folds 
Mrinaldi: checks 
*** FLOP *** [4d Qc 2s]
Mrinaldi: bets $0.50
Applenut: folds 
Hauskater: calls $0.50
*** TURN *** [4d Qc 2s] [5s]
Mrinaldi: checks 
Hauskater: bets $0.50
Mrinaldi: calls $0.50
*** RIVER *** [4d Qc 2s 5s] [8c]
Mrinaldi: checks 
Hauskater: checks 
*** SHOW DOWN ***
Mrinaldi: shows [4c 3c] (a pair of Fours)
Hauskater: shows [Kh Qd] (a pair of Queens)
Hauskater collected $2.75 from pot
*** SUMMARY ***
Total pot $2.85 | Rake $0.10 
Board [4d Qc 2s 5s 8c]
Seat 1: fantasyguy folded before Flop (didn't bet)
Seat 3: Hauskater (button) showed [Kh Qd] and won ($2.75) with a pair of Queens
Seat 5: Le gros pic (small blind) folded before Flop
Seat 6: Mrinaldi (big blind) showed [4c 3c] and lost with a pair of Fours
Seat 7: Alameda22 folded before Flop (didn't bet)
Seat 8: doom069 folded before Flop (didn't bet)
Seat 9: Applenut folded on the Flop



PokerStars Game #19976661538:  Hold'em No Limit ($0.10/$0.25) - 2008/08/28 - 21:19:23 (ET)
Table 'Hippasos IV' 9-max Seat #5 is the button
Seat 1: fantasyguy ($12.10 in chips) 
Seat 3: Hauskater ($7.65 in chips) 
Seat 5: Le gros pic ($29.90 in chips) 
Seat 6: Mrinaldi ($19.20 in chips) 
Seat 7: Alameda22 ($34.85 in chips) 
Seat 8: doom069 ($25 in chips) 
Seat 9: Applenut ($4.75 in chips) 
Mrinaldi: posts small blind $0.10
Alameda22: posts big blind $0.25
*** HOLE CARDS ***
Dealt to Alameda22 [2d 4c]
doom069: folds 
Applenut: calls $0.25
fantasyguy: folds 
Hauskater: folds 
Le gros pic: raises $1 to $1.25
Mrinaldi: folds 
Alameda22: folds 
Applenut: calls $1
*** FLOP *** [Qh Qd 8c]
Applenut: bets $1
Le gros pic: raises $3.50 to $4.50
Applenut: calls $2.50 and is all-in
Uncalled bet ($1) returned to Le gros pic
*** TURN *** [Qh Qd 8c] [Qc]
*** RIVER *** [Qh Qd 8c Qc] [6c]
*** SHOW DOWN ***
Applenut: shows [Ad 7d] (three of a kind, Queens)
Le gros pic: shows [Jh Jd] (a full house, Queens full of Jacks)
Le gros pic collected $9.40 from pot
*** SUMMARY ***
Total pot $9.85 | Rake $0.45 
Board [Qh Qd 8c Qc 6c]
Seat 1: fantasyguy folded before Flop (didn't bet)
Seat 3: Hauskater folded before Flop (didn't bet)
Seat 5: Le gros pic (button) showed [Jh Jd] and won ($9.40) with a full house, Queens full of Jacks
Seat 6: Mrinaldi (small blind) folded before Flop
Seat 7: Alameda22 (big blind) folded before Flop
Seat 8: doom069 folded before Flop (didn't bet)
Seat 9: Applenut showed [Ad 7d] and lost with three of a kind, Queens



PokerStars Game #19976682673:  Hold'em No Limit ($0.10/$0.25) - 2008/08/28 - 21:20:21 (ET)
Table 'Hippasos IV' 9-max Seat #6 is the button
Seat 1: fantasyguy ($12.10 in chips) 
Seat 3: Hauskater ($7.65 in chips) 
Seat 5: Le gros pic ($34.55 in chips) 
Seat 6: Mrinaldi ($19.10 in chips) 
Seat 7: Alameda22 ($34.60 in chips) 
Seat 8: doom069 ($25 in chips) 
Seat 9: Applenut ($5 in chips) 
Alameda22: posts small blind $0.10
doom069: posts big blind $0.25
*** HOLE CARDS ***
Dealt to Alameda22 [9c 6s]
Applenut: calls $0.25
fantasyguy: folds 
Hauskater: folds 
Le gros pic: folds 
Mrinaldi: folds 
Alameda22: folds 
doom069: raises $1.25 to $1.50
Applenut: calls $1.25
*** FLOP *** [8c 7c 3s]
doom069: bets $1.75
Applenut: folds 
Uncalled bet ($1.75) returned to doom069
doom069 collected $2.95 from pot
*** SUMMARY ***
Total pot $3.10 | Rake $0.15 
Board [8c 7c 3s]
Seat 1: fantasyguy folded before Flop (didn't bet)
Seat 3: Hauskater folded before Flop (didn't bet)
Seat 5: Le gros pic folded before Flop (didn't bet)
Seat 6: Mrinaldi (button) folded before Flop (didn't bet)
Seat 7: Alameda22 (small blind) folded before Flop
Seat 8: doom069 (big blind) collected ($2.95)
Seat 9: Applenut folded on the Flop



PokerStars Game #19976706529:  Hold'em No Limit ($0.10/$0.25) - 2008/08/28 - 21:21:26 (ET)
Table 'Hippasos IV' 9-max Seat #7 is the button
Seat 1: fantasyguy ($12.10 in chips) 
Seat 3: Hauskater ($7.65 in chips) 
Seat 5: Le gros pic ($34.55 in chips) 
Seat 6: Mrinaldi ($19.10 in chips) 
Seat 7: Alameda22 ($34.50 in chips) 
Seat 8: doom069 ($26.45 in chips) 
Seat 9: Applenut ($4.30 in chips) 
doom069: posts small blind $0.10
Applenut: posts big blind $0.25
*** HOLE CARDS ***
Dealt to Alameda22 [6c Jc]
fantasyguy: folds 
Hauskater: folds 
Le gros pic: folds 
Mrinaldi: folds 
Alameda22: folds 
doom069: folds 
Uncalled bet ($0.15) returned to Applenut
Applenut collected $0.20 from pot
Applenut: doesn't show hand 
*** SUMMARY ***
Total pot $0.20 | Rake $0 
Seat 1: fantasyguy folded before Flop (didn't bet)
Seat 3: Hauskater folded before Flop (didn't bet)
Seat 5: Le gros pic folded before Flop (didn't bet)
Seat 6: Mrinaldi folded before Flop (didn't bet)
Seat 7: Alameda22 (button) folded before Flop (didn't bet)
Seat 8: doom069 (small blind) folded before Flop
Seat 9: Applenut (big blind) collected ($0.20)



PokerStars Game #19976721150:  Hold'em No Limit ($0.10/$0.25) - 2008/08/28 - 21:22:05 (ET)
Table 'Hippasos IV' 9-max Seat #8 is the button
Seat 1: fantasyguy ($12.10 in chips) 
Seat 3: Hauskater ($7.65 in chips) 
Seat 5: Le gros pic ($34.55 in chips) 
Seat 6: Mrinaldi ($19.10 in chips) 
Seat 7: Alameda22 ($34.50 in chips) 
Seat 8: doom069 ($26.35 in chips) 
Seat 9: Applenut ($4.40 in chips) 
Applenut: posts small blind $0.10
fantasyguy: posts big blind $0.25
*** HOLE CARDS ***
Dealt to Alameda22 [Js 3c]
Hauskater: calls $0.25
Le gros pic: raises $0.25 to $0.50
Mrinaldi: folds 
Alameda22: folds 
doom069: folds 
Applenut: folds 
fantasyguy: calls $0.25
Hauskater: calls $0.25
*** FLOP *** [Ad Ac Qh]
fantasyguy: checks 
Hauskater: checks 
Le gros pic: checks 
*** TURN *** [Ad Ac Qh] [7d]
bigdaddycmd joins the table at seat #4 
fantasyguy: checks 
Hauskater: checks 
Le gros pic: checks 
*** RIVER *** [Ad Ac Qh 7d] [4s]
fantasyguy: checks 
daisy108 joins the table at seat #2 
Hauskater: checks 
Le gros pic: checks 
*** SHOW DOWN ***
fantasyguy: shows [9s 7c] (two pair, Aces and Sevens)
Hauskater: mucks hand 
Le gros pic: mucks hand 
fantasyguy collected $1.55 from pot
*** SUMMARY ***
Total pot $1.60 | Rake $0.05 
Board [Ad Ac Qh 7d 4s]
Seat 1: fantasyguy (big blind) showed [9s 7c] and won ($1.55) with two pair, Aces and Sevens
Seat 3: Hauskater mucked [2s 3s]
Seat 5: Le gros pic mucked [Jh Kc]
Seat 6: Mrinaldi folded before Flop (didn't bet)
Seat 7: Alameda22 folded before Flop (didn't bet)
Seat 8: doom069 (button) folded before Flop (didn't bet)
Seat 9: Applenut (small blind) folded before Flop



PokerStars Game #19976751513:  Hold'em No Limit ($0.10/$0.25) - 2008/08/28 - 21:23:28 (ET)
Table 'Hippasos IV' 9-max Seat #9 is the button
Seat 1: fantasyguy ($13.15 in chips) 
Seat 2: daisy108 ($25 in chips) 
Seat 3: Hauskater ($7.15 in chips) 
Seat 4: bigdaddycmd ($15 in chips) 
Seat 5: Le gros pic ($34.05 in chips) 
Seat 6: Mrinaldi ($19.10 in chips) 
Seat 7: Alameda22 ($34.50 in chips) 
Seat 8: doom069 ($26.35 in chips) 
Seat 9: Applenut ($4.30 in chips) 
fantasyguy: posts small blind $0.10
daisy108: posts big blind $0.25
bigdaddycmd: posts big blind $0.25
*** HOLE CARDS ***
Dealt to Alameda22 [Qc 7h]
Hauskater: folds 
bigdaddycmd: raises $0.25 to $0.50
Le gros pic: folds 
Mrinaldi: folds 
Alameda22: folds 
doom069: folds 
Applenut: calls $0.50
fantasyguy: calls $0.40
daisy108: folds 
*** FLOP *** [Ad 6h 4s]
fantasyguy: checks 
bigdaddycmd: bets $1.75
Hauskater leaves the table
Applenut: folds 
fantasyguy: folds 
Uncalled bet ($1.75) returned to bigdaddycmd
bigdaddycmd collected $1.70 from pot
bigdaddycmd: shows [Ah Qs] (a pair of Aces)
*** SUMMARY ***
Total pot $1.75 | Rake $0.05 
Board [Ad 6h 4s]
Seat 1: fantasyguy (small blind) folded on the Flop
Seat 2: daisy108 (big blind) folded before Flop
Seat 3: Hauskater folded before Flop (didn't bet)
Seat 4: bigdaddycmd collected ($1.70)
Seat 5: Le gros pic folded before Flop (didn't bet)
Seat 6: Mrinaldi folded before Flop (didn't bet)
Seat 7: Alameda22 folded before Flop (didn't bet)
Seat 8: doom069 folded before Flop (didn't bet)
Seat 9: Applenut (button) folded on the Flop



PokerStars Game #19976776746:  Hold'em No Limit ($0.10/$0.25) - 2008/08/28 - 21:24:36 (ET)
Table 'Hippasos IV' 9-max Seat #1 is the button
Seat 1: fantasyguy ($12.65 in chips) 
Seat 2: daisy108 ($24.75 in chips) 
Seat 4: bigdaddycmd ($16.20 in chips) 
Seat 5: Le gros pic ($34.05 in chips) 
Seat 6: Mrinaldi ($19.10 in chips) 
Seat 7: Alameda22 ($34.50 in chips) 
Seat 8: doom069 ($26.35 in chips) 
Seat 9: Applenut ($3.80 in chips) 
daisy108: posts small blind $0.10
bigdaddycmd: posts big blind $0.25
*** HOLE CARDS ***
Dealt to Alameda22 [Td Ad]
Le gros pic: folds 
dwmcc joins the table at seat #3 
Mrinaldi: folds 
Alameda22: folds 
doom069: folds 
Applenut: calls $0.25
fantasyguy: folds 
daisy108: folds 
bigdaddycmd: checks 
*** FLOP *** [4c 8c Qh]
bigdaddycmd: bets $1
Applenut: folds 
Uncalled bet ($1) returned to bigdaddycmd
bigdaddycmd collected $0.60 from pot
bigdaddycmd: doesn't show hand 
*** SUMMARY ***
Total pot $0.60 | Rake $0 
Board [4c 8c Qh]
Seat 1: fantasyguy (button) folded before Flop (didn't bet)
Seat 2: daisy108 (small blind) folded before Flop
Seat 4: bigdaddycmd (big blind) collected ($0.60)
Seat 5: Le gros pic folded before Flop (didn't bet)
Seat 6: Mrinaldi folded before Flop (didn't bet)
Seat 7: Alameda22 folded before Flop (didn't bet)
Seat 8: doom069 folded before Flop (didn't bet)
Seat 9: Applenut folded on the Flop



PokerStars Game #19976795310:  Hold'em No Limit ($0.10/$0.25) - 2008/08/28 - 21:25:27 (ET)
Table 'Hippasos IV' 9-max Seat #2 is the button
Seat 1: fantasyguy ($12.65 in chips) 
Seat 2: daisy108 ($24.65 in chips) 
Seat 4: bigdaddycmd ($16.55 in chips) 
Seat 5: Le gros pic ($34.05 in chips) 
Seat 6: Mrinaldi ($19.10 in chips) 
Seat 7: Alameda22 ($34.50 in chips) 
Seat 8: doom069 ($26.35 in chips) 
Seat 9: Applenut ($3.55 in chips) 
dwmcc will be allowed to play after the button
bigdaddycmd: posts small blind $0.10
Le gros pic: posts big blind $0.25
*** HOLE CARDS ***
Dealt to Alameda22 [9c Th]
Mrinaldi: folds 
Alameda22: folds 
doom069: folds 
Applenut: calls $0.25
fantasyguy: folds 
daisy108: folds 
bigdaddycmd: calls $0.15
Le gros pic: checks 
*** FLOP *** [6d Tc 2h]
bigdaddycmd: checks 
Le gros pic: checks 
Applenut: checks 
*** TURN *** [6d Tc 2h] [Ks]
bigdaddycmd: checks 
Le gros pic: bets $0.50
Applenut: calls $0.50
bigdaddycmd: folds 
*** RIVER *** [6d Tc 2h Ks] [Qc]
Le gros pic: bets $1.25
Applenut: calls $1.25
*** SHOW DOWN ***
Le gros pic: shows [5c Kc] (a pair of Kings)
Applenut: shows [4s Kd] (a pair of Kings)
Le gros pic collected $2.05 from pot
Applenut collected $2 from pot
*** SUMMARY ***
Total pot $4.25 | Rake $0.20 
Board [6d Tc 2h Ks Qc]
Seat 1: fantasyguy folded before Flop (didn't bet)
Seat 2: daisy108 (button) folded before Flop (didn't bet)
Seat 4: bigdaddycmd (small blind) folded on the Turn
Seat 5: Le gros pic (big blind) showed [5c Kc] and won ($2.05) with a pair of Kings
Seat 6: Mrinaldi folded before Flop (didn't bet)
Seat 7: Alameda22 folded before Flop (didn't bet)
Seat 8: doom069 folded before Flop (didn't bet)
Seat 9: Applenut showed [4s Kd] and won ($2) with a pair of Kings



PokerStars Game #19976825241:  Hold'em No Limit ($0.10/$0.25) - 2008/08/28 - 21:26:47 (ET)
Table 'Hippasos IV' 9-max Seat #4 is the button
Seat 1: fantasyguy ($12.65 in chips) 
Seat 2: daisy108 ($24.65 in chips) 
Seat 3: dwmcc ($15 in chips) 
Seat 4: bigdaddycmd ($16.30 in chips) 
Seat 5: Le gros pic ($34.10 in chips) 
Seat 6: Mrinaldi ($19.10 in chips) 
Seat 7: Alameda22 ($34.50 in chips) 
Seat 8: doom069 ($26.35 in chips) 
Seat 9: Applenut ($3.55 in chips) 
Le gros pic: posts small blind $0.10
Mrinaldi: posts big blind $0.25
dwmcc: posts big blind $0.25
*** HOLE CARDS ***
Dealt to Alameda22 [Qh 3h]
Alameda22: folds 
doom069: folds 
Applenut: calls $0.25
fantasyguy: folds 
daisy108: folds 
dwmcc: checks 
bigdaddycmd: folds 
Le gros pic: folds 
Mrinaldi: raises $0.50 to $0.75
Applenut: calls $0.50
dwmcc: folds 
*** FLOP *** [8s 7s 6s]
Mrinaldi: checks 
Applenut: bets $0.25
Mrinaldi: calls $0.25
*** TURN *** [8s 7s 6s] [Td]
Mrinaldi: checks 
Applenut: bets $0.50
Mrinaldi: calls $0.50
*** RIVER *** [8s 7s 6s Td] [4h]
Mrinaldi: checks 
Applenut: bets $0.25
Mrinaldi: folds 
Uncalled bet ($0.25) returned to Applenut
Applenut collected $3.20 from pot
Applenut: doesn't show hand 
*** SUMMARY ***
Total pot $3.35 | Rake $0.15 
Board [8s 7s 6s Td 4h]
Seat 1: fantasyguy folded before Flop (didn't bet)
Seat 2: daisy108 folded before Flop (didn't bet)
Seat 3: dwmcc folded before Flop
Seat 4: bigdaddycmd (button) folded before Flop (didn't bet)
Seat 5: Le gros pic (small blind) folded before Flop
Seat 6: Mrinaldi (big blind) folded on the River
Seat 7: Alameda22 folded before Flop (didn't bet)
Seat 8: doom069 folded before Flop (didn't bet)
Seat 9: Applenut collected ($3.20)



PokerStars Game #19976852811:  Hold'em No Limit ($0.10/$0.25) - 2008/08/28 - 21:28:02 (ET)
Table 'Hippasos IV' 9-max Seat #5 is the button
Seat 1: fantasyguy ($12.65 in chips) 
Seat 2: daisy108 ($24.65 in chips) 
Seat 3: dwmcc ($14.75 in chips) 
Seat 4: bigdaddycmd ($16.30 in chips) 
Seat 5: Le gros pic ($34 in chips) 
Seat 6: Mrinaldi ($17.60 in chips) 
Seat 7: Alameda22 ($34.50 in chips) 
Seat 8: doom069 ($26.35 in chips) 
Seat 9: Applenut ($5.25 in chips) 
Mrinaldi: posts small blind $0.10
Alameda22: posts big blind $0.25
*** HOLE CARDS ***
Dealt to Alameda22 [4c 2d]
doom069: folds 
Applenut: calls $0.25
fantasyguy: folds 
daisy108: folds 
dwmcc: folds 
bigdaddycmd: folds 
Le gros pic: folds 
Mrinaldi: calls $0.15
Alameda22: checks 
*** FLOP *** [7s 9h 5s]
Mrinaldi: checks 
Alameda22: checks 
Applenut: checks 
*** TURN *** [7s 9h 5s] [8c]
Mrinaldi: bets $0.50
Alameda22: folds 
Applenut: folds 
Uncalled bet ($0.50) returned to Mrinaldi
Mrinaldi collected $0.75 from pot
Mrinaldi: doesn't show hand 
*** SUMMARY ***
Total pot $0.75 | Rake $0 
Board [7s 9h 5s 8c]
Seat 1: fantasyguy folded before Flop (didn't bet)
Seat 2: daisy108 folded before Flop (didn't bet)
Seat 3: dwmcc folded before Flop (didn't bet)
Seat 4: bigdaddycmd folded before Flop (didn't bet)
Seat 5: Le gros pic (button) folded before Flop (didn't bet)
Seat 6: Mrinaldi (small blind) collected ($0.75)
Seat 7: Alameda22 (big blind) folded on the Turn
Seat 8: doom069 folded before Flop (didn't bet)
Seat 9: Applenut folded on the Turn



PokerStars Game #19976877085:  Hold'em No Limit ($0.10/$0.25) - 2008/08/28 - 21:29:08 (ET)
Table 'Hippasos IV' 9-max Seat #6 is the button
Seat 1: fantasyguy ($12.65 in chips) 
Seat 2: daisy108 ($24.65 in chips) 
Seat 3: dwmcc ($14.75 in chips) 
Seat 4: bigdaddycmd ($16.30 in chips) 
Seat 5: Le gros pic ($34 in chips) 
Seat 6: Mrinaldi ($18.10 in chips) 
Seat 7: Alameda22 ($34.25 in chips) 
Seat 8: doom069 ($26.35 in chips) 
Seat 9: Applenut ($5 in chips) 
Alameda22: posts small blind $0.10
doom069: posts big blind $0.25
*** HOLE CARDS ***
Dealt to Alameda22 [5c Qd]
Applenut: calls $0.25
fantasyguy: folds 
daisy108: calls $0.25
dwmcc: folds 
bigdaddycmd: folds 
Le gros pic: folds 
Mrinaldi: folds 
Alameda22: folds 
doom069: checks 
*** FLOP *** [Qs 3d 7d]
doom069: checks 
Applenut: bets $0.25
daisy108: raises $0.75 to $1
doom069: folds 
Applenut: folds 
Uncalled bet ($0.75) returned to daisy108
daisy108 collected $1.30 from pot
daisy108: doesn't show hand 
*** SUMMARY ***
Total pot $1.35 | Rake $0.05 
Board [Qs 3d 7d]
Seat 1: fantasyguy folded before Flop (didn't bet)
Seat 2: daisy108 collected ($1.30)
Seat 3: dwmcc folded before Flop (didn't bet)
Seat 4: bigdaddycmd folded before Flop (didn't bet)
Seat 5: Le gros pic folded before Flop (didn't bet)
Seat 6: Mrinaldi (button) folded before Flop (didn't bet)
Seat 7: Alameda22 (small blind) folded before Flop
Seat 8: doom069 (big blind) folded on the Flop
Seat 9: Applenut folded on the Flop



PokerStars Game #19976890538:  Hold'em No Limit ($0.10/$0.25) - 2008/08/28 - 21:29:45 (ET)
Table 'Hippasos IV' 9-max Seat #7 is the button
Seat 1: fantasyguy ($12.65 in chips) 
Seat 2: daisy108 ($25.45 in chips) 
Seat 3: dwmcc ($14.75 in chips) 
Seat 4: bigdaddycmd ($16.30 in chips) 
Seat 5: Le gros pic ($34 in chips) 
Seat 6: Mrinaldi ($18.10 in chips) 
Seat 7: Alameda22 ($34.15 in chips) 
Seat 8: doom069 ($26.10 in chips) 
Seat 9: Applenut ($4.50 in chips) 
doom069: posts small blind $0.10
Applenut: posts big blind $0.25
*** HOLE CARDS ***
Dealt to Alameda22 [9c Qd]
fantasyguy: folds 
daisy108: folds 
dwmcc: calls $0.25
bigdaddycmd: folds 
Le gros pic: folds 
Mrinaldi: folds 
Alameda22: folds 
doom069: raises $1 to $1.25
Applenut: folds 
dwmcc: calls $1
*** FLOP *** [8s 6h 2c]
doom069: bets $2
dwmcc: folds 
Uncalled bet ($2) returned to doom069
doom069 collected $2.65 from pot
doom069: doesn't show hand 
*** SUMMARY ***
Total pot $2.75 | Rake $0.10 
Board [8s 6h 2c]
Seat 1: fantasyguy folded before Flop (didn't bet)
Seat 2: daisy108 folded before Flop (didn't bet)
Seat 3: dwmcc folded on the Flop
Seat 4: bigdaddycmd folded before Flop (didn't bet)
Seat 5: Le gros pic folded before Flop (didn't bet)
Seat 6: Mrinaldi folded before Flop (didn't bet)
Seat 7: Alameda22 (button) folded before Flop (didn't bet)
Seat 8: doom069 (small blind) collected ($2.65)
Seat 9: Applenut (big blind) folded before Flop



PokerStars Game #19976907443:  Hold'em No Limit ($0.10/$0.25) - 2008/08/28 - 21:30:31 (ET)
Table 'Hippasos IV' 9-max Seat #8 is the button
Seat 1: fantasyguy ($12.65 in chips) 
Seat 2: daisy108 ($25.45 in chips) 
Seat 3: dwmcc ($13.50 in chips) 
Seat 4: bigdaddycmd ($16.30 in chips) 
Seat 5: Le gros pic ($34 in chips) 
Seat 6: Mrinaldi ($18.10 in chips) 
Seat 7: Alameda22 ($34.15 in chips) 
Seat 8: doom069 ($27.50 in chips) 
Seat 9: Applenut ($4.25 in chips) 
Applenut: posts small blind $0.10
fantasyguy: posts big blind $0.25
*** HOLE CARDS ***
Dealt to Alameda22 [4d 2h]
daisy108: folds 
dwmcc: calls $0.25
bigdaddycmd: calls $0.25
Le gros pic: raises $0.50 to $0.75
Mrinaldi: folds 
Alameda22: folds 
doom069: folds 
Applenut: calls $0.65
fantasyguy: folds 
dwmcc: calls $0.50
bigdaddycmd: calls $0.50
*** FLOP *** [3c Jc Ah]
Applenut: checks 
dwmcc: checks 
bigdaddycmd: checks 
Le gros pic: checks 
*** TURN *** [3c Jc Ah] [Kc]
Applenut: checks 
dwmcc: checks 
bigdaddycmd: bets $2
Le gros pic: folds 
Applenut: calls $2
dwmcc: folds 
*** RIVER *** [3c Jc Ah Kc] [Qd]
Applenut: bets $1.50 and is all-in
bigdaddycmd: calls $1.50
*** SHOW DOWN ***
Applenut: shows [8s Ks] (a pair of Kings)
bigdaddycmd: shows [As 8h] (a pair of Aces)
bigdaddycmd collected $9.80 from pot
*** SUMMARY ***
Total pot $10.25 | Rake $0.45 
Board [3c Jc Ah Kc Qd]
Seat 1: fantasyguy (big blind) folded before Flop
Seat 2: daisy108 folded before Flop (didn't bet)
Seat 3: dwmcc folded on the Turn
Seat 4: bigdaddycmd showed [As 8h] and won ($9.80) with a pair of Aces
Seat 5: Le gros pic folded on the Turn
Seat 6: Mrinaldi folded before Flop (didn't bet)
Seat 7: Alameda22 folded before Flop (didn't bet)
Seat 8: doom069 (button) folded before Flop (didn't bet)
Seat 9: Applenut (small blind) showed [8s Ks] and lost with a pair of Kings



PokerStars Game #19976932786:  Hold'em No Limit ($0.10/$0.25) - 2008/08/28 - 21:31:40 (ET)
Table 'Hippasos IV' 9-max Seat #1 is the button
Seat 1: fantasyguy ($12.40 in chips) 
Seat 2: daisy108 ($25.45 in chips) 
Seat 3: dwmcc ($12.75 in chips) 
Seat 4: bigdaddycmd ($21.85 in chips) 
Seat 5: Le gros pic ($33.25 in chips) 
Seat 6: Mrinaldi ($18.10 in chips) 
Seat 7: Alameda22 ($34.15 in chips) 
Seat 8: doom069 ($27.50 in chips) 
daisy108: posts small blind $0.10
dwmcc: posts big blind $0.25
*** HOLE CARDS ***
Dealt to Alameda22 [Ks Td]
bigdaddycmd: folds 
Applenut leaves the table
Le gros pic: calls $0.25
Mrinaldi: folds 
Alameda22: folds 
doom069: folds 
fantasyguy: folds 
daisy108: folds 
dwmcc: checks 
*** FLOP *** [3h Ac 5s]
dwmcc: checks 
Le gros pic: bets $0.75
dwmcc: folds 
Uncalled bet ($0.75) returned to Le gros pic
Le gros pic collected $0.60 from pot
Le gros pic: doesn't show hand 
*** SUMMARY ***
Total pot $0.60 | Rake $0 
Board [3h Ac 5s]
Seat 1: fantasyguy (button) folded before Flop (didn't bet)
Seat 2: daisy108 (small blind) folded before Flop
Seat 3: dwmcc (big blind) folded on the Flop
Seat 4: bigdaddycmd folded before Flop (didn't bet)
Seat 5: Le gros pic collected ($0.60)
Seat 6: Mrinaldi folded before Flop (didn't bet)
Seat 7: Alameda22 folded before Flop (didn't bet)
Seat 8: doom069 folded before Flop (didn't bet)



PokerStars Game #19976949455:  Hold'em No Limit ($0.10/$0.25) - 2008/08/28 - 21:32:27 (ET)
Table 'Hippasos IV' 9-max Seat #2 is the button
Seat 1: fantasyguy ($12.40 in chips) 
Seat 2: daisy108 ($25.35 in chips) 
Seat 3: dwmcc ($12.50 in chips) 
Seat 4: bigdaddycmd ($21.85 in chips) 
Seat 5: Le gros pic ($33.60 in chips) 
Seat 6: Mrinaldi ($18.10 in chips) 
Seat 7: Alameda22 ($34.15 in chips) 
Seat 8: doom069 ($27.50 in chips) 
dwmcc: posts small blind $0.10
bigdaddycmd: posts big blind $0.25
*** HOLE CARDS ***
Dealt to Alameda22 [Js 9c]
Le gros pic: folds 
Mrinaldi: folds 
Alameda22: folds 
doom069: folds 
fantasyguy: raises $0.50 to $0.75
daisy108: folds 
dwmcc: folds 
bigdaddycmd: folds 
Uncalled bet ($0.50) returned to fantasyguy
Kosusher joins the table at seat #9 
fantasyguy collected $0.60 from pot
fantasyguy: doesn't show hand 
*** SUMMARY ***
Total pot $0.60 | Rake $0 
Seat 1: fantasyguy collected ($0.60)
Seat 2: daisy108 (button) folded before Flop (didn't bet)
Seat 3: dwmcc (small blind) folded before Flop
Seat 4: bigdaddycmd (big blind) folded before Flop
Seat 5: Le gros pic folded before Flop (didn't bet)
Seat 6: Mrinaldi folded before Flop (didn't bet)
Seat 7: Alameda22 folded before Flop (didn't bet)
Seat 8: doom069 folded before Flop (didn't bet)



PokerStars Game #19976960906:  Hold'em No Limit ($0.10/$0.25) - 2008/08/28 - 21:32:58 (ET)
Table 'Hippasos IV' 9-max Seat #3 is the button
Seat 1: fantasyguy ($12.75 in chips) 
Seat 2: daisy108 ($25.35 in chips) 
Seat 3: dwmcc ($12.40 in chips) 
Seat 4: bigdaddycmd ($21.60 in chips) 
Seat 5: Le gros pic ($33.60 in chips) 
Seat 6: Mrinaldi ($18.10 in chips) 
Seat 7: Alameda22 ($34.15 in chips) 
Seat 8: doom069 ($27.50 in chips) 
Seat 9: Kosusher ($15 in chips) 
bigdaddycmd: posts small blind $0.10
Le gros pic: posts big blind $0.25
Kosusher: posts big blind $0.25
*** HOLE CARDS ***
Dealt to Alameda22 [Ac 2c]
Mrinaldi: calls $0.25
Alameda22: folds 
doom069: folds 
Kosusher: checks 
fantasyguy: folds 
daisy108: folds 
dwmcc: calls $0.25
bigdaddycmd: calls $0.15
Le gros pic: checks 
*** FLOP *** [2h 3h 4c]
bigdaddycmd: checks 
Le gros pic: checks 
Mrinaldi: checks 
Kosusher: bets $0.25
dwmcc: folds 
bigdaddycmd: folds 
Le gros pic: folds 
Mrinaldi: calls $0.25
*** TURN *** [2h 3h 4c] [Js]
Mrinaldi: checks 
Kosusher: bets $0.25
Mrinaldi: calls $0.25
*** RIVER *** [2h 3h 4c Js] [Ts]
Mrinaldi: checks 
Kosusher: bets $0.25
Mrinaldi: folds 
Uncalled bet ($0.25) returned to Kosusher
Kosusher collected $2.15 from pot
*** SUMMARY ***
Total pot $2.25 | Rake $0.10 
Board [2h 3h 4c Js Ts]
Seat 1: fantasyguy folded before Flop (didn't bet)
Seat 2: daisy108 folded before Flop (didn't bet)
Seat 3: dwmcc (button) folded on the Flop
Seat 4: bigdaddycmd (small blind) folded on the Flop
Seat 5: Le gros pic (big blind) folded on the Flop
Seat 6: Mrinaldi folded on the River
Seat 7: Alameda22 folded before Flop (didn't bet)
Seat 8: doom069 folded before Flop (didn't bet)
Seat 9: Kosusher collected ($2.15)



PokerStars Game #19976985184:  Hold'em No Limit ($0.10/$0.25) - 2008/08/28 - 21:34:05 (ET)
Table 'Hippasos IV' 9-max Seat #4 is the button
Seat 1: fantasyguy ($12.75 in chips) 
Seat 2: daisy108 ($25.35 in chips) 
Seat 3: dwmcc ($12.15 in chips) 
Seat 4: bigdaddycmd ($21.35 in chips) 
Seat 5: Le gros pic ($33.35 in chips) 
Seat 6: Mrinaldi ($17.35 in chips) 
Seat 7: Alameda22 ($34.15 in chips) 
Seat 8: doom069 ($27.50 in chips) 
Seat 9: Kosusher ($16.40 in chips) 
Le gros pic: posts small blind $0.10
Mrinaldi: posts big blind $0.25
*** HOLE CARDS ***
Dealt to Alameda22 [4s 3c]
Alameda22: folds 
doom069: folds 
Kosusher: raises $0.75 to $1
fantasyguy: folds 
daisy108: folds 
dwmcc: folds 
bigdaddycmd: folds 
Le gros pic: calls $0.90
Mrinaldi: folds 
*** FLOP *** [8h 5c 9c]
Le gros pic: checks 
Kosusher: bets $0.25
Le gros pic: calls $0.25
*** TURN *** [8h 5c 9c] [5s]
Le gros pic: bets $0.50
Kosusher: calls $0.50
*** RIVER *** [8h 5c 9c 5s] [Kc]
Le gros pic: checks 
Kosusher: checks 
*** SHOW DOWN ***
Le gros pic: shows [Qs Ts] (a pair of Fives)
Kosusher: shows [6c 6h] (two pair, Sixes and Fives)
Kosusher collected $3.60 from pot
*** SUMMARY ***
Total pot $3.75 | Rake $0.15 
Board [8h 5c 9c 5s Kc]
Seat 1: fantasyguy folded before Flop (didn't bet)
Seat 2: daisy108 folded before Flop (didn't bet)
Seat 3: dwmcc folded before Flop (didn't bet)
Seat 4: bigdaddycmd (button) folded before Flop (didn't bet)
Seat 5: Le gros pic (small blind) showed [Qs Ts] and lost with a pair of Fives
Seat 6: Mrinaldi (big blind) folded before Flop
Seat 7: Alameda22 folded before Flop (didn't bet)
Seat 8: doom069 folded before Flop (didn't bet)
Seat 9: Kosusher showed [6c 6h] and won ($3.60) with two pair, Sixes and Fives



PokerStars Game #19977007783:  Hold'em No Limit ($0.10/$0.25) - 2008/08/28 - 21:35:08 (ET)
Table 'Hippasos IV' 9-max Seat #5 is the button
Seat 1: fantasyguy ($12.75 in chips) 
Seat 2: daisy108 ($25.35 in chips) 
Seat 3: dwmcc ($12.15 in chips) 
Seat 4: bigdaddycmd ($21.35 in chips) 
Seat 5: Le gros pic ($31.60 in chips) 
Seat 6: Mrinaldi ($17.10 in chips) 
Seat 7: Alameda22 ($34.15 in chips) 
Seat 8: doom069 ($27.50 in chips) 
Seat 9: Kosusher ($18.25 in chips) 
Mrinaldi: posts small blind $0.10
Alameda22: posts big blind $0.25
*** HOLE CARDS ***
Dealt to Alameda22 [Kc 5h]
doom069: folds 
Kosusher: calls $0.25
fantasyguy: folds 
daisy108: folds 
dwmcc: raises $0.75 to $1
bigdaddycmd: folds 
Le gros pic: calls $1
Mrinaldi: folds 
Alameda22: folds 
Kosusher: calls $0.75
*** FLOP *** [7h Js 7c]
Kosusher: bets $0.50
dwmcc: calls $0.50
Le gros pic: folds 
*** TURN *** [7h Js 7c] [Ah]
Kosusher: bets $0.50
dwmcc: calls $0.50
*** RIVER *** [7h Js 7c Ah] [6d]
Kosusher: bets $0.25
dwmcc: raises $0.75 to $1
Kosusher: calls $0.75
*** SHOW DOWN ***
dwmcc: shows [Ks Ac] (two pair, Aces and Sevens)
Kosusher: shows [8s Jh] (two pair, Jacks and Sevens)
dwmcc collected $7 from pot
*** SUMMARY ***
Total pot $7.35 | Rake $0.35 
Board [7h Js 7c Ah 6d]
Seat 1: fantasyguy folded before Flop (didn't bet)
Seat 2: daisy108 folded before Flop (didn't bet)
Seat 3: dwmcc showed [Ks Ac] and won ($7) with two pair, Aces and Sevens
Seat 4: bigdaddycmd folded before Flop (didn't bet)
Seat 5: Le gros pic (button) folded on the Flop
Seat 6: Mrinaldi (small blind) folded before Flop
Seat 7: Alameda22 (big blind) folded before Flop
Seat 8: doom069 folded before Flop (didn't bet)
Seat 9: Kosusher showed [8s Jh] and lost with two pair, Jacks and Sevens



PokerStars Game #19977033545:  Hold'em No Limit ($0.10/$0.25) - 2008/08/28 - 21:36:20 (ET)
Table 'Hippasos IV' 9-max Seat #6 is the button
Seat 1: fantasyguy ($12.75 in chips) 
Seat 2: daisy108 ($25.35 in chips) 
Seat 3: dwmcc ($16.15 in chips) 
Seat 4: bigdaddycmd ($21.35 in chips) 
Seat 5: Le gros pic ($30.60 in chips) 
Seat 6: Mrinaldi ($17 in chips) 
Seat 7: Alameda22 ($33.90 in chips) 
Seat 8: doom069 ($27.50 in chips) 
Seat 9: Kosusher ($15.25 in chips) 
Alameda22: posts small blind $0.10
doom069: posts big blind $0.25
*** HOLE CARDS ***
Dealt to Alameda22 [4s Ad]
Kosusher: calls $0.25
fantasyguy: folds 
daisy108: folds 
dwmcc: folds 
bigdaddycmd: folds 
Le gros pic: folds 
Mrinaldi: folds 
Alameda22: folds 
doom069: raises $1 to $1.25
Kosusher: calls $1
*** FLOP *** [8h 3c Ah]
doom069: bets $1.75
Kosusher: calls $1.75
*** TURN *** [8h 3c Ah] [3h]
doom069: checks 
Kosusher: checks 
*** RIVER *** [8h 3c Ah 3h] [9s]
doom069: bets $4
Kosusher: calls $4
*** SHOW DOWN ***
doom069: shows [7s 7h] (two pair, Sevens and Threes)
Kosusher: shows [6s 8s] (two pair, Eights and Threes)
Kosusher collected $13.45 from pot
*** SUMMARY ***
Total pot $14.10 | Rake $0.65 
Board [8h 3c Ah 3h 9s]
Seat 1: fantasyguy folded before Flop (didn't bet)
Seat 2: daisy108 folded before Flop (didn't bet)
Seat 3: dwmcc folded before Flop (didn't bet)
Seat 4: bigdaddycmd folded before Flop (didn't bet)
Seat 5: Le gros pic folded before Flop (didn't bet)
Seat 6: Mrinaldi (button) folded before Flop (didn't bet)
Seat 7: Alameda22 (small blind) folded before Flop
Seat 8: doom069 (big blind) showed [7s 7h] and lost with two pair, Sevens and Threes
Seat 9: Kosusher showed [6s 8s] and won ($13.45) with two pair, Eights and Threes



PokerStars Game #19977056533:  Hold'em No Limit ($0.10/$0.25) - 2008/08/28 - 21:37:24 (ET)
Table 'Hippasos IV' 9-max Seat #7 is the button
Seat 1: fantasyguy ($12.75 in chips) 
Seat 2: daisy108 ($25.35 in chips) 
Seat 3: dwmcc ($16.15 in chips) 
Seat 4: bigdaddycmd ($21.35 in chips) 
Seat 5: Le gros pic ($30.60 in chips) 
Seat 6: Mrinaldi ($17 in chips) 
Seat 7: Alameda22 ($33.80 in chips) 
Seat 8: doom069 ($25 in chips) 
Seat 9: Kosusher ($21.70 in chips) 
doom069: posts small blind $0.10
Kosusher: posts big blind $0.25
*** HOLE CARDS ***
Dealt to Alameda22 [4d Ad]
fantasyguy: calls $0.25
daisy108: folds 
dwmcc: raises $0.75 to $1
bigdaddycmd: folds 
Le gros pic: folds 
Mrinaldi: folds 
Alameda22: folds 
doom069: folds 
Kosusher: calls $0.75
fantasyguy: calls $0.75
*** FLOP *** [5s 6c 8s]
Kosusher: checks 
fantasyguy: bets $0.75
dwmcc: raises $1 to $1.75
Kosusher: calls $1.75
fantasyguy: raises $2.25 to $4
dwmcc: raises $11.15 to $15.15 and is all-in
Kosusher: folds 
fantasyguy: calls $7.75 and is all-in
Uncalled bet ($3.40) returned to dwmcc
*** TURN *** [5s 6c 8s] [Jd]
*** RIVER *** [5s 6c 8s Jd] [7c]
*** SHOW DOWN ***
fantasyguy: shows [8c 8h] (three of a kind, Eights)
dwmcc: mucks hand 
fantasyguy collected $26.95 from pot
*** SUMMARY ***
Total pot $28.35 | Rake $1.40 
Board [5s 6c 8s Jd 7c]
Seat 1: fantasyguy showed [8c 8h] and won ($26.95) with three of a kind, Eights
Seat 2: daisy108 folded before Flop (didn't bet)
Seat 3: dwmcc mucked [Js As]
Seat 4: bigdaddycmd folded before Flop (didn't bet)
Seat 5: Le gros pic folded before Flop (didn't bet)
Seat 6: Mrinaldi folded before Flop (didn't bet)
Seat 7: Alameda22 (button) folded before Flop (didn't bet)
Seat 8: doom069 (small blind) folded before Flop
Seat 9: Kosusher (big blind) folded on the Flop



PokerStars Game #19977089234:  Hold'em No Limit ($0.10/$0.25) - 2008/08/28 - 21:38:54 (ET)
Table 'Hippasos IV' 9-max Seat #8 is the button
Seat 1: fantasyguy ($26.95 in chips) 
Seat 2: daisy108 ($25.35 in chips) 
Seat 3: dwmcc ($3.40 in chips) 
Seat 4: bigdaddycmd ($21.35 in chips) 
Seat 5: Le gros pic ($30.60 in chips) 
Seat 6: Mrinaldi ($17 in chips) 
Seat 7: Alameda22 ($33.80 in chips) 
Seat 8: doom069 ($24.90 in chips) 
Seat 9: Kosusher ($18.95 in chips) 
Kosusher: posts small blind $0.10
fantasyguy: posts big blind $0.25
*** HOLE CARDS ***
Dealt to Alameda22 [4c 9s]
daisy108: folds 
dwmcc: calls $0.25
bigdaddycmd: raises $0.75 to $1
Le gros pic: folds 
Mrinaldi: folds 
Alameda22: folds 
doom069: folds 
Kosusher: folds 
fantasyguy: calls $0.75
dwmcc: calls $0.75
*** FLOP *** [2d Qd 6c]
fantasyguy: checks 
dwmcc: checks 
bigdaddycmd: bets $2
fantasyguy: folds 
dwmcc: folds 
Uncalled bet ($2) returned to bigdaddycmd
bigdaddycmd collected $2.95 from pot
bigdaddycmd: doesn't show hand 
*** SUMMARY ***
Total pot $3.10 | Rake $0.15 
Board [2d Qd 6c]
Seat 1: fantasyguy (big blind) folded on the Flop
Seat 2: daisy108 folded before Flop (didn't bet)
Seat 3: dwmcc folded on the Flop
Seat 4: bigdaddycmd collected ($2.95)
Seat 5: Le gros pic folded before Flop (didn't bet)
Seat 6: Mrinaldi folded before Flop (didn't bet)
Seat 7: Alameda22 folded before Flop (didn't bet)
Seat 8: doom069 (button) folded before Flop (didn't bet)
Seat 9: Kosusher (small blind) folded before Flop



PokerStars Game #19977109029:  Hold'em No Limit ($0.10/$0.25) - 2008/08/28 - 21:39:49 (ET)
Table 'Hippasos IV' 9-max Seat #9 is the button
Seat 1: fantasyguy ($25.95 in chips) 
Seat 2: daisy108 ($25.35 in chips) 
Seat 3: dwmcc ($24 in chips) 
Seat 4: bigdaddycmd ($23.30 in chips) 
Seat 5: Le gros pic ($30.60 in chips) 
Seat 6: Mrinaldi ($17 in chips) 
Seat 7: Alameda22 ($33.80 in chips) 
Seat 8: doom069 ($24.90 in chips) 
Seat 9: Kosusher ($18.85 in chips) 
fantasyguy: posts small blind $0.10
daisy108: posts big blind $0.25
*** HOLE CARDS ***
Dealt to Alameda22 [Ts 7s]
dwmcc: folds 
bigdaddycmd: calls $0.25
Le gros pic: folds 
Mrinaldi: calls $0.25
Alameda22: folds 
doom069: raises $1.25 to $1.50
Kosusher: folds 
fantasyguy: folds 
daisy108: folds 
bigdaddycmd: folds 
Mrinaldi: folds 
Uncalled bet ($1.25) returned to doom069
doom069 collected $1.10 from pot
doom069: doesn't show hand 
*** SUMMARY ***
Total pot $1.10 | Rake $0 
Seat 1: fantasyguy (small blind) folded before Flop
Seat 2: daisy108 (big blind) folded before Flop
Seat 3: dwmcc folded before Flop (didn't bet)
Seat 4: bigdaddycmd folded before Flop
Seat 5: Le gros pic folded before Flop (didn't bet)
Seat 6: Mrinaldi folded before Flop
Seat 7: Alameda22 folded before Flop (didn't bet)
Seat 8: doom069 collected ($1.10)
Seat 9: Kosusher (button) folded before Flop (didn't bet)



PokerStars Game #19977125854:  Hold'em No Limit ($0.10/$0.25) - 2008/08/28 - 21:40:35 (ET)
Table 'Hippasos IV' 9-max Seat #1 is the button
Seat 1: fantasyguy ($25.85 in chips) 
Seat 2: daisy108 ($25.10 in chips) 
Seat 3: dwmcc ($24 in chips) 
Seat 4: bigdaddycmd ($23.05 in chips) 
Seat 5: Le gros pic ($30.60 in chips) 
Seat 6: Mrinaldi ($16.75 in chips) 
Seat 7: Alameda22 ($33.80 in chips) 
Seat 8: doom069 ($25.75 in chips) 
Seat 9: Kosusher ($18.85 in chips) 
daisy108: posts small blind $0.10
dwmcc: posts big blind $0.25
*** HOLE CARDS ***
Dealt to Alameda22 [4h Jh]
bigdaddycmd: folds 
Le gros pic: folds 
Mrinaldi: raises $0.50 to $0.75
Alameda22: folds 
doom069: folds 
Kosusher: folds 
fantasyguy: folds 
daisy108: folds 
dwmcc: calls $0.50
*** FLOP *** [6s 9h Ad]
dwmcc: checks 
Mrinaldi: bets $0.75
dwmcc: folds 
Uncalled bet ($0.75) returned to Mrinaldi
Mrinaldi collected $1.55 from pot
Mrinaldi: doesn't show hand 
*** SUMMARY ***
Total pot $1.60 | Rake $0.05 
Board [6s 9h Ad]
Seat 1: fantasyguy (button) folded before Flop (didn't bet)
Seat 2: daisy108 (small blind) folded before Flop
Seat 3: dwmcc (big blind) folded on the Flop
Seat 4: bigdaddycmd folded before Flop (didn't bet)
Seat 5: Le gros pic folded before Flop (didn't bet)
Seat 6: Mrinaldi collected ($1.55)
Seat 7: Alameda22 folded before Flop (didn't bet)
Seat 8: doom069 folded before Flop (didn't bet)
Seat 9: Kosusher folded before Flop (didn't bet)



PokerStars Game #19977142794:  Hold'em No Limit ($0.10/$0.25) - 2008/08/28 - 21:41:20 (ET)
Table 'Hippasos IV' 9-max Seat #2 is the button
Seat 1: fantasyguy ($25.85 in chips) 
Seat 2: daisy108 ($25 in chips) 
Seat 3: dwmcc ($23.25 in chips) 
Seat 4: bigdaddycmd ($23.05 in chips) 
Seat 5: Le gros pic ($30.60 in chips) 
Seat 6: Mrinaldi ($17.55 in chips) 
Seat 7: Alameda22 ($33.80 in chips) 
Seat 8: doom069 ($25.75 in chips) 
Seat 9: Kosusher ($18.85 in chips) 
dwmcc: posts small blind $0.10
bigdaddycmd: posts big blind $0.25
*** HOLE CARDS ***
Dealt to Alameda22 [3h 7h]
Le gros pic: folds 
Mrinaldi: raises $0.25 to $0.50
Alameda22: folds 
doom069: folds 
Kosusher: calls $0.50
fantasyguy: folds 
daisy108: folds 
dwmcc: calls $0.40
bigdaddycmd: calls $0.25
*** FLOP *** [7s 2h 5d]
dwmcc: checks 
bigdaddycmd: checks 
Mrinaldi: checks 
Kosusher: checks 
*** TURN *** [7s 2h 5d] [4c]
dwmcc: bets $0.75
bigdaddycmd: calls $0.75
Mrinaldi: folds 
Kosusher: calls $0.75
*** RIVER *** [7s 2h 5d 4c] [6h]
dwmcc: checks 
bigdaddycmd: checks 
Kosusher: checks 
*** SHOW DOWN ***
dwmcc: shows [Td 7d] (a pair of Sevens)
bigdaddycmd: mucks hand 
Kosusher: shows [3d 3c] (a straight, Three to Seven)
Kosusher collected $4.05 from pot
*** SUMMARY ***
Total pot $4.25 | Rake $0.20 
Board [7s 2h 5d 4c 6h]
Seat 1: fantasyguy folded before Flop (didn't bet)
Seat 2: daisy108 (button) folded before Flop (didn't bet)
Seat 3: dwmcc (small blind) showed [Td 7d] and lost with a pair of Sevens
Seat 4: bigdaddycmd (big blind) mucked [Ah 6c]
Seat 5: Le gros pic folded before Flop (didn't bet)
Seat 6: Mrinaldi folded on the Turn
Seat 7: Alameda22 folded before Flop (didn't bet)
Seat 8: doom069 folded before Flop (didn't bet)
Seat 9: Kosusher showed [3d 3c] and won ($4.05) with a straight, Three to Seven



PokerStars Game #19977169029:  Hold'em No Limit ($0.10/$0.25) - 2008/08/28 - 21:42:33 (ET)
Table 'Hippasos IV' 9-max Seat #3 is the button
Seat 1: fantasyguy ($25.85 in chips) 
Seat 2: daisy108 ($25 in chips) 
Seat 3: dwmcc ($22 in chips) 
Seat 4: bigdaddycmd ($21.80 in chips) 
Seat 5: Le gros pic ($30.60 in chips) 
Seat 6: Mrinaldi ($17.05 in chips) 
Seat 7: Alameda22 ($33.80 in chips) 
Seat 8: doom069 ($25.75 in chips) 
Seat 9: Kosusher ($21.65 in chips) 
bigdaddycmd: posts small blind $0.10
Le gros pic: posts big blind $0.25
*** HOLE CARDS ***
Dealt to Alameda22 [Qc 4s]
Mrinaldi: folds 
Alameda22: folds 
doom069: folds 
Kosusher: folds 
fantasyguy: folds 
daisy108: folds 
dwmcc: raises $0.50 to $0.75
bigdaddycmd: folds 
Le gros pic: folds 
Uncalled bet ($0.50) returned to dwmcc
dwmcc collected $0.60 from pot
dwmcc: doesn't show hand 
*** SUMMARY ***
Total pot $0.60 | Rake $0 
Seat 1: fantasyguy folded before Flop (didn't bet)
Seat 2: daisy108 folded before Flop (didn't bet)
Seat 3: dwmcc (button) collected ($0.60)
Seat 4: bigdaddycmd (small blind) folded before Flop
Seat 5: Le gros pic (big blind) folded before Flop
Seat 6: Mrinaldi folded before Flop (didn't bet)
Seat 7: Alameda22 folded before Flop (didn't bet)
Seat 8: doom069 folded before Flop (didn't bet)
Seat 9: Kosusher folded before Flop (didn't bet)



PokerStars Game #19977189189:  Hold'em No Limit ($0.10/$0.25) - 2008/08/28 - 21:43:27 (ET)
Table 'Hippasos IV' 9-max Seat #4 is the button
Seat 1: fantasyguy ($25.85 in chips) 
Seat 2: daisy108 ($25 in chips) 
Seat 3: dwmcc ($22.35 in chips) 
Seat 4: bigdaddycmd ($21.70 in chips) 
Seat 5: Le gros pic ($30.35 in chips) 
Seat 6: Mrinaldi ($17.05 in chips) 
Seat 7: Alameda22 ($33.80 in chips) 
Seat 8: doom069 ($25.75 in chips) 
Seat 9: Kosusher ($21.65 in chips) 
Le gros pic: posts small blind $0.10
Mrinaldi: posts big blind $0.25
*** HOLE CARDS ***
Dealt to Alameda22 [3d As]
Alameda22: folds 
doom069: folds 
Kosusher: folds 
fantasyguy: folds 
daisy108: folds 
dwmcc: folds 
bigdaddycmd: raises $0.50 to $0.75
Le gros pic: folds 
Mrinaldi: calls $0.50
*** FLOP *** [Kc Ts 8h]
Mrinaldi: checks 
bigdaddycmd: bets $1.50
Mrinaldi: raises $1.75 to $3.25
bigdaddycmd: folds 
Uncalled bet ($1.75) returned to Mrinaldi
Mrinaldi collected $4.40 from pot
Mrinaldi: doesn't show hand 
*** SUMMARY ***
Total pot $4.60 | Rake $0.20 
Board [Kc Ts 8h]
Seat 1: fantasyguy folded before Flop (didn't bet)
Seat 2: daisy108 folded before Flop (didn't bet)
Seat 3: dwmcc folded before Flop (didn't bet)
Seat 4: bigdaddycmd (button) folded on the Flop
Seat 5: Le gros pic (small blind) folded before Flop
Seat 6: Mrinaldi (big blind) collected ($4.40)
Seat 7: Alameda22 folded before Flop (didn't bet)
Seat 8: doom069 folded before Flop (didn't bet)
Seat 9: Kosusher folded before Flop (didn't bet)



PokerStars Game #19977206703:  Hold'em No Limit ($0.10/$0.25) - 2008/08/28 - 21:44:15 (ET)
Table 'Hippasos IV' 9-max Seat #5 is the button
Seat 1: fantasyguy ($25.85 in chips) 
Seat 2: daisy108 ($25 in chips) 
Seat 3: dwmcc ($22.35 in chips) 
Seat 4: bigdaddycmd ($19.45 in chips) 
Seat 5: Le gros pic ($30.25 in chips) 
Seat 6: Mrinaldi ($19.20 in chips) 
Seat 7: Alameda22 ($33.80 in chips) 
Seat 8: doom069 ($25.75 in chips) 
Seat 9: Kosusher ($21.65 in chips) 
Mrinaldi: posts small blind $0.10
Alameda22: posts big blind $0.25
*** HOLE CARDS ***
Dealt to Alameda22 [5h 9s]
doom069: folds 
Kosusher: folds 
fantasyguy: folds 
daisy108: folds 
dwmcc: raises $0.50 to $0.75
bigdaddycmd: folds 
Le gros pic: folds 
Mrinaldi: folds 
Alameda22: folds 
Uncalled bet ($0.50) returned to dwmcc
dwmcc collected $0.60 from pot
dwmcc: doesn't show hand 
*** SUMMARY ***
Total pot $0.60 | Rake $0 
Seat 1: fantasyguy folded before Flop (didn't bet)
Seat 2: daisy108 folded before Flop (didn't bet)
Seat 3: dwmcc collected ($0.60)
Seat 4: bigdaddycmd folded before Flop (didn't bet)
Seat 5: Le gros pic (button) folded before Flop (didn't bet)
Seat 6: Mrinaldi (small blind) folded before Flop
Seat 7: Alameda22 (big blind) folded before Flop
Seat 8: doom069 folded before Flop (didn't bet)
Seat 9: Kosusher folded before Flop (didn't bet)



PokerStars Game #19977217483:  Hold'em No Limit ($0.10/$0.25) - 2008/08/28 - 21:44:44 (ET)
Table 'Hippasos IV' 9-max Seat #6 is the button
Seat 1: fantasyguy ($25.85 in chips) 
Seat 2: daisy108 ($25 in chips) 
Seat 3: dwmcc ($22.70 in chips) 
Seat 4: bigdaddycmd ($19.45 in chips) 
Seat 5: Le gros pic ($30.25 in chips) 
Seat 6: Mrinaldi ($19.10 in chips) 
Seat 7: Alameda22 ($33.55 in chips) 
Seat 8: doom069 ($25.75 in chips) 
Seat 9: Kosusher ($21.65 in chips) 
Alameda22: posts small blind $0.10
doom069: posts big blind $0.25
*** HOLE CARDS ***
Dealt to Alameda22 [5c 7d]
Kosusher: calls $0.25
fantasyguy: folds 
daisy108: folds 
dwmcc: raises $1 to $1.25
bigdaddycmd: folds 
Le gros pic: folds 
Mrinaldi: folds 
Alameda22: folds 
doom069: folds 
Kosusher: calls $1
*** FLOP *** [9h Jd 5h]
Kosusher: bets $0.25
dwmcc: raises $2 to $2.25
Kosusher: folds 
Uncalled bet ($2) returned to dwmcc
dwmcc collected $3.20 from pot
dwmcc: doesn't show hand 
*** SUMMARY ***
Total pot $3.35 | Rake $0.15 
Board [9h Jd 5h]
Seat 1: fantasyguy folded before Flop (didn't bet)
Seat 2: daisy108 folded before Flop (didn't bet)
Seat 3: dwmcc collected ($3.20)
Seat 4: bigdaddycmd folded before Flop (didn't bet)
Seat 5: Le gros pic folded before Flop (didn't bet)
Seat 6: Mrinaldi (button) folded before Flop (didn't bet)
Seat 7: Alameda22 (small blind) folded before Flop
Seat 8: doom069 (big blind) folded before Flop
Seat 9: Kosusher folded on the Flop



PokerStars Game #19977241483:  Hold'em No Limit ($0.10/$0.25) - 2008/08/28 - 21:45:48 (ET)
Table 'Hippasos IV' 9-max Seat #7 is the button
Seat 1: fantasyguy ($25.85 in chips) 
Seat 2: daisy108 ($25 in chips) 
Seat 3: dwmcc ($24.40 in chips) 
Seat 4: bigdaddycmd ($19.45 in chips) 
Seat 5: Le gros pic ($30.25 in chips) 
Seat 6: Mrinaldi ($19.10 in chips) 
Seat 7: Alameda22 ($33.45 in chips) 
Seat 8: doom069 ($25.50 in chips) 
Seat 9: Kosusher ($20.15 in chips) 
doom069: posts small blind $0.10
Kosusher: posts big blind $0.25
*** HOLE CARDS ***
Dealt to Alameda22 [6s 2s]
fantasyguy: folds 
daisy108: folds 
dwmcc: folds 
bigdaddycmd: calls $0.25
Le gros pic: folds 
Mrinaldi: folds 
Alameda22: folds 
doom069: folds 
Kosusher: checks 
*** FLOP *** [Th 7c 3h]
Kosusher: bets $0.25
bigdaddycmd: calls $0.25
*** TURN *** [Th 7c 3h] [Qh]
Kosusher: bets $1
bigdaddycmd: folds 
Uncalled bet ($1) returned to Kosusher
Kosusher collected $1.05 from pot
*** SUMMARY ***
Total pot $1.10 | Rake $0.05 
Board [Th 7c 3h Qh]
Seat 1: fantasyguy folded before Flop (didn't bet)
Seat 2: daisy108 folded before Flop (didn't bet)
Seat 3: dwmcc folded before Flop (didn't bet)
Seat 4: bigdaddycmd folded on the Turn
Seat 5: Le gros pic folded before Flop (didn't bet)
Seat 6: Mrinaldi folded before Flop (didn't bet)
Seat 7: Alameda22 (button) folded before Flop (didn't bet)
Seat 8: doom069 (small blind) folded before Flop
Seat 9: Kosusher (big blind) collected ($1.05)



PokerStars Game #19977255748:  Hold'em No Limit ($0.10/$0.25) - 2008/08/28 - 21:46:27 (ET)
Table 'Hippasos IV' 9-max Seat #8 is the button
Seat 1: fantasyguy ($25.85 in chips) 
Seat 2: daisy108 ($25 in chips) 
Seat 3: dwmcc ($24.40 in chips) 
Seat 4: bigdaddycmd ($18.95 in chips) 
Seat 5: Le gros pic ($30.25 in chips) 
Seat 6: Mrinaldi ($19.10 in chips) 
Seat 7: Alameda22 ($33.45 in chips) 
Seat 8: doom069 ($25.40 in chips) 
Seat 9: Kosusher ($20.70 in chips) 
Kosusher: posts small blind $0.10
fantasyguy: posts big blind $0.25
*** HOLE CARDS ***
Dealt to Alameda22 [4s Ah]
daisy108: folds 
dwmcc: calls $0.25
bigdaddycmd: calls $0.25
Le gros pic: folds 
Mrinaldi: folds 
Alameda22: folds 
doom069: raises $1.25 to $1.50
Kosusher: folds 
fantasyguy: calls $1.25
dwmcc: calls $1.25
bigdaddycmd: calls $1.25
*** FLOP *** [Ts 2h Ks]
fantasyguy: checks 
dwmcc: bets $2
bigdaddycmd: folds 
doom069: folds 
fantasyguy: calls $2
*** TURN *** [Ts 2h Ks] [7s]
fantasyguy: checks 
dwmcc: checks 
*** RIVER *** [Ts 2h Ks 7s] [Tc]
fantasyguy: bets $4.75
dwmcc: calls $4.75
*** SHOW DOWN ***
fantasyguy: shows [Kd Th] (a full house, Tens full of Kings)
dwmcc: mucks hand 
fantasyguy collected $18.65 from pot
*** SUMMARY ***
Total pot $19.60 | Rake $0.95 
Board [Ts 2h Ks 7s Tc]
Seat 1: fantasyguy (big blind) showed [Kd Th] and won ($18.65) with a full house, Tens full of Kings
Seat 2: daisy108 folded before Flop (didn't bet)
Seat 3: dwmcc mucked [Qd Kc]
Seat 4: bigdaddycmd folded on the Flop
Seat 5: Le gros pic folded before Flop (didn't bet)
Seat 6: Mrinaldi folded before Flop (didn't bet)
Seat 7: Alameda22 folded before Flop (didn't bet)
Seat 8: doom069 (button) folded on the Flop
Seat 9: Kosusher (small blind) folded before Flop



PokerStars Game #19977286824:  Hold'em No Limit ($0.10/$0.25) - 2008/08/28 - 21:47:50 (ET)
Table 'Hippasos IV' 9-max Seat #9 is the button
Seat 1: fantasyguy ($36.25 in chips) 
Seat 2: daisy108 ($25 in chips) 
Seat 3: dwmcc ($16.15 in chips) 
Seat 4: bigdaddycmd ($17.45 in chips) 
Seat 5: Le gros pic ($30.25 in chips) 
Seat 6: Mrinaldi ($19.10 in chips) 
Seat 7: Alameda22 ($33.45 in chips) 
Seat 8: doom069 ($23.90 in chips) 
Seat 9: Kosusher ($20.60 in chips) 
fantasyguy: posts small blind $0.10
daisy108: posts big blind $0.25
*** HOLE CARDS ***
Dealt to Alameda22 [9s 2s]
dwmcc: folds 
bigdaddycmd: folds 
Le gros pic: folds 
Mrinaldi: raises $0.50 to $0.75
Alameda22: folds 
doom069: folds 
Kosusher: raises $1 to $1.75
fantasyguy: folds 
daisy108: folds 
Mrinaldi: folds 
Uncalled bet ($1) returned to Kosusher
Kosusher collected $1.85 from pot
*** SUMMARY ***
Total pot $1.85 | Rake $0 
Seat 1: fantasyguy (small blind) folded before Flop
Seat 2: daisy108 (big blind) folded before Flop
Seat 3: dwmcc folded before Flop (didn't bet)
Seat 4: bigdaddycmd folded before Flop (didn't bet)
Seat 5: Le gros pic folded before Flop (didn't bet)
Seat 6: Mrinaldi folded before Flop
Seat 7: Alameda22 folded before Flop (didn't bet)
Seat 8: doom069 folded before Flop (didn't bet)
Seat 9: Kosusher (button) collected ($1.85)



PokerStars Game #19977303002:  Hold'em No Limit ($0.10/$0.25) - 2008/08/28 - 21:48:34 (ET)
Table 'Hippasos IV' 9-max Seat #1 is the button
Seat 1: fantasyguy ($36.15 in chips) 
Seat 2: daisy108 ($24.75 in chips) 
Seat 3: dwmcc ($16.15 in chips) 
Seat 4: bigdaddycmd ($17.45 in chips) 
Seat 5: Le gros pic ($30.25 in chips) 
Seat 6: Mrinaldi ($18.35 in chips) 
Seat 7: Alameda22 ($33.45 in chips) 
Seat 8: doom069 ($23.90 in chips) 
Seat 9: Kosusher ($21.70 in chips) 
daisy108: posts small blind $0.10
dwmcc: posts big blind $0.25
*** HOLE CARDS ***
Dealt to Alameda22 [Qs Kd]
bigdaddycmd: raises $0.50 to $0.75
Le gros pic: folds 
Mrinaldi: folds 
Alameda22: folds 
doom069: folds 
Kosusher: calls $0.75
fantasyguy: folds 
daisy108: folds 
dwmcc: calls $0.50
*** FLOP *** [Tc Ts Ks]
dwmcc: checks 
bigdaddycmd: checks 
Kosusher: bets $0.50
dwmcc: folds 
bigdaddycmd: folds 
Uncalled bet ($0.50) returned to Kosusher
Kosusher collected $2.25 from pot
*** SUMMARY ***
Total pot $2.35 | Rake $0.10 
Board [Tc Ts Ks]
Seat 1: fantasyguy (button) folded before Flop (didn't bet)
Seat 2: daisy108 (small blind) folded before Flop
Seat 3: dwmcc (big blind) folded on the Flop
Seat 4: bigdaddycmd folded on the Flop
Seat 5: Le gros pic folded before Flop (didn't bet)
Seat 6: Mrinaldi folded before Flop (didn't bet)
Seat 7: Alameda22 folded before Flop (didn't bet)
Seat 8: doom069 folded before Flop (didn't bet)
Seat 9: Kosusher collected ($2.25)



PokerStars Game #19977319295:  Hold'em No Limit ($0.10/$0.25) - 2008/08/28 - 21:49:18 (ET)
Table 'Hippasos IV' 9-max Seat #2 is the button
Seat 1: fantasyguy ($36.15 in chips) 
Seat 2: daisy108 ($24.65 in chips) 
Seat 3: dwmcc ($15.40 in chips) 
Seat 4: bigdaddycmd ($16.70 in chips) 
Seat 5: Le gros pic ($30.25 in chips) 
Seat 6: Mrinaldi ($18.35 in chips) 
Seat 7: Alameda22 ($33.45 in chips) 
Seat 8: doom069 ($23.90 in chips) 
Seat 9: Kosusher ($23.20 in chips) 
dwmcc: posts small blind $0.10
bigdaddycmd: posts big blind $0.25
*** HOLE CARDS ***
Dealt to Alameda22 [Kh Kc]
Le gros pic: folds 
Mrinaldi: calls $0.25
Alameda22: raises $0.75 to $1
doom069: folds 
Kosusher: calls $1
fantasyguy: folds 
daisy108: raises $2.75 to $3.75
dwmcc: folds 
bigdaddycmd: folds 
Mrinaldi: calls $3.50
Alameda22: raises $5.25 to $9
Kosusher: folds 
daisy108: folds 
Mrinaldi: raises $9.35 to $18.35 and is all-in
Alameda22: calls $9.35
*** FLOP *** [Ts 6s 2s]
*** TURN *** [Ts 6s 2s] [3h]
*** RIVER *** [Ts 6s 2s 3h] [7s]
*** SHOW DOWN ***
Mrinaldi: shows [Ah Ac] (a pair of Aces)
Alameda22: mucks hand 
Mrinaldi collected $39.75 from pot
*** SUMMARY ***
Total pot $41.80 | Rake $2.05 
Board [Ts 6s 2s 3h 7s]
Seat 1: fantasyguy folded before Flop (didn't bet)
Seat 2: daisy108 (button) folded before Flop
Seat 3: dwmcc (small blind) folded before Flop
Seat 4: bigdaddycmd (big blind) folded before Flop
Seat 5: Le gros pic folded before Flop (didn't bet)
Seat 6: Mrinaldi showed [Ah Ac] and won ($39.75) with a pair of Aces
Seat 7: Alameda22 mucked [Kh Kc]
Seat 8: doom069 folded before Flop (didn't bet)
Seat 9: Kosusher folded before Flop



PokerStars Game #19977359542:  Hold'em No Limit ($0.10/$0.25) - 2008/08/28 - 21:51:06 (ET)
Table 'Hippasos IV' 9-max Seat #3 is the button
Seat 1: fantasyguy ($36.15 in chips) 
Seat 2: daisy108 ($25 in chips) 
Seat 3: dwmcc ($15.30 in chips) 
Seat 4: bigdaddycmd ($16.45 in chips) 
Seat 5: Le gros pic ($30.25 in chips) 
Seat 6: Mrinaldi ($39.75 in chips) 
Seat 7: Alameda22 ($15.10 in chips) 
Seat 8: doom069 ($23.90 in chips) 
Seat 9: Kosusher ($22.20 in chips) 
bigdaddycmd: posts small blind $0.10
Le gros pic: posts big blind $0.25
*** HOLE CARDS ***
Dealt to Alameda22 [2d 7c]
Mrinaldi: folds 
Alameda22: folds 
doom069: folds 
doom069 leaves the table
Kosusher: folds 
fantasyguy: folds 
daisy108: raises $0.75 to $1
dwmcc: calls $1
bigdaddycmd: raises $1.50 to $2.50
Le gros pic: folds 
daisy108: calls $1.50
dwmcc: calls $1.50
*** FLOP *** [Jc 4h Qh]
asar3010 joins the table at seat #8 
bigdaddycmd: bets $7.75
daisy108: folds 
dwmcc: folds 
Uncalled bet ($7.75) returned to bigdaddycmd
bigdaddycmd collected $7.40 from pot
bigdaddycmd: doesn't show hand 
*** SUMMARY ***
Total pot $7.75 | Rake $0.35 
Board [Jc 4h Qh]
Seat 1: fantasyguy folded before Flop (didn't bet)
Seat 2: daisy108 folded on the Flop
Seat 3: dwmcc (button) folded on the Flop
Seat 4: bigdaddycmd (small blind) collected ($7.40)
Seat 5: Le gros pic (big blind) folded before Flop
Seat 6: Mrinaldi folded before Flop (didn't bet)
Seat 7: Alameda22 folded before Flop (didn't bet)
Seat 8: doom069 folded before Flop (didn't bet)
Seat 9: Kosusher folded before Flop (didn't bet)



PokerStars Game #19977388129:  Hold'em No Limit ($0.10/$0.25) - 2008/08/28 - 21:52:24 (ET)
Table 'Hippasos IV' 9-max Seat #4 is the button
Seat 1: fantasyguy ($36.15 in chips) 
Seat 2: daisy108 ($25 in chips) 
Seat 3: dwmcc ($12.80 in chips) 
Seat 4: bigdaddycmd ($21.35 in chips) 
Seat 5: Le gros pic ($30 in chips) 
Seat 6: Mrinaldi ($39.75 in chips) 
Seat 7: Alameda22 ($25 in chips) 
Seat 8: asar3010 ($5.30 in chips) 
Seat 9: Kosusher ($22.20 in chips) 
Le gros pic: posts small blind $0.10
Mrinaldi: posts big blind $0.25
asar3010: posts big blind $0.25
*** HOLE CARDS ***
Dealt to Alameda22 [Qh 2d]
Alameda22: folds 
asar3010: checks 
Kosusher: calls $0.25
fantasyguy: folds 
daisy108: folds 
dwmcc: calls $0.25
bigdaddycmd: folds 
Le gros pic: calls $0.15
Mrinaldi: checks 
*** FLOP *** [6h Kd Kh]
Le gros pic: checks 
Mrinaldi: bets $2.25
asar3010: folds 
Kosusher: folds 
dwmcc: folds 
Le gros pic: folds 
Uncalled bet ($2.25) returned to Mrinaldi
Mrinaldi collected $1.20 from pot
Mrinaldi: doesn't show hand 
*** SUMMARY ***
Total pot $1.25 | Rake $0.05 
Board [6h Kd Kh]
Seat 1: fantasyguy folded before Flop (didn't bet)
Seat 2: daisy108 folded before Flop (didn't bet)
Seat 3: dwmcc folded on the Flop
Seat 4: bigdaddycmd (button) folded before Flop (didn't bet)
Seat 5: Le gros pic (small blind) folded on the Flop
Seat 6: Mrinaldi (big blind) collected ($1.20)
Seat 7: Alameda22 folded before Flop (didn't bet)
Seat 8: asar3010 folded on the Flop
Seat 9: Kosusher folded on the Flop



PokerStars Game #19977413933:  Hold'em No Limit ($0.10/$0.25) - 2008/08/28 - 21:53:34 (ET)
Table 'Hippasos IV' 9-max Seat #5 is the button
Seat 1: fantasyguy ($36.15 in chips) 
Seat 2: daisy108 ($25 in chips) 
Seat 3: dwmcc ($12.55 in chips) 
Seat 4: bigdaddycmd ($21.35 in chips) 
Seat 5: Le gros pic ($29.75 in chips) 
Seat 6: Mrinaldi ($40.70 in chips) 
Seat 7: Alameda22 ($25 in chips) 
Seat 8: asar3010 ($5.05 in chips) 
Seat 9: Kosusher ($21.95 in chips) 
Mrinaldi: posts small blind $0.10
Alameda22: posts big blind $0.25
*** HOLE CARDS ***
Dealt to Alameda22 [4s 3c]
asar3010: raises $0.25 to $0.50
Kosusher: folds 
fantasyguy: folds 
daisy108: folds 
dwmcc: calls $0.50
bigdaddycmd: calls $0.50
Le gros pic: folds 
Mrinaldi: folds 
Alameda22: folds 
*** FLOP *** [2h Th 2c]
asar3010: bets $1.25
dwmcc: folds 
bigdaddycmd: folds 
Uncalled bet ($1.25) returned to asar3010
asar3010 collected $1.80 from pot
asar3010: doesn't show hand 
*** SUMMARY ***
Total pot $1.85 | Rake $0.05 
Board [2h Th 2c]
Seat 1: fantasyguy folded before Flop (didn't bet)
Seat 2: daisy108 folded before Flop (didn't bet)
Seat 3: dwmcc folded on the Flop
Seat 4: bigdaddycmd folded on the Flop
Seat 5: Le gros pic (button) folded before Flop (didn't bet)
Seat 6: Mrinaldi (small blind) folded before Flop
Seat 7: Alameda22 (big blind) folded before Flop
Seat 8: asar3010 collected ($1.80)
Seat 9: Kosusher folded before Flop (didn't bet)



PokerStars Game #19977429127:  Hold'em No Limit ($0.10/$0.25) - 2008/08/28 - 21:54:15 (ET)
Table 'Hippasos IV' 9-max Seat #6 is the button
Seat 1: fantasyguy ($36.15 in chips) 
Seat 2: daisy108 ($25 in chips) 
Seat 3: dwmcc ($12.05 in chips) 
Seat 4: bigdaddycmd ($20.85 in chips) 
Seat 5: Le gros pic ($29.75 in chips) 
Seat 6: Mrinaldi ($40.60 in chips) 
Seat 7: Alameda22 ($24.75 in chips) 
Seat 8: asar3010 ($6.35 in chips) 
Seat 9: Kosusher ($21.95 in chips) 
Alameda22: posts small blind $0.10
asar3010: posts big blind $0.25
*** HOLE CARDS ***
Dealt to Alameda22 [3c 2h]
Kosusher: calls $0.25
fantasyguy: folds 
daisy108: folds 
dwmcc: raises $0.75 to $1
bigdaddycmd: folds 
Le gros pic: folds 
Mrinaldi: calls $1
Alameda22: folds 
asar3010: calls $0.75
Kosusher: calls $0.75
*** FLOP *** [4s Jc 8h]
asar3010: bets $0.25
Kosusher: calls $0.25
dwmcc: raises $1.75 to $2
Mrinaldi: folds 
asar3010: calls $1.75
Kosusher: calls $1.75
*** TURN *** [4s Jc 8h] [5c]
asar3010: bets $0.25
Kosusher: calls $0.25
dwmcc: raises $3.50 to $3.75
asar3010: folds 
Kosusher: calls $3.50
*** RIVER *** [4s Jc 8h 5c] [2d]
Kosusher: checks 
dwmcc: bets $4.50
Kosusher: folds 
Uncalled bet ($4.50) returned to dwmcc
dwmcc collected $17 from pot
dwmcc: doesn't show hand 
*** SUMMARY ***
Total pot $17.85 | Rake $0.85 
Board [4s Jc 8h 5c 2d]
Seat 1: fantasyguy folded before Flop (didn't bet)
Seat 2: daisy108 folded before Flop (didn't bet)
Seat 3: dwmcc collected ($17)
Seat 4: bigdaddycmd folded before Flop (didn't bet)
Seat 5: Le gros pic folded before Flop (didn't bet)
Seat 6: Mrinaldi (button) folded on the Flop
Seat 7: Alameda22 (small blind) folded before Flop
Seat 8: asar3010 (big blind) folded on the Turn
Seat 9: Kosusher folded on the River



PokerStars Game #19977472365:  Hold'em No Limit ($0.10/$0.25) - 2008/08/28 - 21:56:13 (ET)
Table 'Hippasos IV' 9-max Seat #7 is the button
Seat 1: fantasyguy ($36.15 in chips) 
Seat 2: daisy108 ($25 in chips) 
Seat 3: dwmcc ($22.30 in chips) 
Seat 4: bigdaddycmd ($20.85 in chips) 
Seat 5: Le gros pic ($29.75 in chips) 
Seat 6: Mrinaldi ($39.60 in chips) 
Seat 7: Alameda22 ($24.65 in chips) 
Seat 8: asar3010 ($3.10 in chips) 
Seat 9: Kosusher ($15.20 in chips) 
asar3010: posts small blind $0.10
Kosusher: posts big blind $0.25
*** HOLE CARDS ***
Dealt to Alameda22 [Ac Jd]
fantasyguy: folds 
daisy108: folds 
dwmcc: calls $0.25
bigdaddycmd: folds 
Le gros pic: calls $0.25
Mrinaldi: folds 
Alameda22: raises $1 to $1.25
asar3010: folds 
Kosusher: folds 
dwmcc: folds 
Le gros pic: calls $1
*** FLOP *** [4d 6s Ah]
Le gros pic: checks 
Alameda22: bets $2
Le gros pic: folds 
Uncalled bet ($2) returned to Alameda22
Alameda22 collected $2.95 from pot
Alameda22: doesn't show hand 
*** SUMMARY ***
Total pot $3.10 | Rake $0.15 
Board [4d 6s Ah]
Seat 1: fantasyguy folded before Flop (didn't bet)
Seat 2: daisy108 folded before Flop (didn't bet)
Seat 3: dwmcc folded before Flop
Seat 4: bigdaddycmd folded before Flop (didn't bet)
Seat 5: Le gros pic folded on the Flop
Seat 6: Mrinaldi folded before Flop (didn't bet)
Seat 7: Alameda22 (button) collected ($2.95)
Seat 8: asar3010 (small blind) folded before Flop
Seat 9: Kosusher (big blind) folded before Flop



PokerStars Game #19977493741:  Hold'em No Limit ($0.10/$0.25) - 2008/08/28 - 21:57:12 (ET)
Table 'Hippasos IV' 9-max Seat #8 is the button
Seat 2: daisy108 ($25 in chips) 
Seat 3: dwmcc ($22.05 in chips) 
Seat 4: bigdaddycmd ($20.85 in chips) 
Seat 5: Le gros pic ($28.50 in chips) 
Seat 6: Mrinaldi ($39.60 in chips) 
Seat 7: Alameda22 ($26.35 in chips) 
Seat 8: asar3010 ($3 in chips) 
Seat 9: Kosusher ($14.95 in chips) 
Kosusher: posts small blind $0.10
fantasyguy: is sitting out 
fantasyguy leaves the table
daisy108: posts big blind $0.25
*** HOLE CARDS ***
Dealt to Alameda22 [Kc 8s]
dwmcc: folds 
bigdaddycmd: folds 
Le gros pic: folds 
John_The_Bad joins the table at seat #1 
Mrinaldi: raises $0.50 to $0.75
Alameda22: folds 
asar3010: folds 
Le gros pic is sitting out
Kosusher: calls $0.65
daisy108: folds 
*** FLOP *** [3d 4c 3c]
Kosusher: bets $0.25
Mrinaldi: calls $0.25
*** TURN *** [3d 4c 3c] [9s]
Kosusher: bets $0.25
Mrinaldi: calls $0.25
*** RIVER *** [3d 4c 3c 9s] [Ac]
Kosusher: bets $0.25
Mrinaldi: folds 
Uncalled bet ($0.25) returned to Kosusher
Kosusher collected $2.65 from pot
*** SUMMARY ***
Total pot $2.75 | Rake $0.10 
Board [3d 4c 3c 9s Ac]
Seat 2: daisy108 (big blind) folded before Flop
Seat 3: dwmcc folded before Flop (didn't bet)
Seat 4: bigdaddycmd folded before Flop (didn't bet)
Seat 5: Le gros pic folded before Flop (didn't bet)
Seat 6: Mrinaldi folded on the River
Seat 7: Alameda22 folded before Flop (didn't bet)
Seat 8: asar3010 (button) folded before Flop (didn't bet)
Seat 9: Kosusher (small blind) collected ($2.65)



PokerStars Game #19977516192:  Hold'em No Limit ($0.10/$0.25) - 2008/08/28 - 21:58:13 (ET)
Table 'Hippasos IV' 9-max Seat #9 is the button
Seat 2: daisy108 ($24.75 in chips) 
Seat 3: dwmcc ($22.05 in chips) 
Seat 4: bigdaddycmd ($20.85 in chips) 
Seat 6: Mrinaldi ($38.35 in chips) 
Seat 7: Alameda22 ($26.35 in chips) 
Seat 8: asar3010 ($3 in chips) 
Seat 9: Kosusher ($16.35 in chips) 
John_The_Bad will be allowed to play after the button
daisy108: posts small blind $0.10
dwmcc: posts big blind $0.25
*** HOLE CARDS ***
Dealt to Alameda22 [7h 2d]
bigdaddycmd: raises $1 to $1.25
Mrinaldi: folds 
Alameda22: folds 
asar3010: calls $1.25
Le gros pic has returned
Kosusher: calls $1.25
daisy108: folds 
dwmcc: calls $1
*** FLOP *** [Ac 9c 8h]
dwmcc: checks 
bigdaddycmd: bets $4.50
asar3010: calls $1.75 and is all-in
Kosusher: folds 
dwmcc: folds 
Uncalled bet ($2.75) returned to bigdaddycmd
*** TURN *** [Ac 9c 8h] [Qd]
*** RIVER *** [Ac 9c 8h Qd] [2h]
*** SHOW DOWN ***
bigdaddycmd: shows [8s 8c] (three of a kind, Eights)
asar3010: mucks hand 
bigdaddycmd collected $8.20 from pot
*** SUMMARY ***
Total pot $8.60 | Rake $0.40 
Board [Ac 9c 8h Qd 2h]
Seat 2: daisy108 (small blind) folded before Flop
Seat 3: dwmcc (big blind) folded on the Flop
Seat 4: bigdaddycmd showed [8s 8c] and won ($8.20) with three of a kind, Eights
Seat 6: Mrinaldi folded before Flop (didn't bet)
Seat 7: Alameda22 folded before Flop (didn't bet)
Seat 8: asar3010 mucked [3h 5h]
Seat 9: Kosusher (button) folded on the Flop



PokerStars Game #19977539008:  Hold'em No Limit ($0.10/$0.25) - 2008/08/28 - 21:59:17 (ET)
Table 'Hippasos IV' 9-max Seat #2 is the button
Seat 2: daisy108 ($24.65 in chips) 
Seat 3: dwmcc ($20.80 in chips) 
Seat 4: bigdaddycmd ($26.05 in chips) 
Seat 5: Le gros pic ($28.50 in chips) 
Seat 6: Mrinaldi ($38.35 in chips) 
Seat 7: Alameda22 ($26.35 in chips) 
Seat 9: Kosusher ($15.10 in chips) 
dwmcc: posts small blind $0.10
bigdaddycmd: posts big blind $0.25
John_The_Bad: sits out 
*** HOLE CARDS ***
Dealt to Alameda22 [Td 6s]
asar3010 has returned
Le gros pic: folds 
Mrinaldi: folds 
Alameda22: folds 
Kosusher: raises $1.50 to $1.75
daisy108: folds 
dwmcc: folds 
bigdaddycmd: folds 
Uncalled bet ($1.50) returned to Kosusher
Kosusher collected $0.60 from pot
*** SUMMARY ***
Total pot $0.60 | Rake $0 
Seat 2: daisy108 (button) folded before Flop (didn't bet)
Seat 3: dwmcc (small blind) folded before Flop
Seat 4: bigdaddycmd (big blind) folded before Flop
Seat 5: Le gros pic folded before Flop (didn't bet)
Seat 6: Mrinaldi folded before Flop (didn't bet)
Seat 7: Alameda22 folded before Flop (didn't bet)
Seat 9: Kosusher collected ($0.60)



PokerStars Game #19977554669:  Hold'em No Limit ($0.10/$0.25) - 2008/08/28 - 21:59:59 (ET)
Table 'Hippasos IV' 9-max Seat #3 is the button
Seat 2: daisy108 ($24.65 in chips) 
Seat 3: dwmcc ($20.70 in chips) 
Seat 4: bigdaddycmd ($25.80 in chips) 
Seat 5: Le gros pic ($28.50 in chips) 
Seat 6: Mrinaldi ($38.35 in chips) 
Seat 7: Alameda22 ($26.35 in chips) 
Seat 8: asar3010 ($5 in chips) 
Seat 9: Kosusher ($15.45 in chips) 
bigdaddycmd: posts small blind $0.10
Le gros pic: posts big blind $0.25
John_The_Bad: sits out 
*** HOLE CARDS ***
Dealt to Alameda22 [5s 6h]
Mrinaldi: raises $0.25 to $0.50
Alameda22: folds 
asar3010: folds 
Kosusher: calls $0.50
daisy108: folds 
dwmcc: folds 
bigdaddycmd: calls $0.40
Le gros pic: calls $0.25
*** FLOP *** [9c 4d 7c]
bigdaddycmd: bets $1
Le gros pic: folds 
Mrinaldi: folds 
Kosusher: raises $1 to $2
bigdaddycmd: folds 
Uncalled bet ($1) returned to Kosusher
Kosusher collected $3.85 from pot
*** SUMMARY ***
Total pot $4 | Rake $0.15 
Board [9c 4d 7c]
Seat 2: daisy108 folded before Flop (didn't bet)
Seat 3: dwmcc (button) folded before Flop (didn't bet)
Seat 4: bigdaddycmd (small blind) folded on the Flop
Seat 5: Le gros pic (big blind) folded on the Flop
Seat 6: Mrinaldi folded on the Flop
Seat 7: Alameda22 folded before Flop (didn't bet)
Seat 8: asar3010 folded before Flop (didn't bet)
Seat 9: Kosusher collected ($3.85)



PokerStars Game #19977578720:  Hold'em No Limit ($0.10/$0.25) - 2008/08/28 - 22:01:03 (ET)
Table 'Hippasos IV' 9-max Seat #4 is the button
Seat 2: daisy108 ($24.65 in chips) 
Seat 3: dwmcc ($20.70 in chips) 
Seat 4: bigdaddycmd ($24.30 in chips) 
Seat 5: Le gros pic ($28 in chips) 
Seat 6: Mrinaldi ($37.85 in chips) 
Seat 7: Alameda22 ($26.35 in chips) 
Seat 8: asar3010 ($5 in chips) 
Seat 9: Kosusher ($17.80 in chips) 
Le gros pic: posts small blind $0.10
Mrinaldi: posts big blind $0.25
John_The_Bad: sits out 
*** HOLE CARDS ***
Dealt to Alameda22 [3s 6c]
Alameda22: folds 
asar3010: raises $0.25 to $0.50
Kosusher: calls $0.50
daisy108: calls $0.50
dwmcc: folds 
bigdaddycmd: folds 
Le gros pic: folds 
Mrinaldi: folds 
*** FLOP *** [6h Kc 5d]
asar3010: bets $0.75
Kosusher: raises $0.75 to $1.50
daisy108: folds 
asar3010: calls $0.75
*** TURN *** [6h Kc 5d] [6s]
asar3010: checks 
Kosusher: bets $0.75
asar3010: folds 
Uncalled bet ($0.75) returned to Kosusher
Kosusher collected $4.65 from pot
*** SUMMARY ***
Total pot $4.85 | Rake $0.20 
Board [6h Kc 5d 6s]
Seat 2: daisy108 folded on the Flop
Seat 3: dwmcc folded before Flop (didn't bet)
Seat 4: bigdaddycmd (button) folded before Flop (didn't bet)
Seat 5: Le gros pic (small blind) folded before Flop
Seat 6: Mrinaldi (big blind) folded before Flop
Seat 7: Alameda22 folded before Flop (didn't bet)
Seat 8: asar3010 folded on the Turn
Seat 9: Kosusher collected ($4.65)



PokerStars Game #19977597167:  Hold'em No Limit ($0.10/$0.25) - 2008/08/28 - 22:01:52 (ET)
Table 'Hippasos IV' 9-max Seat #5 is the button
Seat 2: daisy108 ($24.15 in chips) 
Seat 3: dwmcc ($20.70 in chips) 
Seat 4: bigdaddycmd ($24.30 in chips) 
Seat 5: Le gros pic ($27.90 in chips) 
Seat 6: Mrinaldi ($37.60 in chips) 
Seat 7: Alameda22 ($26.35 in chips) 
Seat 8: asar3010 ($3 in chips) 
Seat 9: Kosusher ($20.45 in chips) 
Mrinaldi: posts small blind $0.10
Alameda22: posts big blind $0.25
John_The_Bad: sits out 
*** HOLE CARDS ***
Dealt to Alameda22 [Qs Ah]
asar3010: calls $0.25
Kosusher: calls $0.25
daisy108: folds 
dwmcc: folds 
bigdaddycmd: calls $0.25
Le gros pic: calls $0.25
Mrinaldi: folds 
Alameda22: raises $1.25 to $1.50
asar3010: folds 
Kosusher: calls $1.25
bigdaddycmd: calls $1.25
Le gros pic: folds 
*** FLOP *** [9s Ts 7c]
Alameda22: bets $3
Kosusher: calls $3
bigdaddycmd: calls $3
*** TURN *** [9s Ts 7c] [8s]
asar3010 is sitting out
Alameda22: checks 
Kosusher: bets $2
bigdaddycmd: raises $12 to $14
Alameda22: folds 
Kosusher: calls $12
*** RIVER *** [9s Ts 7c 8s] [Tc]
Kosusher: checks 
bigdaddycmd: bets $5.80 and is all-in
Kosusher: calls $1.95 and is all-in
Uncalled bet ($3.85) returned to bigdaddycmd
*** SHOW DOWN ***
bigdaddycmd: shows [Js Qc] (a straight, Eight to Queen)
Kosusher: shows [Kh 6s] (a straight, Six to Ten)
bigdaddycmd collected $43.85 from pot
*** SUMMARY ***
Total pot $46 | Rake $2.15 
Board [9s Ts 7c 8s Tc]
Seat 2: daisy108 folded before Flop (didn't bet)
Seat 3: dwmcc folded before Flop (didn't bet)
Seat 4: bigdaddycmd showed [Js Qc] and won ($43.85) with a straight, Eight to Queen
Seat 5: Le gros pic (button) folded before Flop
Seat 6: Mrinaldi (small blind) folded before Flop
Seat 7: Alameda22 (big blind) folded on the Turn
Seat 8: asar3010 folded before Flop
Seat 9: Kosusher showed [Kh 6s] and lost with a straight, Six to Ten



PokerStars Game #19977642790:  Hold'em No Limit ($0.10/$0.25) - 2008/08/28 - 22:03:56 (ET)
Table 'Hippasos IV' 9-max Seat #6 is the button
Seat 1: John_The_Bad ($25 in chips) 
Seat 2: daisy108 ($24.15 in chips) 
Seat 3: dwmcc ($20.70 in chips) 
Seat 4: bigdaddycmd ($47.70 in chips) 
Seat 5: Le gros pic ($27.65 in chips) 
Seat 6: Mrinaldi ($37.50 in chips) 
Seat 7: Alameda22 ($21.85 in chips) 
Alameda22: posts small blind $0.10
John_The_Bad: posts big blind $0.25
*** HOLE CARDS ***
Dealt to Alameda22 [Tc Ah]
daisy108: folds 
dwmcc: folds 
bigdaddycmd: folds 
Le gros pic: folds 
Kosusher leaves the table
Mrinaldi: folds 
Alameda22: folds 
Uncalled bet ($0.15) returned to John_The_Bad
John_The_Bad collected $0.20 from pot
John_The_Bad: doesn't show hand 
*** SUMMARY ***
Total pot $0.20 | Rake $0 
Seat 1: John_The_Bad (big blind) collected ($0.20)
Seat 2: daisy108 folded before Flop (didn't bet)
Seat 3: dwmcc folded before Flop (didn't bet)
Seat 4: bigdaddycmd folded before Flop (didn't bet)
Seat 5: Le gros pic folded before Flop (didn't bet)
Seat 6: Mrinaldi (button) folded before Flop (didn't bet)
Seat 7: Alameda22 (small blind) folded before Flop



PokerStars Game #19977652661:  Hold'em No Limit ($0.10/$0.25) - 2008/08/28 - 22:04:23 (ET)
Table 'Hippasos IV' 9-max Seat #7 is the button
Seat 1: John_The_Bad ($25.10 in chips) 
Seat 2: daisy108 ($24.15 in chips) 
Seat 3: dwmcc ($20.70 in chips) 
Seat 4: bigdaddycmd ($47.70 in chips) 
Seat 5: Le gros pic ($27.65 in chips) 
Seat 6: Mrinaldi ($37.50 in chips) 
Seat 7: Alameda22 ($21.75 in chips) 
John_The_Bad: posts small blind $0.10
daisy108: posts big blind $0.25
*** HOLE CARDS ***
Dealt to Alameda22 [2c 5h]
dwmcc: calls $0.25
bigdaddycmd: calls $0.25
Le gros pic: folds 
Mrinaldi: folds 
Alameda22: folds 
John_The_Bad: folds 
daisy108: checks 
*** FLOP *** [4c Js Tc]
daisy108: checks 
jm_mathurin joins the table at seat #9 
dwmcc: bets $0.75
bigdaddycmd: folds 
daisy108: folds 
Uncalled bet ($0.75) returned to dwmcc
dwmcc collected $0.85 from pot
dwmcc: doesn't show hand 
*** SUMMARY ***
Total pot $0.85 | Rake $0 
Board [4c Js Tc]
Seat 1: John_The_Bad (small blind) folded before Flop
Seat 2: daisy108 (big blind) folded on the Flop
Seat 3: dwmcc collected ($0.85)
Seat 4: bigdaddycmd folded on the Flop
Seat 5: Le gros pic folded before Flop (didn't bet)
Seat 6: Mrinaldi folded before Flop (didn't bet)
Seat 7: Alameda22 (button) folded before Flop (didn't bet)



PokerStars Game #19977670384:  Hold'em No Limit ($0.10/$0.25) - 2008/08/28 - 22:05:11 (ET)
Table 'Hippasos IV' 9-max Seat #1 is the button
Seat 1: John_The_Bad ($25 in chips) 
Seat 2: daisy108 ($23.90 in chips) 
Seat 3: dwmcc ($21.30 in chips) 
Seat 4: bigdaddycmd ($47.45 in chips) 
Seat 5: Le gros pic ($27.65 in chips) 
Seat 6: Mrinaldi ($37.50 in chips) 
Seat 7: Alameda22 ($21.75 in chips) 
Seat 9: jm_mathurin ($25 in chips) 
daisy108: posts small blind $0.10
dwmcc: posts big blind $0.25
jm_mathurin: posts big blind $0.25
*** HOLE CARDS ***
Dealt to Alameda22 [Td 5s]
bigdaddycmd: folds 
Le gros pic: folds 
Mrinaldi: folds 
Alameda22: folds 
jm_mathurin: checks 
John_The_Bad: folds 
daisy108: folds 
dwmcc: checks 
*** FLOP *** [Tc Kh 9d]
dwmcc: bets $0.25
jm_mathurin: folds 
Uncalled bet ($0.25) returned to dwmcc
dwmcc collected $0.60 from pot
dwmcc: doesn't show hand 
*** SUMMARY ***
Total pot $0.60 | Rake $0 
Board [Tc Kh 9d]
Seat 1: John_The_Bad (button) folded before Flop (didn't bet)
Seat 2: daisy108 (small blind) folded before Flop
Seat 3: dwmcc (big blind) collected ($0.60)
Seat 4: bigdaddycmd folded before Flop (didn't bet)
Seat 5: Le gros pic folded before Flop (didn't bet)
Seat 6: Mrinaldi folded before Flop (didn't bet)
Seat 7: Alameda22 folded before Flop (didn't bet)
Seat 9: jm_mathurin folded on the Flop



PokerStars Game #19977688262:  Hold'em No Limit ($0.10/$0.25) - 2008/08/28 - 22:06:00 (ET)
Table 'Hippasos IV' 9-max Seat #2 is the button
Seat 1: John_The_Bad ($25 in chips) 
Seat 2: daisy108 ($23.80 in chips) 
Seat 3: dwmcc ($21.65 in chips) 
Seat 4: bigdaddycmd ($47.45 in chips) 
Seat 5: Le gros pic ($27.65 in chips) 
Seat 6: Mrinaldi ($37.50 in chips) 
Seat 7: Alameda22 ($21.75 in chips) 
Seat 9: jm_mathurin ($24.75 in chips) 
dwmcc: posts small blind $0.10
bigdaddycmd: posts big blind $0.25
*** HOLE CARDS ***
Dealt to Alameda22 [Ad 8h]
Le gros pic: folds 
Mrinaldi: folds 
Alameda22: folds 
jm_mathurin: folds 
John_The_Bad: raises $0.50 to $0.75
daisy108: folds 
dwmcc: calls $0.65
bigdaddycmd: calls $0.50
*** FLOP *** [Ah Ks 6d]
dwmcc: bets $0.75
bigdaddycmd: folds 
John_The_Bad: calls $0.75
*** TURN *** [Ah Ks 6d] [9c]
dwmcc: bets $1.50
John_The_Bad: folds 
Uncalled bet ($1.50) returned to dwmcc
dwmcc collected $3.60 from pot
dwmcc: doesn't show hand 
*** SUMMARY ***
Total pot $3.75 | Rake $0.15 
Board [Ah Ks 6d 9c]
Seat 1: John_The_Bad folded on the Turn
Seat 2: daisy108 (button) folded before Flop (didn't bet)
Seat 3: dwmcc (small blind) collected ($3.60)
Seat 4: bigdaddycmd (big blind) folded on the Flop
Seat 5: Le gros pic folded before Flop (didn't bet)
Seat 6: Mrinaldi folded before Flop (didn't bet)
Seat 7: Alameda22 folded before Flop (didn't bet)
Seat 9: jm_mathurin folded before Flop (didn't bet)



PokerStars Game #19977706667:  Hold'em No Limit ($0.10/$0.25) - 2008/08/28 - 22:06:50 (ET)
Table 'Hippasos IV' 9-max Seat #3 is the button
Seat 1: John_The_Bad ($25 in chips) 
Seat 2: daisy108 ($25 in chips) 
Seat 3: dwmcc ($23.75 in chips) 
Seat 4: bigdaddycmd ($46.70 in chips) 
Seat 5: Le gros pic ($27.65 in chips) 
Seat 6: Mrinaldi ($37.50 in chips) 
Seat 7: Alameda22 ($21.75 in chips) 
Seat 9: jm_mathurin ($24.75 in chips) 
bigdaddycmd: posts small blind $0.10
Le gros pic: posts big blind $0.25
*** HOLE CARDS ***
Dealt to Alameda22 [Td 2c]
Mrinaldi: folds 
Alameda22: folds 
jm_mathurin: folds 
John_The_Bad: folds 
daisy108: folds 
dwmcc: raises $0.50 to $0.75
bigdaddycmd: calls $0.65
Le gros pic: folds 
*** FLOP *** [2h 2d Ts]
bigdaddycmd: bets $1
dwmcc: folds 
Uncalled bet ($1) returned to bigdaddycmd
bigdaddycmd collected $1.70 from pot
bigdaddycmd: doesn't show hand 
*** SUMMARY ***
Total pot $1.75 | Rake $0.05 
Board [2h 2d Ts]
Seat 1: John_The_Bad folded before Flop (didn't bet)
Seat 2: daisy108 folded before Flop (didn't bet)
Seat 3: dwmcc (button) folded on the Flop
Seat 4: bigdaddycmd (small blind) collected ($1.70)
Seat 5: Le gros pic (big blind) folded before Flop
Seat 6: Mrinaldi folded before Flop (didn't bet)
Seat 7: Alameda22 folded before Flop (didn't bet)
Seat 9: jm_mathurin folded before Flop (didn't bet)



PokerStars Game #19977719491:  Hold'em No Limit ($0.10/$0.25) - 2008/08/28 - 22:07:25 (ET)
Table 'Hippasos IV' 9-max Seat #4 is the button
Seat 1: John_The_Bad ($25 in chips) 
Seat 2: daisy108 ($25 in chips) 
Seat 3: dwmcc ($23 in chips) 
Seat 4: bigdaddycmd ($47.65 in chips) 
Seat 5: Le gros pic ($27.40 in chips) 
Seat 6: Mrinaldi ($37.50 in chips) 
Seat 7: Alameda22 ($21.75 in chips) 
Seat 9: jm_mathurin ($24.75 in chips) 
Le gros pic: posts small blind $0.10
Mrinaldi: posts big blind $0.25
*** HOLE CARDS ***
Dealt to Alameda22 [9d 7d]
Alameda22: folds 
jm_mathurin: folds 
John_The_Bad: folds 
daisy108: folds 
dwmcc: calls $0.25
bigdaddycmd: raises $1.75 to $2
asar3010 has returned
Le gros pic: folds 
Mrinaldi: folds 
dwmcc: calls $1.75
*** FLOP *** [5d 8d 5s]
dwmcc: checks 
asar3010 leaves the table
bigdaddycmd: bets $1.50
dwmcc: calls $1.50
*** TURN *** [5d 8d 5s] [2h]
betganij joins the table at seat #8 
dwmcc: bets $2
bigdaddycmd: calls $2
*** RIVER *** [5d 8d 5s 2h] [2s]
dwmcc: bets $5
bigdaddycmd: calls $5
*** SHOW DOWN ***
dwmcc: shows [4h 6s] (two pair, Fives and Deuces)
bigdaddycmd: shows [Ad Qc] (two pair, Fives and Deuces - Ace kicker)
bigdaddycmd collected $20.35 from pot
*** SUMMARY ***
Total pot $21.35 | Rake $1 
Board [5d 8d 5s 2h 2s]
Seat 1: John_The_Bad folded before Flop (didn't bet)
Seat 2: daisy108 folded before Flop (didn't bet)
Seat 3: dwmcc showed [4h 6s] and lost with two pair, Fives and Deuces
Seat 4: bigdaddycmd (button) showed [Ad Qc] and won ($20.35) with two pair, Fives and Deuces
Seat 5: Le gros pic (small blind) folded before Flop
Seat 6: Mrinaldi (big blind) folded before Flop
Seat 7: Alameda22 folded before Flop (didn't bet)
Seat 9: jm_mathurin folded before Flop (didn't bet)



PokerStars Game #19977750952:  Hold'em No Limit ($0.10/$0.25) - 2008/08/28 - 22:08:51 (ET)
Table 'Hippasos IV' 9-max Seat #5 is the button
Seat 1: John_The_Bad ($25 in chips) 
Seat 2: daisy108 ($25 in chips) 
Seat 3: dwmcc ($12.50 in chips) 
Seat 4: bigdaddycmd ($57.50 in chips) 
Seat 5: Le gros pic ($27.30 in chips) 
Seat 6: Mrinaldi ($37.25 in chips) 
Seat 7: Alameda22 ($21.75 in chips) 
Seat 9: jm_mathurin ($24.75 in chips) 
Mrinaldi: posts small blind $0.10
Alameda22: posts big blind $0.25
betganij: sits out 
*** HOLE CARDS ***
Dealt to Alameda22 [Qs 5h]
jm_mathurin: calls $0.25
John_The_Bad: raises $1 to $1.25
daisy108: folds 
dwmcc: calls $1.25
bigdaddycmd: calls $1.25
Le gros pic: folds 
Mrinaldi: folds 
Alameda22: folds 
jm_mathurin: calls $1
*** FLOP *** [8h Jh Kc]
jm_mathurin: checks 
John_The_Bad: checks 
dwmcc: checks 
bigdaddycmd: bets $2.25
jm_mathurin: folds 
John_The_Bad: folds 
dwmcc: calls $2.25
*** TURN *** [8h Jh Kc] [Kd]
dwmcc: checks 
bigdaddycmd: checks 
*** RIVER *** [8h Jh Kc Kd] [7c]
dwmcc: checks 
bigdaddycmd: checks 
*** SHOW DOWN ***
dwmcc: shows [Qd Ac] (a pair of Kings)
bigdaddycmd: shows [Jd Qh] (two pair, Kings and Jacks)
bigdaddycmd collected $9.40 from pot
*** SUMMARY ***
Total pot $9.85 | Rake $0.45 
Board [8h Jh Kc Kd 7c]
Seat 1: John_The_Bad folded on the Flop
Seat 2: daisy108 folded before Flop (didn't bet)
Seat 3: dwmcc showed [Qd Ac] and lost with a pair of Kings
Seat 4: bigdaddycmd showed [Jd Qh] and won ($9.40) with two pair, Kings and Jacks
Seat 5: Le gros pic (button) folded before Flop (didn't bet)
Seat 6: Mrinaldi (small blind) folded before Flop
Seat 7: Alameda22 (big blind) folded before Flop
Seat 9: jm_mathurin folded on the Flop



PokerStars Game #19977784473:  Hold'em No Limit ($0.10/$0.25) - 2008/08/28 - 22:10:24 (ET)
Table 'Hippasos IV' 9-max Seat #6 is the button
Seat 1: John_The_Bad ($25 in chips) 
Seat 2: daisy108 ($25 in chips) 
Seat 3: dwmcc ($9 in chips) 
Seat 4: bigdaddycmd ($63.40 in chips) 
Seat 5: Le gros pic ($27.30 in chips) 
Seat 6: Mrinaldi ($37.15 in chips) 
Seat 7: Alameda22 ($21.50 in chips) 
Seat 8: betganij ($5 in chips) 
Seat 9: jm_mathurin ($23.50 in chips) 
Alameda22: posts small blind $0.10
betganij: posts big blind $0.25
*** HOLE CARDS ***
Dealt to Alameda22 [4h Ks]
jm_mathurin: folds 
John_The_Bad: folds 
daisy108: folds 
dwmcc: folds 
bigdaddycmd: folds 
Le gros pic: raises $0.50 to $0.75
Mrinaldi: folds 
Alameda22: folds 
betganij: folds 
Uncalled bet ($0.50) returned to Le gros pic
Le gros pic collected $0.60 from pot
Le gros pic: doesn't show hand 
*** SUMMARY ***
Total pot $0.60 | Rake $0 
Seat 1: John_The_Bad folded before Flop (didn't bet)
Seat 2: daisy108 folded before Flop (didn't bet)
Seat 3: dwmcc folded before Flop (didn't bet)
Seat 4: bigdaddycmd folded before Flop (didn't bet)
Seat 5: Le gros pic collected ($0.60)
Seat 6: Mrinaldi (button) folded before Flop (didn't bet)
Seat 7: Alameda22 (small blind) folded before Flop
Seat 8: betganij (big blind) folded before Flop
Seat 9: jm_mathurin folded before Flop (didn't bet)



PokerStars Game #19977797076:  Hold'em No Limit ($0.10/$0.25) - 2008/08/28 - 22:10:58 (ET)
Table 'Hippasos IV' 9-max Seat #7 is the button
Seat 1: John_The_Bad ($25 in chips) 
Seat 2: daisy108 ($25 in chips) 
Seat 3: dwmcc ($9 in chips) 
Seat 4: bigdaddycmd ($63.40 in chips) 
Seat 5: Le gros pic ($27.65 in chips) 
Seat 6: Mrinaldi ($37.15 in chips) 
Seat 7: Alameda22 ($21.40 in chips) 
Seat 8: betganij ($4.75 in chips) 
Seat 9: jm_mathurin ($23.50 in chips) 
betganij: posts small blind $0.10
jm_mathurin: posts big blind $0.25
*** HOLE CARDS ***
Dealt to Alameda22 [8h 8d]
John_The_Bad: folds 
daisy108: folds 
dwmcc: calls $0.25
bigdaddycmd: calls $0.25
Le gros pic: folds 
Mrinaldi: folds 
Alameda22: calls $0.25
betganij: folds 
jm_mathurin: checks 
*** FLOP *** [Ts Kc 3d]
jm_mathurin: checks 
dwmcc: bets $0.75
bigdaddycmd: folds 
Alameda22: folds 
jm_mathurin: folds 
Uncalled bet ($0.75) returned to dwmcc
dwmcc collected $1.05 from pot
dwmcc: doesn't show hand 
*** SUMMARY ***
Total pot $1.10 | Rake $0.05 
Board [Ts Kc 3d]
Seat 1: John_The_Bad folded before Flop (didn't bet)
Seat 2: daisy108 folded before Flop (didn't bet)
Seat 3: dwmcc collected ($1.05)
Seat 4: bigdaddycmd folded on the Flop
Seat 5: Le gros pic folded before Flop (didn't bet)
Seat 6: Mrinaldi folded before Flop (didn't bet)
Seat 7: Alameda22 (button) folded on the Flop
Seat 8: betganij (small blind) folded before Flop
Seat 9: jm_mathurin (big blind) folded on the Flop



PokerStars Game #19977823232:  Hold'em No Limit ($0.10/$0.25) - 2008/08/28 - 22:12:10 (ET)
Table 'Hippasos IV' 9-max Seat #8 is the button
Seat 1: John_The_Bad ($25 in chips) 
Seat 2: daisy108 ($25 in chips) 
Seat 3: dwmcc ($9.80 in chips) 
Seat 4: bigdaddycmd ($63.15 in chips) 
Seat 5: Le gros pic ($27.65 in chips) 
Seat 6: Mrinaldi ($37.15 in chips) 
Seat 7: Alameda22 ($21.15 in chips) 
Seat 8: betganij ($4.65 in chips) 
Seat 9: jm_mathurin ($23.25 in chips) 
jm_mathurin: posts small blind $0.10
John_The_Bad: posts big blind $0.25
*** HOLE CARDS ***
Dealt to Alameda22 [Tc 8h]
daisy108: raises $0.75 to $1
dwmcc: folds 
bigdaddycmd: folds 
Le gros pic: folds 
Mrinaldi: folds 
Alameda22: folds 
betganij: folds 
jm_mathurin: folds 
John_The_Bad: folds 
Uncalled bet ($0.75) returned to daisy108
daisy108 collected $0.60 from pot
daisy108: doesn't show hand 
*** SUMMARY ***
Total pot $0.60 | Rake $0 
Seat 1: John_The_Bad (big blind) folded before Flop
Seat 2: daisy108 collected ($0.60)
Seat 3: dwmcc folded before Flop (didn't bet)
Seat 4: bigdaddycmd folded before Flop (didn't bet)
Seat 5: Le gros pic folded before Flop (didn't bet)
Seat 6: Mrinaldi folded before Flop (didn't bet)
Seat 7: Alameda22 folded before Flop (didn't bet)
Seat 8: betganij (button) folded before Flop (didn't bet)
Seat 9: jm_mathurin (small blind) folded before Flop



PokerStars Game #19977838143:  Hold'em No Limit ($0.10/$0.25) - 2008/08/28 - 22:12:51 (ET)
Table 'Hippasos IV' 9-max Seat #9 is the button
Seat 1: John_The_Bad ($24.75 in chips) 
Seat 2: daisy108 ($25.35 in chips) 
Seat 3: dwmcc ($9.80 in chips) 
Seat 4: bigdaddycmd ($63.15 in chips) 
Seat 5: Le gros pic ($27.65 in chips) 
Seat 6: Mrinaldi ($37.15 in chips) 
Seat 7: Alameda22 ($21.15 in chips) 
Seat 8: betganij ($4.65 in chips) 
Seat 9: jm_mathurin ($23.15 in chips) 
John_The_Bad: posts small blind $0.10
daisy108: posts big blind $0.25
*** HOLE CARDS ***
Dealt to Alameda22 [Th Jc]
dwmcc: folds 
bigdaddycmd: folds 
Le gros pic: folds 
Mrinaldi: folds 
Alameda22: folds 
betganij: folds 
jm_mathurin: folds 
John_The_Bad: folds 
Uncalled bet ($0.15) returned to daisy108
daisy108 collected $0.20 from pot
daisy108: doesn't show hand 
*** SUMMARY ***
Total pot $0.20 | Rake $0 
Seat 1: John_The_Bad (small blind) folded before Flop
Seat 2: daisy108 (big blind) collected ($0.20)
Seat 3: dwmcc folded before Flop (didn't bet)
Seat 4: bigdaddycmd folded before Flop (didn't bet)
Seat 5: Le gros pic folded before Flop (didn't bet)
Seat 6: Mrinaldi folded before Flop (didn't bet)
Seat 7: Alameda22 folded before Flop (didn't bet)
Seat 8: betganij folded before Flop (didn't bet)
Seat 9: jm_mathurin (button) folded before Flop (didn't bet)



PokerStars Game #19977857586:  Hold'em No Limit ($0.10/$0.25) - 2008/08/28 - 22:13:45 (ET)
Table 'Hippasos IV' 9-max Seat #1 is the button
Seat 1: John_The_Bad ($24.65 in chips) 
Seat 2: daisy108 ($25.45 in chips) 
Seat 3: dwmcc ($9.80 in chips) 
Seat 4: bigdaddycmd ($63.15 in chips) 
Seat 5: Le gros pic ($27.65 in chips) 
Seat 6: Mrinaldi ($37.15 in chips) 
Seat 7: Alameda22 ($21.15 in chips) 
Seat 8: betganij ($4.65 in chips) 
Seat 9: jm_mathurin ($23.15 in chips) 
daisy108: posts small blind $0.10
dwmcc: posts big blind $0.25
*** HOLE CARDS ***
Dealt to Alameda22 [Th 3h]
bigdaddycmd: raises $1.25 to $1.50
Le gros pic: folds 
Mrinaldi: folds 
Alameda22: folds 
betganij: folds 
jm_mathurin: folds 
John_The_Bad: calls $1.50
daisy108: folds 
dwmcc: folds 
*** FLOP *** [Ac 4s 8c]
bigdaddycmd: bets $1.25
John_The_Bad: calls $1.25
*** TURN *** [Ac 4s 8c] [6d]
bigdaddycmd: checks 
John_The_Bad: bets $3.75
bigdaddycmd: calls $3.75
*** RIVER *** [Ac 4s 8c 6d] [8d]
bigdaddycmd: checks 
John_The_Bad: bets $5
bigdaddycmd: folds 
Uncalled bet ($5) returned to John_The_Bad
John_The_Bad collected $12.70 from pot
John_The_Bad: doesn't show hand 
*** SUMMARY ***
Total pot $13.35 | Rake $0.65 
Board [Ac 4s 8c 6d 8d]
Seat 1: John_The_Bad (button) collected ($12.70)
Seat 2: daisy108 (small blind) folded before Flop
Seat 3: dwmcc (big blind) folded before Flop
Seat 4: bigdaddycmd folded on the River
Seat 5: Le gros pic folded before Flop (didn't bet)
Seat 6: Mrinaldi folded before Flop (didn't bet)
Seat 7: Alameda22 folded before Flop (didn't bet)
Seat 8: betganij folded before Flop (didn't bet)
Seat 9: jm_mathurin folded before Flop (didn't bet)



PokerStars Game #19977881473:  Hold'em No Limit ($0.10/$0.25) - 2008/08/28 - 22:14:51 (ET)
Table 'Hippasos IV' 9-max Seat #2 is the button
Seat 1: John_The_Bad ($30.85 in chips) 
Seat 2: daisy108 ($25.35 in chips) 
Seat 3: dwmcc ($9.55 in chips) 
Seat 4: bigdaddycmd ($56.65 in chips) 
Seat 5: Le gros pic ($27.65 in chips) 
Seat 6: Mrinaldi ($37.15 in chips) 
Seat 7: Alameda22 ($21.15 in chips) 
Seat 8: betganij ($4.65 in chips) 
Seat 9: jm_mathurin ($23.15 in chips) 
dwmcc: posts small blind $0.10
bigdaddycmd: posts big blind $0.25
*** HOLE CARDS ***
Dealt to Alameda22 [4c 4d]
Le gros pic: folds 
Mrinaldi: raises $0.50 to $0.75
Alameda22: folds 
betganij: folds 
jm_mathurin: calls $0.75
John_The_Bad: folds 
daisy108: folds 
dwmcc: folds 
bigdaddycmd: calls $0.50
*** FLOP *** [2d Tc 6c]
bigdaddycmd: bets $1
Mrinaldi: folds 
jm_mathurin: folds 
Uncalled bet ($1) returned to bigdaddycmd
bigdaddycmd collected $2.25 from pot
bigdaddycmd: doesn't show hand 
*** SUMMARY ***
Total pot $2.35 | Rake $0.10 
Board [2d Tc 6c]
Seat 1: John_The_Bad folded before Flop (didn't bet)
Seat 2: daisy108 (button) folded before Flop (didn't bet)
Seat 3: dwmcc (small blind) folded before Flop
Seat 4: bigdaddycmd (big blind) collected ($2.25)
Seat 5: Le gros pic folded before Flop (didn't bet)
Seat 6: Mrinaldi folded on the Flop
Seat 7: Alameda22 folded before Flop (didn't bet)
Seat 8: betganij folded before Flop (didn't bet)
Seat 9: jm_mathurin folded on the Flop



PokerStars Game #19977909921:  Hold'em No Limit ($0.10/$0.25) - 2008/08/28 - 22:16:09 (ET)
Table 'Hippasos IV' 9-max Seat #3 is the button
Seat 1: John_The_Bad ($30.85 in chips) 
Seat 2: daisy108 ($25.35 in chips) 
Seat 3: dwmcc ($9.45 in chips) 
Seat 4: bigdaddycmd ($58.15 in chips) 
Seat 5: Le gros pic ($27.65 in chips) 
Seat 6: Mrinaldi ($36.40 in chips) 
Seat 7: Alameda22 ($21.15 in chips) 
Seat 8: betganij ($4.65 in chips) 
Seat 9: jm_mathurin ($22.40 in chips) 
bigdaddycmd: posts small blind $0.10
Le gros pic: posts big blind $0.25
*** HOLE CARDS ***
Dealt to Alameda22 [Td 7h]
Mrinaldi: folds 
Alameda22: folds 
betganij: folds 
jm_mathurin: folds 
John_The_Bad: raises $0.75 to $1
daisy108: raises $2.25 to $3.25
dwmcc: folds 
bigdaddycmd: folds 
Le gros pic: folds 
John_The_Bad: folds 
Uncalled bet ($2.25) returned to daisy108
daisy108 collected $2.35 from pot
daisy108: doesn't show hand 
*** SUMMARY ***
Total pot $2.35 | Rake $0 
Seat 1: John_The_Bad folded before Flop
Seat 2: daisy108 collected ($2.35)
Seat 3: dwmcc (button) folded before Flop (didn't bet)
Seat 4: bigdaddycmd (small blind) folded before Flop
Seat 5: Le gros pic (big blind) folded before Flop
Seat 6: Mrinaldi folded before Flop (didn't bet)
Seat 7: Alameda22 folded before Flop (didn't bet)
Seat 8: betganij folded before Flop (didn't bet)
Seat 9: jm_mathurin folded before Flop (didn't bet)



PokerStars Game #19977929172:  Hold'em No Limit ($0.10/$0.25) - 2008/08/28 - 22:17:03 (ET)
Table 'Hippasos IV' 9-max Seat #4 is the button
Seat 1: John_The_Bad ($29.85 in chips) 
Seat 2: daisy108 ($26.70 in chips) 
Seat 3: dwmcc ($9.45 in chips) 
Seat 4: bigdaddycmd ($58.05 in chips) 
Seat 5: Le gros pic ($27.40 in chips) 
Seat 6: Mrinaldi ($36.40 in chips) 
Seat 7: Alameda22 ($21.15 in chips) 
Seat 8: betganij ($4.65 in chips) 
Seat 9: jm_mathurin ($22.40 in chips) 
Le gros pic: posts small blind $0.10
Mrinaldi: posts big blind $0.25
*** HOLE CARDS ***
Dealt to Alameda22 [2s Qs]
Alameda22: folds 
betganij: folds 
jm_mathurin: folds 
John_The_Bad: folds 
daisy108: folds 
dwmcc: folds 
bigdaddycmd: raises $1.25 to $1.50
Le gros pic: folds 
Mrinaldi: folds 
Uncalled bet ($1.25) returned to bigdaddycmd
bigdaddycmd collected $0.60 from pot
bigdaddycmd: shows [Ac Kc] (high card Ace)
*** SUMMARY ***
Total pot $0.60 | Rake $0 
Seat 1: John_The_Bad folded before Flop (didn't bet)
Seat 2: daisy108 folded before Flop (didn't bet)
Seat 3: dwmcc folded before Flop (didn't bet)
Seat 4: bigdaddycmd (button) collected ($0.60)
Seat 5: Le gros pic (small blind) folded before Flop
Seat 6: Mrinaldi (big blind) folded before Flop
Seat 7: Alameda22 folded before Flop (didn't bet)
Seat 8: betganij folded before Flop (didn't bet)
Seat 9: jm_mathurin folded before Flop (didn't bet)



PokerStars Game #19977941342:  Hold'em No Limit ($0.10/$0.25) - 2008/08/28 - 22:17:37 (ET)
Table 'Hippasos IV' 9-max Seat #5 is the button
Seat 1: John_The_Bad ($29.85 in chips) 
Seat 2: daisy108 ($26.70 in chips) 
Seat 3: dwmcc ($9.45 in chips) 
Seat 4: bigdaddycmd ($58.40 in chips) 
Seat 5: Le gros pic ($27.30 in chips) 
Seat 6: Mrinaldi ($36.15 in chips) 
Seat 7: Alameda22 ($21.15 in chips) 
Seat 8: betganij ($4.65 in chips) 
Seat 9: jm_mathurin ($22.40 in chips) 
Mrinaldi: posts small blind $0.10
Alameda22: posts big blind $0.25
*** HOLE CARDS ***
Dealt to Alameda22 [Ac 3s]
betganij: folds 
jm_mathurin: folds 
John_The_Bad: folds 
daisy108: folds 
dwmcc: calls $0.25
bigdaddycmd: calls $0.25
Le gros pic: folds 
Mrinaldi: calls $0.15
Alameda22: checks 
*** FLOP *** [7s 2h Qd]
Mrinaldi: checks 
Alameda22: checks 
dwmcc: bets $0.50
bigdaddycmd: folds 
Mrinaldi: folds 
Alameda22: folds 
Uncalled bet ($0.50) returned to dwmcc
dwmcc collected $0.95 from pot
dwmcc: doesn't show hand 
*** SUMMARY ***
Total pot $1 | Rake $0.05 
Board [7s 2h Qd]
Seat 1: John_The_Bad folded before Flop (didn't bet)
Seat 2: daisy108 folded before Flop (didn't bet)
Seat 3: dwmcc collected ($0.95)
Seat 4: bigdaddycmd folded on the Flop
Seat 5: Le gros pic (button) folded before Flop (didn't bet)
Seat 6: Mrinaldi (small blind) folded on the Flop
Seat 7: Alameda22 (big blind) folded on the Flop
Seat 8: betganij folded before Flop (didn't bet)
Seat 9: jm_mathurin folded before Flop (didn't bet)



PokerStars Game #19977962035:  Hold'em No Limit ($0.10/$0.25) - 2008/08/28 - 22:18:34 (ET)
Table 'Hippasos IV' 9-max Seat #6 is the button
Seat 1: John_The_Bad ($29.85 in chips) 
Seat 2: daisy108 ($26.70 in chips) 
Seat 3: dwmcc ($10.15 in chips) 
Seat 4: bigdaddycmd ($58.15 in chips) 
Seat 5: Le gros pic ($27.30 in chips) 
Seat 6: Mrinaldi ($35.90 in chips) 
Seat 7: Alameda22 ($20.90 in chips) 
Seat 8: betganij ($4.65 in chips) 
Seat 9: jm_mathurin ($22.40 in chips) 
Alameda22: posts small blind $0.10
betganij: posts big blind $0.25
*** HOLE CARDS ***
Dealt to Alameda22 [5c Ks]
jm_mathurin: folds 
John_The_Bad: folds 
daisy108: folds 
dwmcc: folds 
bigdaddycmd: folds 
Le gros pic: folds 
Mrinaldi: raises $0.50 to $0.75
Alameda22: folds 
betganij: folds 
Uncalled bet ($0.50) returned to Mrinaldi
Mrinaldi collected $0.60 from pot
Mrinaldi: doesn't show hand 
*** SUMMARY ***
Total pot $0.60 | Rake $0 
Seat 1: John_The_Bad folded before Flop (didn't bet)
Seat 2: daisy108 folded before Flop (didn't bet)
Seat 3: dwmcc folded before Flop (didn't bet)
Seat 4: bigdaddycmd folded before Flop (didn't bet)
Seat 5: Le gros pic folded before Flop (didn't bet)
Seat 6: Mrinaldi (button) collected ($0.60)
Seat 7: Alameda22 (small blind) folded before Flop
Seat 8: betganij (big blind) folded before Flop
Seat 9: jm_mathurin folded before Flop (didn't bet)



PokerStars Game #19977983364:  Hold'em No Limit ($0.10/$0.25) - 2008/08/28 - 22:19:34 (ET)
Table 'Hippasos IV' 9-max Seat #7 is the button
Seat 1: John_The_Bad ($29.85 in chips) 
Seat 2: daisy108 ($26.70 in chips) 
Seat 3: dwmcc ($10.15 in chips) 
Seat 4: bigdaddycmd ($58.15 in chips) 
Seat 5: Le gros pic ($27.30 in chips) 
Seat 6: Mrinaldi ($36.25 in chips) 
Seat 7: Alameda22 ($20.80 in chips) 
Seat 8: betganij ($4.40 in chips) 
Seat 9: jm_mathurin ($22.40 in chips) 
betganij: posts small blind $0.10
jm_mathurin: posts big blind $0.25
*** HOLE CARDS ***
Dealt to Alameda22 [Jc 2d]
John_The_Bad: raises $0.75 to $1
daisy108: folds 
dwmcc: folds 
bigdaddycmd: folds 
Le gros pic: calls $1
Mrinaldi: folds 
Alameda22: folds 
betganij: folds 
jm_mathurin: folds 
*** FLOP *** [4h Td 9d]
John_The_Bad: bets $1.75
Le gros pic: calls $1.75
*** TURN *** [4h Td 9d] [Ks]
John_The_Bad: checks 
Le gros pic: bets $3.25
John_The_Bad: calls $3.25
*** RIVER *** [4h Td 9d Ks] [3d]
John_The_Bad: checks 
Le gros pic: checks 
*** SHOW DOWN ***
John_The_Bad: shows [Kd Ad] (a flush, Ace high)
Le gros pic: mucks hand 
John_The_Bad collected $11.75 from pot
*** SUMMARY ***
Total pot $12.35 | Rake $0.60 
Board [4h Td 9d Ks 3d]
Seat 1: John_The_Bad showed [Kd Ad] and won ($11.75) with a flush, Ace high
Seat 2: daisy108 folded before Flop (didn't bet)
Seat 3: dwmcc folded before Flop (didn't bet)
Seat 4: bigdaddycmd folded before Flop (didn't bet)
Seat 5: Le gros pic mucked [8c 8d]
Seat 6: Mrinaldi folded before Flop (didn't bet)
Seat 7: Alameda22 (button) folded before Flop (didn't bet)
Seat 8: betganij (small blind) folded before Flop
Seat 9: jm_mathurin (big blind) folded before Flop



PokerStars Game #19978016797:  Hold'em No Limit ($0.10/$0.25) - 2008/08/28 - 22:21:08 (ET)
Table 'Hippasos IV' 9-max Seat #8 is the button
Seat 1: John_The_Bad ($35.60 in chips) 
Seat 2: daisy108 ($26.70 in chips) 
Seat 3: dwmcc ($10.15 in chips) 
Seat 4: bigdaddycmd ($58.15 in chips) 
Seat 5: Le gros pic ($21.30 in chips) 
Seat 6: Mrinaldi ($36.25 in chips) 
Seat 7: Alameda22 ($20.80 in chips) 
Seat 8: betganij ($4.30 in chips) 
Seat 9: jm_mathurin ($22.15 in chips) 
jm_mathurin: posts small blind $0.10
John_The_Bad: posts big blind $0.25
*** HOLE CARDS ***
Dealt to Alameda22 [Ad 5s]
daisy108: folds 
dwmcc: calls $0.25
bigdaddycmd: calls $0.25
Le gros pic: folds 
Mrinaldi: folds 
Alameda22: folds 
betganij: folds 
jm_mathurin: folds 
John_The_Bad: checks 
*** FLOP *** [6d 5d Kd]
John_The_Bad: checks 
dwmcc: checks 
bigdaddycmd: checks 
*** TURN *** [6d 5d Kd] [9s]
John_The_Bad: checks 
dwmcc: checks 
bigdaddycmd: checks 
*** RIVER *** [6d 5d Kd 9s] [Ah]
John_The_Bad: checks 
dwmcc: checks 
bigdaddycmd: checks 
*** SHOW DOWN ***
John_The_Bad: shows [Tc 9c] (a pair of Nines)
dwmcc: shows [4s As] (a pair of Aces)
bigdaddycmd: shows [Ac 2h] (a pair of Aces)
dwmcc collected $0.45 from pot
bigdaddycmd collected $0.40 from pot
*** SUMMARY ***
Total pot $0.85 | Rake $0 
Board [6d 5d Kd 9s Ah]
Seat 1: John_The_Bad (big blind) showed [Tc 9c] and lost with a pair of Nines
Seat 2: daisy108 folded before Flop (didn't bet)
Seat 3: dwmcc showed [4s As] and won ($0.45) with a pair of Aces
Seat 4: bigdaddycmd showed [Ac 2h] and won ($0.40) with a pair of Aces
Seat 5: Le gros pic folded before Flop (didn't bet)
Seat 6: Mrinaldi folded before Flop (didn't bet)
Seat 7: Alameda22 folded before Flop (didn't bet)
Seat 8: betganij (button) folded before Flop (didn't bet)
Seat 9: jm_mathurin (small blind) folded before Flop



PokerStars Game #19978037141:  Hold'em No Limit ($0.10/$0.25) - 2008/08/28 - 22:22:05 (ET)
Table 'Hippasos IV' 9-max Seat #9 is the button
Seat 1: John_The_Bad ($35.35 in chips) 
Seat 2: daisy108 ($26.70 in chips) 
Seat 3: dwmcc ($10.35 in chips) 
Seat 4: bigdaddycmd ($58.30 in chips) 
Seat 5: Le gros pic ($21.30 in chips) 
Seat 6: Mrinaldi ($36.25 in chips) 
Seat 7: Alameda22 ($20.80 in chips) 
Seat 8: betganij ($4.30 in chips) 
Seat 9: jm_mathurin ($22.05 in chips) 
John_The_Bad: posts small blind $0.10
daisy108: posts big blind $0.25
*** HOLE CARDS ***
Dealt to Alameda22 [4s Ac]
dwmcc: folds 
bigdaddycmd: folds 
Le gros pic: calls $0.25
Mrinaldi: calls $0.25
Alameda22: folds 
betganij: folds 
jm_mathurin: folds 
John_The_Bad: calls $0.15
daisy108: checks 
*** FLOP *** [9c 4h 9h]
John_The_Bad: checks 
daisy108: checks 
Le gros pic: checks 
Mrinaldi: checks 
*** TURN *** [9c 4h 9h] [Kh]
John_The_Bad: checks 
daisy108: checks 
Le gros pic: checks 
Mrinaldi: bets $1.50
John_The_Bad: folds 
daisy108: folds 
Le gros pic: folds 
Uncalled bet ($1.50) returned to Mrinaldi
Mrinaldi collected $0.95 from pot
Mrinaldi: doesn't show hand 
*** SUMMARY ***
Total pot $1 | Rake $0.05 
Board [9c 4h 9h Kh]
Seat 1: John_The_Bad (small blind) folded on the Turn
Seat 2: daisy108 (big blind) folded on the Turn
Seat 3: dwmcc folded before Flop (didn't bet)
Seat 4: bigdaddycmd folded before Flop (didn't bet)
Seat 5: Le gros pic folded on the Turn
Seat 6: Mrinaldi collected ($0.95)
Seat 7: Alameda22 folded before Flop (didn't bet)
Seat 8: betganij folded before Flop (didn't bet)
Seat 9: jm_mathurin (button) folded before Flop (didn't bet)



PokerStars Game #19978065279:  Hold'em No Limit ($0.10/$0.25) - 2008/08/28 - 22:23:23 (ET)
Table 'Hippasos IV' 9-max Seat #1 is the button
Seat 1: John_The_Bad ($35.10 in chips) 
Seat 2: daisy108 ($26.45 in chips) 
Seat 3: dwmcc ($10.35 in chips) 
Seat 4: bigdaddycmd ($58.30 in chips) 
Seat 5: Le gros pic ($21.05 in chips) 
Seat 6: Mrinaldi ($36.95 in chips) 
Seat 7: Alameda22 ($20.80 in chips) 
Seat 8: betganij ($5 in chips) 
Seat 9: jm_mathurin ($22.05 in chips) 
daisy108: posts small blind $0.10
dwmcc: posts big blind $0.25
*** HOLE CARDS ***
Dealt to Alameda22 [Js Ts]
bigdaddycmd: folds 
Le gros pic: folds 
Mrinaldi: raises $0.50 to $0.75
Alameda22: folds 
betganij: folds 
jm_mathurin: calls $0.75
John_The_Bad: folds 
daisy108: folds 
dwmcc: folds 
*** FLOP *** [Qs As Jd]
Mrinaldi: bets $1
jm_mathurin: folds 
Uncalled bet ($1) returned to Mrinaldi
Mrinaldi collected $1.80 from pot
Mrinaldi: doesn't show hand 
*** SUMMARY ***
Total pot $1.85 | Rake $0.05 
Board [Qs As Jd]
Seat 1: John_The_Bad (button) folded before Flop (didn't bet)
Seat 2: daisy108 (small blind) folded before Flop
Seat 3: dwmcc (big blind) folded before Flop
Seat 4: bigdaddycmd folded before Flop (didn't bet)
Seat 5: Le gros pic folded before Flop (didn't bet)
Seat 6: Mrinaldi collected ($1.80)
Seat 7: Alameda22 folded before Flop (didn't bet)
Seat 8: betganij folded before Flop (didn't bet)
Seat 9: jm_mathurin folded on the Flop



PokerStars Game #19978084956:  Hold'em No Limit ($0.10/$0.25) - 2008/08/28 - 22:24:17 (ET)
Table 'Hippasos IV' 9-max Seat #2 is the button
Seat 1: John_The_Bad ($35.10 in chips) 
Seat 2: daisy108 ($26.35 in chips) 
Seat 3: dwmcc ($10.10 in chips) 
Seat 4: bigdaddycmd ($58.30 in chips) 
Seat 5: Le gros pic ($21.05 in chips) 
Seat 6: Mrinaldi ($38 in chips) 
Seat 7: Alameda22 ($20.80 in chips) 
Seat 8: betganij ($5 in chips) 
Seat 9: jm_mathurin ($25 in chips) 
dwmcc: posts small blind $0.10
bigdaddycmd: posts big blind $0.25
*** HOLE CARDS ***
Dealt to Alameda22 [Kd 6s]
Le gros pic: folds 
Mrinaldi: folds 
Alameda22: folds 
betganij: folds 
jm_mathurin: folds 
John_The_Bad: raises $0.75 to $1
daisy108: folds 
dwmcc: folds 
bigdaddycmd: folds 
Uncalled bet ($0.75) returned to John_The_Bad
John_The_Bad collected $0.60 from pot
John_The_Bad: doesn't show hand 
*** SUMMARY ***
Total pot $0.60 | Rake $0 
Seat 1: John_The_Bad collected ($0.60)
Seat 2: daisy108 (button) folded before Flop (didn't bet)
Seat 3: dwmcc (small blind) folded before Flop
Seat 4: bigdaddycmd (big blind) folded before Flop
Seat 5: Le gros pic folded before Flop (didn't bet)
Seat 6: Mrinaldi folded before Flop (didn't bet)
Seat 7: Alameda22 folded before Flop (didn't bet)
Seat 8: betganij folded before Flop (didn't bet)
Seat 9: jm_mathurin folded before Flop (didn't bet)



PokerStars Game #19978096512:  Hold'em No Limit ($0.10/$0.25) - 2008/08/28 - 22:24:49 (ET)
Table 'Hippasos IV' 9-max Seat #3 is the button
Seat 1: John_The_Bad ($35.45 in chips) 
Seat 2: daisy108 ($26.35 in chips) 
Seat 3: dwmcc ($10 in chips) 
Seat 4: bigdaddycmd ($58.05 in chips) 
Seat 5: Le gros pic ($21.05 in chips) 
Seat 6: Mrinaldi ($38 in chips) 
Seat 7: Alameda22 ($20.80 in chips) 
Seat 8: betganij ($5 in chips) 
Seat 9: jm_mathurin ($25 in chips) 
bigdaddycmd: posts small blind $0.10
Le gros pic: posts big blind $0.25
*** HOLE CARDS ***
Dealt to Alameda22 [8d Th]
Mrinaldi: folds 
Alameda22: folds 
betganij: raises $0.75 to $1
jm_mathurin: folds 
John_The_Bad: folds 
daisy108: folds 
dwmcc: folds 
bigdaddycmd: calls $0.90
Le gros pic: folds 
*** FLOP *** [Jh 3d Tc]
bigdaddycmd: checks 
betganij: bets $2
bigdaddycmd: folds 
Uncalled bet ($2) returned to betganij
betganij collected $2.15 from pot
betganij: doesn't show hand 
*** SUMMARY ***
Total pot $2.25 | Rake $0.10 
Board [Jh 3d Tc]
Seat 1: John_The_Bad folded before Flop (didn't bet)
Seat 2: daisy108 folded before Flop (didn't bet)
Seat 3: dwmcc (button) folded before Flop (didn't bet)
Seat 4: bigdaddycmd (small blind) folded on the Flop
Seat 5: Le gros pic (big blind) folded before Flop
Seat 6: Mrinaldi folded before Flop (didn't bet)
Seat 7: Alameda22 folded before Flop (didn't bet)
Seat 8: betganij collected ($2.15)
Seat 9: jm_mathurin folded before Flop (didn't bet)



PokerStars Game #19978114618:  Hold'em No Limit ($0.10/$0.25) - 2008/08/28 - 22:25:40 (ET)
Table 'Hippasos IV' 9-max Seat #4 is the button
Seat 1: John_The_Bad ($35.45 in chips) 
Seat 2: daisy108 ($26.35 in chips) 
Seat 3: dwmcc ($10 in chips) 
Seat 4: bigdaddycmd ($57.05 in chips) 
Seat 5: Le gros pic ($20.80 in chips) 
Seat 6: Mrinaldi ($38 in chips) 
Seat 7: Alameda22 ($20.80 in chips) 
Seat 8: betganij ($6.15 in chips) 
Seat 9: jm_mathurin ($25 in chips) 
Le gros pic: posts small blind $0.10
Mrinaldi: posts big blind $0.25
*** HOLE CARDS ***
Dealt to Alameda22 [4d 4c]
Alameda22: folds 
betganij: raises $0.75 to $1
jm_mathurin: calls $1
John_The_Bad: folds 
daisy108: folds 
dwmcc: calls $1
bigdaddycmd: calls $1
Le gros pic: folds 
Mrinaldi: calls $0.75
*** FLOP *** [8d 6d 9c]
Mrinaldi: checks 
betganij: bets $3
jm_mathurin: folds 
dwmcc: folds 
bigdaddycmd: raises $3 to $6
Mrinaldi: folds 
betganij: calls $2.15 and is all-in
Uncalled bet ($0.85) returned to bigdaddycmd
*** TURN *** [8d 6d 9c] [3c]
*** RIVER *** [8d 6d 9c 3c] [9s]
*** SHOW DOWN ***
betganij: shows [Qh Qs] (two pair, Queens and Nines)
bigdaddycmd: mucks hand 
betganij collected $14.65 from pot
*** SUMMARY ***
Total pot $15.40 | Rake $0.75 
Board [8d 6d 9c 3c 9s]
Seat 1: John_The_Bad folded before Flop (didn't bet)
Seat 2: daisy108 folded before Flop (didn't bet)
Seat 3: dwmcc folded on the Flop
Seat 4: bigdaddycmd (button) mucked [Kd As]
Seat 5: Le gros pic (small blind) folded before Flop
Seat 6: Mrinaldi (big blind) folded on the Flop
Seat 7: Alameda22 folded before Flop (didn't bet)
Seat 8: betganij showed [Qh Qs] and won ($14.65) with two pair, Queens and Nines
Seat 9: jm_mathurin folded on the Flop



PokerStars Game #19978154987:  Hold'em No Limit ($0.10/$0.25) - 2008/08/28 - 22:27:33 (ET)
Table 'Hippasos IV' 9-max Seat #5 is the button
Seat 1: John_The_Bad ($35.45 in chips) 
Seat 2: daisy108 ($26.35 in chips) 
Seat 3: dwmcc ($9 in chips) 
Seat 4: bigdaddycmd ($50.90 in chips) 
Seat 5: Le gros pic ($20.70 in chips) 
Seat 6: Mrinaldi ($37 in chips) 
Seat 7: Alameda22 ($20.80 in chips) 
Seat 8: betganij ($14.65 in chips) 
Seat 9: jm_mathurin ($24 in chips) 
Mrinaldi: posts small blind $0.10
Alameda22: posts big blind $0.25
*** HOLE CARDS ***
Dealt to Alameda22 [Qs 9h]
betganij: folds 
jm_mathurin: raises $0.75 to $1
John_The_Bad: folds 
daisy108: folds 
dwmcc: folds 
bigdaddycmd: calls $1
Le gros pic: calls $1
Mrinaldi: folds 
Alameda22: folds 
*** FLOP *** [4h 2s Jc]
jm_mathurin: bets $1.50
bigdaddycmd: calls $1.50
Le gros pic: calls $1.50
*** TURN *** [4h 2s Jc] [6c]
jm_mathurin: bets $3
bigdaddycmd: raises $3 to $6
Le gros pic: folds 
jm_mathurin: raises $3 to $9
bigdaddycmd: calls $3
*** RIVER *** [4h 2s Jc 6c] [4d]
jm_mathurin: bets $10
bigdaddycmd: folds 
Uncalled bet ($10) returned to jm_mathurin
jm_mathurin collected $24.60 from pot
*** SUMMARY ***
Total pot $25.85 | Rake $1.25 
Board [4h 2s Jc 6c 4d]
Seat 1: John_The_Bad folded before Flop (didn't bet)
Seat 2: daisy108 folded before Flop (didn't bet)
Seat 3: dwmcc folded before Flop (didn't bet)
Seat 4: bigdaddycmd folded on the River
Seat 5: Le gros pic (button) folded on the Turn
Seat 6: Mrinaldi (small blind) folded before Flop
Seat 7: Alameda22 (big blind) folded before Flop
Seat 8: betganij folded before Flop (didn't bet)
Seat 9: jm_mathurin collected ($24.60)



PokerStars Game #19978181212:  Hold'em No Limit ($0.10/$0.25) - 2008/08/28 - 22:28:47 (ET)
Table 'Hippasos IV' 9-max Seat #6 is the button
Seat 1: John_The_Bad ($35.45 in chips) 
Seat 2: daisy108 ($26.35 in chips) 
Seat 3: dwmcc ($9 in chips) 
Seat 4: bigdaddycmd ($39.40 in chips) 
Seat 5: Le gros pic ($18.20 in chips) 
Seat 6: Mrinaldi ($36.90 in chips) 
Seat 7: Alameda22 ($20.55 in chips) 
Seat 9: jm_mathurin ($37.10 in chips) 
Alameda22: posts small blind $0.10
betganij: is sitting out 
jm_mathurin: posts big blind $0.25
*** HOLE CARDS ***
Dealt to Alameda22 [Ad 9c]
betganij leaves the table
John_The_Bad: raises $0.75 to $1
Cardini 23 joins the table at seat #8 
daisy108: folds 
dwmcc: folds 
bigdaddycmd: folds 
bigdaddycmd leaves the table
Le gros pic: folds 
Mrinaldi: folds 
Alameda22: folds 
jm_mathurin: calls $0.75
*** FLOP *** [Ts 3s Kc]
jm_mathurin: checks 
John_The_Bad: checks 
*** TURN *** [Ts 3s Kc] [4s]
jm_mathurin: checks 
John_The_Bad: checks 
*** RIVER *** [Ts 3s Kc 4s] [Ah]
jm_mathurin: checks 
John_The_Bad: bets $1.25
ctojeira joins the table at seat #4 
jm_mathurin: calls $1.25
*** SHOW DOWN ***
John_The_Bad: shows [7c 7s] (a pair of Sevens)
jm_mathurin: shows [Ac 8c] (a pair of Aces)
jm_mathurin collected $4.40 from pot
jm_mathurin is sitting out
*** SUMMARY ***
Total pot $4.60 | Rake $0.20 
Board [Ts 3s Kc 4s Ah]
Seat 1: John_The_Bad showed [7c 7s] and lost with a pair of Sevens
Seat 2: daisy108 folded before Flop (didn't bet)
Seat 3: dwmcc folded before Flop (didn't bet)
Seat 4: bigdaddycmd folded before Flop (didn't bet)
Seat 5: Le gros pic folded before Flop (didn't bet)
Seat 6: Mrinaldi (button) folded before Flop (didn't bet)
Seat 7: Alameda22 (small blind) folded before Flop
Seat 9: jm_mathurin (big blind) showed [Ac 8c] and won ($4.40) with a pair of Aces



PokerStars Game #19978199764:  Hold'em No Limit ($0.10/$0.25) - 2008/08/28 - 22:29:39 (ET)
Table 'Hippasos IV' 9-max Seat #7 is the button
Seat 2: daisy108 ($26.35 in chips) 
Seat 3: dwmcc ($9 in chips) 
Seat 5: Le gros pic ($18.20 in chips) 
Seat 6: Mrinaldi ($36.90 in chips) 
Seat 7: Alameda22 ($20.45 in chips) 
Cardini 23 will be allowed to play after the button
John_The_Bad: is sitting out 
jm_mathurin leaves the table
daisy108: posts small blind $0.10
dwmcc: posts big blind $0.25
John_The_Bad leaves the table
ctojeira is disconnected 
ctojeira is connected 
ctojeira: sits out 
*** HOLE CARDS ***
Dealt to Alameda22 [8c 3h]
Le gros pic: folds 
Mrinaldi: folds 
Alameda22: folds 
daisy108: folds 
Uncalled bet ($0.15) returned to dwmcc
dwmcc collected $0.20 from pot
dwmcc: doesn't show hand 
*** SUMMARY ***
Total pot $0.20 | Rake $0 
Seat 2: daisy108 (small blind) folded before Flop
Seat 3: dwmcc (big blind) collected ($0.20)
Seat 5: Le gros pic folded before Flop (didn't bet)
Seat 6: Mrinaldi folded before Flop (didn't bet)
Seat 7: Alameda22 (button) folded before Flop (didn't bet)



PokerStars Game #19978229196:  Hold'em No Limit ($0.10/$0.25) - 2008/08/28 - 22:31:01 (ET)
Table 'Hippasos IV' 9-max Seat #2 is the button
Seat 2: daisy108 ($26.25 in chips) 
Seat 3: dwmcc ($9.10 in chips) 
Seat 4: ctojeira ($25 in chips) 
Seat 5: Le gros pic ($18.20 in chips) 
Seat 6: Mrinaldi ($36.90 in chips) 
Seat 7: Alameda22 ($20.45 in chips) 
dwmcc: posts small blind $0.10
ctojeira is disconnected 
ctojeira is connected 
ctojeira: posts big blind $0.25
Cardini 23: sits out 
*** HOLE CARDS ***
Dealt to Alameda22 [Qs 8s]
Le gros pic: folds 
Mrinaldi: folds 
Alameda22: folds 
daisy108: folds 
dwmcc: calls $0.15
ctojeira: checks 
*** FLOP *** [3h Ah 7h]
dwmcc: checks 
ctojeira: bets $0.50
dwmcc: folds 
Uncalled bet ($0.50) returned to ctojeira
ctojeira collected $0.50 from pot
*** SUMMARY ***
Total pot $0.50 | Rake $0 
Board [3h Ah 7h]
Seat 2: daisy108 (button) folded before Flop (didn't bet)
Seat 3: dwmcc (small blind) folded on the Flop
Seat 4: ctojeira (big blind) collected ($0.50)
Seat 5: Le gros pic folded before Flop (didn't bet)
Seat 6: Mrinaldi folded before Flop (didn't bet)
Seat 7: Alameda22 folded before Flop (didn't bet)



PokerStars Game #19978251040:  Hold'em No Limit ($0.10/$0.25) - 2008/08/28 - 22:31:58 (ET)
Table 'Hippasos IV' 9-max Seat #3 is the button
Seat 2: daisy108 ($26.25 in chips) 
Seat 3: dwmcc ($8.85 in chips) 
Seat 4: ctojeira ($25.25 in chips) 
Seat 5: Le gros pic ($18.20 in chips) 
Seat 6: Mrinaldi ($36.90 in chips) 
Seat 7: Alameda22 ($20.45 in chips) 
ctojeira: posts small blind $0.10
Le gros pic: posts big blind $0.25
Cardini 23: sits out 
*** HOLE CARDS ***
Dealt to Alameda22 [8d Tc]
Mrinaldi: calls $0.25
Alameda22: folds 
daisy108: folds 
dwmcc: calls $0.25
Dj Kenny S joins the table at seat #9 
ctojeira: calls $0.15
Le gros pic: checks 
*** FLOP *** [2s Qc 4d]
ctojeira: bets $0.75
Le gros pic: folds 
Mrinaldi: folds 
dwmcc: folds 
Uncalled bet ($0.75) returned to ctojeira
gong4da joins the table at seat #1 
ctojeira collected $0.95 from pot
ctojeira: doesn't show hand 
*** SUMMARY ***
Total pot $1 | Rake $0.05 
Board [2s Qc 4d]
Seat 2: daisy108 folded before Flop (didn't bet)
Seat 3: dwmcc (button) folded on the Flop
Seat 4: ctojeira (small blind) collected ($0.95)
Seat 5: Le gros pic (big blind) folded on the Flop
Seat 6: Mrinaldi folded on the Flop
Seat 7: Alameda22 folded before Flop (didn't bet)



PokerStars Game #19978262990:  Hold'em No Limit ($0.10/$0.25) - 2008/08/28 - 22:32:29 (ET)
Table 'Hippasos IV' 9-max Seat #4 is the button
Seat 2: daisy108 ($26.25 in chips) 
Seat 3: dwmcc ($8.60 in chips) 
Seat 4: ctojeira ($25.95 in chips) 
Seat 5: Le gros pic ($17.95 in chips) 
Seat 6: Mrinaldi ($36.65 in chips) 
Seat 7: Alameda22 ($20.45 in chips) 
Le gros pic: posts small blind $0.10
Mrinaldi: posts big blind $0.25
Cardini 23: sits out 
Dj Kenny S: sits out 
gong4da: sits out 
*** HOLE CARDS ***
Dealt to Alameda22 [Ts Js]
Alameda22: folds 
daisy108: folds 
dwmcc: calls $0.25
ctojeira: folds 
Le gros pic: folds 
Mrinaldi: checks 
*** FLOP *** [8s 3d 9h]
Mrinaldi: bets $0.25
dwmcc: calls $0.25
*** TURN *** [8s 3d 9h] [4h]
Mrinaldi: bets $0.75
dwmcc: calls $0.75
*** RIVER *** [8s 3d 9h 4h] [Qd]
Mrinaldi: checks 
dwmcc: bets $1
Mrinaldi: calls $1
*** SHOW DOWN ***
dwmcc: shows [9s Jh] (a pair of Nines)
Mrinaldi: shows [Kh 9c] (a pair of Nines - King kicker)
Mrinaldi collected $4.40 from pot
*** SUMMARY ***
Total pot $4.60 | Rake $0.20 
Board [8s 3d 9h 4h Qd]
Seat 2: daisy108 folded before Flop (didn't bet)
Seat 3: dwmcc showed [9s Jh] and lost with a pair of Nines
Seat 4: ctojeira (button) folded before Flop (didn't bet)
Seat 5: Le gros pic (small blind) folded before Flop
Seat 6: Mrinaldi (big blind) showed [Kh 9c] and won ($4.40) with a pair of Nines
Seat 7: Alameda22 folded before Flop (didn't bet)



PokerStars Game #19978288108:  Hold'em No Limit ($0.10/$0.25) - 2008/08/28 - 22:33:37 (ET)
Table 'Hippasos IV' 9-max Seat #5 is the button
Seat 2: daisy108 ($26.25 in chips) 
Seat 3: dwmcc ($6.35 in chips) 
Seat 4: ctojeira ($25.95 in chips) 
Seat 5: Le gros pic ($17.85 in chips) 
Seat 6: Mrinaldi ($38.80 in chips) 
Seat 7: Alameda22 ($20.45 in chips) 
Mrinaldi: posts small blind $0.10
Alameda22: posts big blind $0.25
Cardini 23: sits out 
Dj Kenny S: sits out 
gong4da: sits out 
*** HOLE CARDS ***
Dealt to Alameda22 [8h Ts]
daisy108: folds 
dwmcc: calls $0.25
ctojeira: folds 
Le gros pic: folds 
Mrinaldi: calls $0.15
ctojeira is sitting out
Alameda22: checks 
*** FLOP *** [9d 8s Td]
Mrinaldi: bets $0.50
Alameda22: raises $1 to $1.50
dwmcc: folds 
Mrinaldi: calls $1
*** TURN *** [9d 8s Td] [Qd]
Mrinaldi: checks 
Alameda22: checks 
*** RIVER *** [9d 8s Td Qd] [Qc]
Mrinaldi: checks 
Alameda22: checks 
*** SHOW DOWN ***
Mrinaldi: shows [Kc Th] (two pair, Queens and Tens)
Alameda22: mucks hand 
Mrinaldi collected $3.60 from pot
*** SUMMARY ***
Total pot $3.75 | Rake $0.15 
Board [9d 8s Td Qd Qc]
Seat 2: daisy108 folded before Flop (didn't bet)
Seat 3: dwmcc folded on the Flop
Seat 4: ctojeira folded before Flop (didn't bet)
Seat 5: Le gros pic (button) folded before Flop (didn't bet)
Seat 6: Mrinaldi (small blind) showed [Kc Th] and won ($3.60) with two pair, Queens and Tens
Seat 7: Alameda22 (big blind) mucked [8h Ts]



PokerStars Game #19978311577:  Hold'em No Limit ($0.10/$0.25) - 2008/08/28 - 22:34:39 (ET)
Table 'Hippasos IV' 9-max Seat #6 is the button
Seat 2: daisy108 ($26.25 in chips) 
Seat 3: dwmcc ($6.10 in chips) 
Seat 5: Le gros pic ($17.85 in chips) 
Seat 6: Mrinaldi ($40.65 in chips) 
Seat 7: Alameda22 ($18.70 in chips) 
Seat 8: Cardini 23 ($25 in chips) 
Alameda22: posts small blind $0.10
ctojeira is connected 
ctojeira has returned
Cardini 23: posts big blind $0.25
Dj Kenny S: sits out 
gong4da: sits out 
*** HOLE CARDS ***
Dealt to Alameda22 [Ad Tc]
daisy108: folds 
dwmcc: folds 
Le gros pic: folds 
Mrinaldi: raises $0.50 to $0.75
Alameda22: folds 
Cardini 23: raises $1.50 to $2.25
Mrinaldi: folds 
Uncalled bet ($1.50) returned to Cardini 23
Cardini 23 collected $1.60 from pot
Cardini 23: doesn't show hand 
*** SUMMARY ***
Total pot $1.60 | Rake $0 
Seat 2: daisy108 folded before Flop (didn't bet)
Seat 3: dwmcc folded before Flop (didn't bet)
Seat 5: Le gros pic folded before Flop (didn't bet)
Seat 6: Mrinaldi (button) folded before Flop
Seat 7: Alameda22 (small blind) folded before Flop
Seat 8: Cardini 23 (big blind) collected ($1.60)



PokerStars Game #19978329476:  Hold'em No Limit ($0.10/$0.25) - 2008/08/28 - 22:35:28 (ET)
Table 'Hippasos IV' 9-max Seat #7 is the button
Seat 2: daisy108 ($26.25 in chips) 
Seat 3: dwmcc ($6.10 in chips) 
Seat 4: ctojeira ($25.95 in chips) 
Seat 5: Le gros pic ($17.85 in chips) 
Seat 6: Mrinaldi ($39.90 in chips) 
Seat 7: Alameda22 ($18.60 in chips) 
Seat 8: Cardini 23 ($25.85 in chips) 
Seat 9: Dj Kenny S ($7 in chips) 
Cardini 23: posts small blind $0.10
Dj Kenny S: posts big blind $0.25
gong4da: sits out 
*** HOLE CARDS ***
Dealt to Alameda22 [Qh Ac]
daisy108: raises $0.75 to $1
dwmcc: folds 
ctojeira: folds 
Le gros pic: folds 
Mrinaldi: folds 
Alameda22: folds 
Cardini 23: folds 
Dj Kenny S: folds 
Uncalled bet ($0.75) returned to daisy108
daisy108 collected $0.60 from pot
daisy108: doesn't show hand 
*** SUMMARY ***
Total pot $0.60 | Rake $0 
Seat 2: daisy108 collected ($0.60)
Seat 3: dwmcc folded before Flop (didn't bet)
Seat 4: ctojeira folded before Flop (didn't bet)
Seat 5: Le gros pic folded before Flop (didn't bet)
Seat 6: Mrinaldi folded before Flop (didn't bet)
Seat 7: Alameda22 (button) folded before Flop (didn't bet)
Seat 8: Cardini 23 (small blind) folded before Flop
Seat 9: Dj Kenny S (big blind) folded before Flop



PokerStars Game #19978342683:  Hold'em No Limit ($0.10/$0.25) - 2008/08/28 - 22:36:03 (ET)
Table 'Hippasos IV' 9-max Seat #8 is the button
Seat 1: gong4da ($5 in chips) 
Seat 2: daisy108 ($26.60 in chips) 
Seat 3: dwmcc ($6.10 in chips) 
Seat 4: ctojeira ($25.95 in chips) 
Seat 5: Le gros pic ($17.85 in chips) 
Seat 6: Mrinaldi ($39.90 in chips) 
Seat 7: Alameda22 ($25 in chips) 
Seat 8: Cardini 23 ($25.75 in chips) 
Seat 9: Dj Kenny S ($6.75 in chips) 
Dj Kenny S: posts small blind $0.10
gong4da: posts big blind $0.25
*** HOLE CARDS ***
Dealt to Alameda22 [Ks 3s]
daisy108: folds 
dwmcc: calls $0.25
ctojeira: raises $0.75 to $1
Le gros pic: folds 
Mrinaldi: folds 
Alameda22: folds 
Cardini 23: folds 
Dj Kenny S: folds 
gong4da: folds 
dwmcc: folds 
Uncalled bet ($0.75) returned to ctojeira
ctojeira collected $0.85 from pot
ctojeira: doesn't show hand 
*** SUMMARY ***
Total pot $0.85 | Rake $0 
Seat 1: gong4da (big blind) folded before Flop
Seat 2: daisy108 folded before Flop (didn't bet)
Seat 3: dwmcc folded before Flop
Seat 4: ctojeira collected ($0.85)
Seat 5: Le gros pic folded before Flop (didn't bet)
Seat 6: Mrinaldi folded before Flop (didn't bet)
Seat 7: Alameda22 folded before Flop (didn't bet)
Seat 8: Cardini 23 (button) folded before Flop (didn't bet)
Seat 9: Dj Kenny S (small blind) folded before Flop



PokerStars Game #19978358135:  Hold'em No Limit ($0.10/$0.25) - 2008/08/28 - 22:36:44 (ET)
Table 'Hippasos IV' 9-max Seat #9 is the button
Seat 1: gong4da ($4.75 in chips) 
Seat 2: daisy108 ($26.60 in chips) 
Seat 3: dwmcc ($5.85 in chips) 
Seat 4: ctojeira ($26.55 in chips) 
Seat 5: Le gros pic ($17.85 in chips) 
Seat 6: Mrinaldi ($39.90 in chips) 
Seat 7: Alameda22 ($25 in chips) 
Seat 8: Cardini 23 ($25.75 in chips) 
Seat 9: Dj Kenny S ($6.65 in chips) 
gong4da: posts small blind $0.10
daisy108: posts big blind $0.25
*** HOLE CARDS ***
Dealt to Alameda22 [5d 6h]
dwmcc: calls $0.25
ctojeira: folds 
Le gros pic: folds 
Mrinaldi: raises $0.50 to $0.75
Alameda22: folds 
Cardini 23: folds 
Dj Kenny S: folds 
gong4da: folds 
daisy108: folds 
dwmcc: calls $0.50
*** FLOP *** [7d Tc 5c]
dwmcc: checks 
Mrinaldi: checks 
*** TURN *** [7d Tc 5c] [4d]
dwmcc: checks 
Mrinaldi: bets $1
dwmcc: folds 
Uncalled bet ($1) returned to Mrinaldi
Mrinaldi collected $1.80 from pot
Mrinaldi: doesn't show hand 
*** SUMMARY ***
Total pot $1.85 | Rake $0.05 
Board [7d Tc 5c 4d]
Seat 1: gong4da (small blind) folded before Flop
Seat 2: daisy108 (big blind) folded before Flop
Seat 3: dwmcc folded on the Turn
Seat 4: ctojeira folded before Flop (didn't bet)
Seat 5: Le gros pic folded before Flop (didn't bet)
Seat 6: Mrinaldi collected ($1.80)
Seat 7: Alameda22 folded before Flop (didn't bet)
Seat 8: Cardini 23 folded before Flop (didn't bet)
Seat 9: Dj Kenny S (button) folded before Flop (didn't bet)



PokerStars Game #19978379513:  Hold'em No Limit ($0.10/$0.25) - 2008/08/28 - 22:37:42 (ET)
Table 'Hippasos IV' 9-max Seat #1 is the button
Seat 1: gong4da ($4.65 in chips) 
Seat 2: daisy108 ($26.35 in chips) 
Seat 3: dwmcc ($5.10 in chips) 
Seat 4: ctojeira ($26.55 in chips) 
Seat 5: Le gros pic ($17.85 in chips) 
Seat 6: Mrinaldi ($40.95 in chips) 
Seat 7: Alameda22 ($25 in chips) 
Seat 8: Cardini 23 ($25.75 in chips) 
Seat 9: Dj Kenny S ($6.65 in chips) 
daisy108: posts small blind $0.10
dwmcc: posts big blind $0.25
*** HOLE CARDS ***
Dealt to Alameda22 [Qs 2d]
ctojeira: folds 
Le gros pic: folds 
Mrinaldi: folds 
Alameda22: folds 
Cardini 23: folds 
Dj Kenny S: folds 
gong4da: raises $0.75 to $1
daisy108: folds 
dwmcc: calls $0.75
*** FLOP *** [Ks 3d 2h]
dwmcc: checks 
gong4da: checks 
*** TURN *** [Ks 3d 2h] [3h]
dwmcc: checks 
gong4da: bets $1
dwmcc: folds 
Uncalled bet ($1) returned to gong4da
gong4da collected $2 from pot
gong4da: doesn't show hand 
*** SUMMARY ***
Total pot $2.10 | Rake $0.10 
Board [Ks 3d 2h 3h]
Seat 1: gong4da (button) collected ($2)
Seat 2: daisy108 (small blind) folded before Flop
Seat 3: dwmcc (big blind) folded on the Turn
Seat 4: ctojeira folded before Flop (didn't bet)
Seat 5: Le gros pic folded before Flop (didn't bet)
Seat 6: Mrinaldi folded before Flop (didn't bet)
Seat 7: Alameda22 folded before Flop (didn't bet)
Seat 8: Cardini 23 folded before Flop (didn't bet)
Seat 9: Dj Kenny S folded before Flop (didn't bet)



PokerStars Game #19978398081:  Hold'em No Limit ($0.10/$0.25) - 2008/08/28 - 22:38:32 (ET)
Table 'Hippasos IV' 9-max Seat #2 is the button
Seat 1: gong4da ($5.65 in chips) 
Seat 2: daisy108 ($26.25 in chips) 
Seat 3: dwmcc ($4.10 in chips) 
Seat 4: ctojeira ($26.55 in chips) 
Seat 5: Le gros pic ($17.85 in chips) 
Seat 6: Mrinaldi ($40.95 in chips) 
Seat 7: Alameda22 ($25 in chips) 
Seat 8: Cardini 23 ($25.75 in chips) 
Seat 9: Dj Kenny S ($6.65 in chips) 
dwmcc: posts small blind $0.10
ctojeira: posts big blind $0.25
*** HOLE CARDS ***
Dealt to Alameda22 [Kd 5c]
Le gros pic: folds 
Mrinaldi: folds 
Alameda22: folds 
Cardini 23: folds 
Dj Kenny S: calls $0.25
gong4da: folds 
daisy108: raises $0.50 to $0.75
dwmcc: folds 
ctojeira: calls $0.50
Dj Kenny S: calls $0.50
*** FLOP *** [Td 2s 3s]
ctojeira: checks 
Dj Kenny S: bets $1
daisy108: folds 
ctojeira: folds 
Uncalled bet ($1) returned to Dj Kenny S
Dj Kenny S collected $2.25 from pot
*** SUMMARY ***
Total pot $2.35 | Rake $0.10 
Board [Td 2s 3s]
Seat 1: gong4da folded before Flop (didn't bet)
Seat 2: daisy108 (button) folded on the Flop
Seat 3: dwmcc (small blind) folded before Flop
Seat 4: ctojeira (big blind) folded on the Flop
Seat 5: Le gros pic folded before Flop (didn't bet)
Seat 6: Mrinaldi folded before Flop (didn't bet)
Seat 7: Alameda22 folded before Flop (didn't bet)
Seat 8: Cardini 23 folded before Flop (didn't bet)
Seat 9: Dj Kenny S collected ($2.25)



PokerStars Game #19978425247:  Hold'em No Limit ($0.10/$0.25) - 2008/08/28 - 22:39:45 (ET)
Table 'Hippasos IV' 9-max Seat #3 is the button
Seat 1: gong4da ($5.65 in chips) 
Seat 2: daisy108 ($25.50 in chips) 
Seat 3: dwmcc ($4 in chips) 
Seat 4: ctojeira ($25.80 in chips) 
Seat 5: Le gros pic ($17.85 in chips) 
Seat 6: Mrinaldi ($40.95 in chips) 
Seat 7: Alameda22 ($25 in chips) 
Seat 8: Cardini 23 ($25.75 in chips) 
Seat 9: Dj Kenny S ($8.15 in chips) 
ctojeira: posts small blind $0.10
Le gros pic: posts big blind $0.25
*** HOLE CARDS ***
Dealt to Alameda22 [Th Ad]
Mrinaldi: calls $0.25
Alameda22: folds 
Cardini 23: folds 
Dj Kenny S: folds 
gong4da: folds 
daisy108: folds 
dwmcc: calls $0.25
ctojeira: calls $0.15
Le gros pic: checks 
*** FLOP *** [4h 8s 8c]
ctojeira: checks 
Le gros pic: checks 
Mrinaldi: bets $1
dwmcc: folds 
ctojeira: folds 
Le gros pic: folds 
Uncalled bet ($1) returned to Mrinaldi
Mrinaldi collected $0.95 from pot
Mrinaldi: doesn't show hand 
*** SUMMARY ***
Total pot $1 | Rake $0.05 
Board [4h 8s 8c]
Seat 1: gong4da folded before Flop (didn't bet)
Seat 2: daisy108 folded before Flop (didn't bet)
Seat 3: dwmcc (button) folded on the Flop
Seat 4: ctojeira (small blind) folded on the Flop
Seat 5: Le gros pic (big blind) folded on the Flop
Seat 6: Mrinaldi collected ($0.95)
Seat 7: Alameda22 folded before Flop (didn't bet)
Seat 8: Cardini 23 folded before Flop (didn't bet)
Seat 9: Dj Kenny S folded before Flop (didn't bet)



PokerStars Game #19978446386:  Hold'em No Limit ($0.10/$0.25) - 2008/08/28 - 22:40:40 (ET)
Table 'Hippasos IV' 9-max Seat #4 is the button
Seat 1: gong4da ($5.65 in chips) 
Seat 2: daisy108 ($25.50 in chips) 
Seat 3: dwmcc ($3.75 in chips) 
Seat 4: ctojeira ($25.55 in chips) 
Seat 5: Le gros pic ($17.60 in chips) 
Seat 6: Mrinaldi ($41.65 in chips) 
Seat 7: Alameda22 ($25 in chips) 
Seat 8: Cardini 23 ($25.75 in chips) 
Seat 9: Dj Kenny S ($8.15 in chips) 
Le gros pic: posts small blind $0.10
Mrinaldi: posts big blind $0.25
*** HOLE CARDS ***
Dealt to Alameda22 [5d 7d]
Alameda22: folds 
Cardini 23: folds 
Dj Kenny S: calls $0.25
gong4da: folds 
daisy108: folds 
dwmcc: calls $0.25
ctojeira: folds 
Le gros pic: calls $0.15
Mrinaldi: checks 
*** FLOP *** [Js 3h 2c]
Le gros pic: checks 
Mrinaldi: checks 
Dj Kenny S: checks 
dwmcc: checks 
*** TURN *** [Js 3h 2c] [Qc]
Le gros pic: bets $1
Mrinaldi: raises $1.25 to $2.25
Dj Kenny S: folds 
dwmcc: folds 
Le gros pic: raises $1.25 to $3.50
Mrinaldi: calls $1.25
*** RIVER *** [Js 3h 2c Qc] [2s]
Le gros pic: bets $2.50
Mrinaldi: folds 
Uncalled bet ($2.50) returned to Le gros pic
Le gros pic collected $7.65 from pot
Le gros pic: doesn't show hand 
*** SUMMARY ***
Total pot $8 | Rake $0.35 
Board [Js 3h 2c Qc 2s]
Seat 1: gong4da folded before Flop (didn't bet)
Seat 2: daisy108 folded before Flop (didn't bet)
Seat 3: dwmcc folded on the Turn
Seat 4: ctojeira (button) folded before Flop (didn't bet)
Seat 5: Le gros pic (small blind) collected ($7.65)
Seat 6: Mrinaldi (big blind) folded on the River
Seat 7: Alameda22 folded before Flop (didn't bet)
Seat 8: Cardini 23 folded before Flop (didn't bet)
Seat 9: Dj Kenny S folded on the Turn



PokerStars Game #19978475617:  Hold'em No Limit ($0.10/$0.25) - 2008/08/28 - 22:41:59 (ET)
Table 'Hippasos IV' 9-max Seat #5 is the button
Seat 1: gong4da ($5.65 in chips) 
Seat 2: daisy108 ($25.50 in chips) 
Seat 3: dwmcc ($3.50 in chips) 
Seat 4: ctojeira ($25.55 in chips) 
Seat 5: Le gros pic ($21.50 in chips) 
Seat 6: Mrinaldi ($37.90 in chips) 
Seat 7: Alameda22 ($25 in chips) 
Seat 8: Cardini 23 ($25.75 in chips) 
Seat 9: Dj Kenny S ($7.90 in chips) 
Mrinaldi: posts small blind $0.10
Alameda22: posts big blind $0.25
*** HOLE CARDS ***
Dealt to Alameda22 [5h Kc]
Cardini 23: folds 
Dj Kenny S: folds 
gong4da: folds 
daisy108: folds 
dwmcc: raises $1 to $1.25
ctojeira: folds 
Le gros pic: folds 
Mrinaldi: calls $1.15
Alameda22: folds 
*** FLOP *** [2d Ah 8d]
Mrinaldi: checks 
dwmcc: bets $1.25
Mrinaldi: raises $1.25 to $2.50
dwmcc: calls $1 and is all-in
Uncalled bet ($0.25) returned to Mrinaldi
*** TURN *** [2d Ah 8d] [Jc]
*** RIVER *** [2d Ah 8d Jc] [4d]
*** SHOW DOWN ***
Mrinaldi: shows [Ts Ac] (a pair of Aces)
dwmcc: mucks hand 
Mrinaldi collected $6.90 from pot
dwmcc leaves the table
*** SUMMARY ***
Total pot $7.25 | Rake $0.35 
Board [2d Ah 8d Jc 4d]
Seat 1: gong4da folded before Flop (didn't bet)
Seat 2: daisy108 folded before Flop (didn't bet)
Seat 3: dwmcc mucked [9h 9d]
Seat 4: ctojeira folded before Flop (didn't bet)
Seat 5: Le gros pic (button) folded before Flop (didn't bet)
Seat 6: Mrinaldi (small blind) showed [Ts Ac] and won ($6.90) with a pair of Aces
Seat 7: Alameda22 (big blind) folded before Flop
Seat 8: Cardini 23 folded before Flop (didn't bet)
Seat 9: Dj Kenny S folded before Flop (didn't bet)



PokerStars Game #19978494155:  Hold'em No Limit ($0.10/$0.25) - 2008/08/28 - 22:42:49 (ET)
Table 'Hippasos IV' 9-max Seat #6 is the button
Seat 1: gong4da ($5.65 in chips) 
Seat 2: daisy108 ($25.50 in chips) 
Seat 4: ctojeira ($25.55 in chips) 
Seat 5: Le gros pic ($21.50 in chips) 
Seat 6: Mrinaldi ($41.30 in chips) 
Seat 7: Alameda22 ($24.75 in chips) 
Seat 8: Cardini 23 ($25.75 in chips) 
Seat 9: Dj Kenny S ($7.90 in chips) 
Alameda22: posts small blind $0.10
Cardini 23: posts big blind $0.25
*** HOLE CARDS ***
Dealt to Alameda22 [8s 5s]
Dj Kenny S: folds 
gong4da: folds 
daisy108: folds 
ctojeira: folds 
Le gros pic: folds 
Mrinaldi: folds 
Alameda22: folds 
Uncalled bet ($0.15) returned to Cardini 23
Cardini 23 collected $0.20 from pot
Cardini 23: doesn't show hand 
*** SUMMARY ***
Total pot $0.20 | Rake $0 
Seat 1: gong4da folded before Flop (didn't bet)
Seat 2: daisy108 folded before Flop (didn't bet)
Seat 4: ctojeira folded before Flop (didn't bet)
Seat 5: Le gros pic folded before Flop (didn't bet)
Seat 6: Mrinaldi (button) folded before Flop (didn't bet)
Seat 7: Alameda22 (small blind) folded before Flop
Seat 8: Cardini 23 (big blind) collected ($0.20)
Seat 9: Dj Kenny S folded before Flop (didn't bet)



PokerStars Game #19978505197:  Hold'em No Limit ($0.10/$0.25) - 2008/08/28 - 22:43:20 (ET)
Table 'Hippasos IV' 9-max Seat #7 is the button
Seat 1: gong4da ($5.65 in chips) 
Seat 2: daisy108 ($25.50 in chips) 
Seat 4: ctojeira ($25.55 in chips) 
Seat 5: Le gros pic ($21.50 in chips) 
Seat 6: Mrinaldi ($41.30 in chips) 
Seat 7: Alameda22 ($24.65 in chips) 
Seat 8: Cardini 23 ($25.85 in chips) 
Seat 9: Dj Kenny S ($7.90 in chips) 
Cardini 23: posts small blind $0.10
Dj Kenny S: posts big blind $0.25
*** HOLE CARDS ***
Dealt to Alameda22 [8s 9s]
gong4da: folds 
daisy108: folds 
ctojeira: folds 
Le gros pic: folds 
Mrinaldi: folds 
Alameda22: raises $0.50 to $0.75
Cardini 23: folds 
Dj Kenny S: folds 
Uncalled bet ($0.50) returned to Alameda22
Alameda22 collected $0.60 from pot
Alameda22: doesn't show hand 
*** SUMMARY ***
Total pot $0.60 | Rake $0 
Seat 1: gong4da folded before Flop (didn't bet)
Seat 2: daisy108 folded before Flop (didn't bet)
Seat 4: ctojeira folded before Flop (didn't bet)
Seat 5: Le gros pic folded before Flop (didn't bet)
Seat 6: Mrinaldi folded before Flop (didn't bet)
Seat 7: Alameda22 (button) collected ($0.60)
Seat 8: Cardini 23 (small blind) folded before Flop
Seat 9: Dj Kenny S (big blind) folded before Flop



PokerStars Game #19978517376:  Hold'em No Limit ($0.10/$0.25) - 2008/08/28 - 22:43:54 (ET)
Table 'Hippasos IV' 9-max Seat #8 is the button
Seat 1: gong4da ($5.65 in chips) 
Seat 2: daisy108 ($25.50 in chips) 
Seat 4: ctojeira ($25.55 in chips) 
Seat 5: Le gros pic ($21.50 in chips) 
Seat 6: Mrinaldi ($41.30 in chips) 
Seat 7: Alameda22 ($25 in chips) 
Seat 8: Cardini 23 ($25.75 in chips) 
Seat 9: Dj Kenny S ($7.65 in chips) 
Dj Kenny S: posts small blind $0.10
gong4da: posts big blind $0.25
*** HOLE CARDS ***
Dealt to Alameda22 [9d 3d]
daisy108: folds 
ctojeira: folds 
Le gros pic: folds 
Mrinaldi: raises $0.50 to $0.75
Alameda22: folds 
Cardini 23: folds 
Dj Kenny S: calls $0.65
gong4da: folds 
*** FLOP *** [5h 4s 8h]
Dj Kenny S: checks 
Mrinaldi: bets $0.75
Dj Kenny S: folds 
Uncalled bet ($0.75) returned to Mrinaldi
Mrinaldi collected $1.70 from pot
Mrinaldi: doesn't show hand 
*** SUMMARY ***
Total pot $1.75 | Rake $0.05 
Board [5h 4s 8h]
Seat 1: gong4da (big blind) folded before Flop
Seat 2: daisy108 folded before Flop (didn't bet)
Seat 4: ctojeira folded before Flop (didn't bet)
Seat 5: Le gros pic folded before Flop (didn't bet)
Seat 6: Mrinaldi collected ($1.70)
Seat 7: Alameda22 folded before Flop (didn't bet)
Seat 8: Cardini 23 (button) folded before Flop (didn't bet)
Seat 9: Dj Kenny S (small blind) folded on the Flop



PokerStars Game #19978538936:  Hold'em No Limit ($0.10/$0.25) - 2008/08/28 - 22:44:53 (ET)
Table 'Hippasos IV' 9-max Seat #9 is the button
Seat 1: gong4da ($5.40 in chips) 
Seat 2: daisy108 ($25.50 in chips) 
Seat 4: ctojeira ($25.55 in chips) 
Seat 5: Le gros pic ($21.50 in chips) 
Seat 6: Mrinaldi ($42.25 in chips) 
Seat 7: Alameda22 ($25 in chips) 
Seat 8: Cardini 23 ($25.75 in chips) 
Seat 9: Dj Kenny S ($6.90 in chips) 
gong4da: posts small blind $0.10
daisy108: posts big blind $0.25
*** HOLE CARDS ***
Dealt to Alameda22 [4h 9d]
ctojeira: folds 
Le gros pic: folds 
Mrinaldi: raises $0.50 to $0.75
Alameda22: folds 
Cardini 23: folds 
Dj Kenny S: folds 
gong4da: folds 
daisy108: folds 
Uncalled bet ($0.50) returned to Mrinaldi
][MPACKING$$ joins the table at seat #3 
Mrinaldi collected $0.60 from pot
Mrinaldi: doesn't show hand 
*** SUMMARY ***
Total pot $0.60 | Rake $0 
Seat 1: gong4da (small blind) folded before Flop
Seat 2: daisy108 (big blind) folded before Flop
Seat 4: ctojeira folded before Flop (didn't bet)
Seat 5: Le gros pic folded before Flop (didn't bet)
Seat 6: Mrinaldi collected ($0.60)
Seat 7: Alameda22 folded before Flop (didn't bet)
Seat 8: Cardini 23 folded before Flop (didn't bet)
Seat 9: Dj Kenny S (button) folded before Flop (didn't bet)



PokerStars Game #19978559704:  Hold'em No Limit ($0.10/$0.25) - 2008/08/28 - 22:45:51 (ET)
Table 'Hippasos IV' 9-max Seat #1 is the button
Seat 1: gong4da ($5.30 in chips) 
Seat 2: daisy108 ($25.25 in chips) 
Seat 3: ][MPACKING$$ ($15 in chips) 
Seat 4: ctojeira ($25.55 in chips) 
Seat 5: Le gros pic ($21.50 in chips) 
Seat 6: Mrinaldi ($42.60 in chips) 
Seat 7: Alameda22 ($25 in chips) 
Seat 8: Cardini 23 ($25.75 in chips) 
Seat 9: Dj Kenny S ($6.90 in chips) 
daisy108: posts small blind $0.10
][MPACKING$$: posts big blind $0.25
*** HOLE CARDS ***
Dealt to Alameda22 [7s 8c]
ctojeira: folds 
Le gros pic: folds 
Mrinaldi: folds 
Alameda22: folds 
Cardini 23: folds 
Dj Kenny S: folds 
gong4da: raises $0.75 to $1
daisy108: folds 
][MPACKING$$: folds 
Uncalled bet ($0.75) returned to gong4da
gong4da collected $0.60 from pot
gong4da: doesn't show hand 
*** SUMMARY ***
Total pot $0.60 | Rake $0 
Seat 1: gong4da (button) collected ($0.60)
Seat 2: daisy108 (small blind) folded before Flop
Seat 3: ][MPACKING$$ (big blind) folded before Flop
Seat 4: ctojeira folded before Flop (didn't bet)
Seat 5: Le gros pic folded before Flop (didn't bet)
Seat 6: Mrinaldi folded before Flop (didn't bet)
Seat 7: Alameda22 folded before Flop (didn't bet)
Seat 8: Cardini 23 folded before Flop (didn't bet)
Seat 9: Dj Kenny S folded before Flop (didn't bet)



PokerStars Game #19978572034:  Hold'em No Limit ($0.10/$0.25) - 2008/08/28 - 22:46:26 (ET)
Table 'Hippasos IV' 9-max Seat #2 is the button
Seat 1: gong4da ($5.65 in chips) 
Seat 2: daisy108 ($25.15 in chips) 
Seat 3: ][MPACKING$$ ($14.75 in chips) 
Seat 4: ctojeira ($25.55 in chips) 
Seat 5: Le gros pic ($21.50 in chips) 
Seat 6: Mrinaldi ($42.60 in chips) 
Seat 7: Alameda22 ($25 in chips) 
Seat 8: Cardini 23 ($25.75 in chips) 
Seat 9: Dj Kenny S ($6.90 in chips) 
][MPACKING$$: posts small blind $0.10
ctojeira: posts big blind $0.25
*** HOLE CARDS ***
Dealt to Alameda22 [9h 9s]
Le gros pic: raises $0.50 to $0.75
Mrinaldi: folds 
Alameda22: calls $0.75
Cardini 23: calls $0.75
Dj Kenny S: folds 
gong4da: folds 
daisy108: folds 
][MPACKING$$: calls $0.65
ctojeira: calls $0.50
*** FLOP *** [Qc Td 7d]
][MPACKING$$: checks 
ctojeira: checks 
Le gros pic: bets $0.75
Alameda22: folds 
Cardini 23: folds 
][MPACKING$$: calls $0.75
ctojeira: folds 
*** TURN *** [Qc Td 7d] [Ts]
][MPACKING$$: checks 
Le gros pic: bets $1.75
][MPACKING$$: calls $1.75
*** RIVER *** [Qc Td 7d Ts] [7c]
][MPACKING$$: checks 
Le gros pic: bets $2.75
][MPACKING$$: folds 
Uncalled bet ($2.75) returned to Le gros pic
Le gros pic collected $8.35 from pot
Le gros pic: doesn't show hand 
*** SUMMARY ***
Total pot $8.75 | Rake $0.40 
Board [Qc Td 7d Ts 7c]
Seat 1: gong4da folded before Flop (didn't bet)
Seat 2: daisy108 (button) folded before Flop (didn't bet)
Seat 3: ][MPACKING$$ (small blind) folded on the River
Seat 4: ctojeira (big blind) folded on the Flop
Seat 5: Le gros pic collected ($8.35)
Seat 6: Mrinaldi folded before Flop (didn't bet)
Seat 7: Alameda22 folded on the Flop
Seat 8: Cardini 23 folded on the Flop
Seat 9: Dj Kenny S folded before Flop (didn't bet)



PokerStars Game #19978601232:  Hold'em No Limit ($0.10/$0.25) - 2008/08/28 - 22:47:48 (ET)
Table 'Hippasos IV' 9-max Seat #3 is the button
Seat 1: gong4da ($5.65 in chips) 
Seat 2: daisy108 ($25.15 in chips) 
Seat 3: ][MPACKING$$ ($11.50 in chips) 
Seat 4: ctojeira ($24.80 in chips) 
Seat 5: Le gros pic ($26.60 in chips) 
Seat 6: Mrinaldi ($42.60 in chips) 
Seat 7: Alameda22 ($24.25 in chips) 
Seat 8: Cardini 23 ($25 in chips) 
Seat 9: Dj Kenny S ($6.90 in chips) 
ctojeira: posts small blind $0.10
Le gros pic: posts big blind $0.25
*** HOLE CARDS ***
Dealt to Alameda22 [Qh 3d]
Mrinaldi: folds 
Alameda22: folds 
Cardini 23: folds 
Dj Kenny S: folds 
gong4da: folds 
daisy108 is disconnected 
daisy108 is connected 
daisy108: folds 
][MPACKING$$: folds 
ctojeira: calls $0.15
Le gros pic: checks 
*** FLOP *** [Qc 8h 6s]
ctojeira: bets $0.50
Le gros pic: folds 
Uncalled bet ($0.50) returned to ctojeira
ctojeira collected $0.50 from pot
ctojeira: doesn't show hand 
*** SUMMARY ***
Total pot $0.50 | Rake $0 
Board [Qc 8h 6s]
Seat 1: gong4da folded before Flop (didn't bet)
Seat 2: daisy108 folded before Flop (didn't bet)
Seat 3: ][MPACKING$$ (button) folded before Flop (didn't bet)
Seat 4: ctojeira (small blind) collected ($0.50)
Seat 5: Le gros pic (big blind) folded on the Flop
Seat 6: Mrinaldi folded before Flop (didn't bet)
Seat 7: Alameda22 folded before Flop (didn't bet)
Seat 8: Cardini 23 folded before Flop (didn't bet)
Seat 9: Dj Kenny S folded before Flop (didn't bet)



PokerStars Game #19978628328:  Hold'em No Limit ($0.10/$0.25) - 2008/08/28 - 22:49:04 (ET)
Table 'Hippasos IV' 9-max Seat #4 is the button
Seat 1: gong4da ($5.65 in chips) 
Seat 2: daisy108 ($25.15 in chips) 
Seat 3: ][MPACKING$$ ($11.50 in chips) 
Seat 4: ctojeira ($25.05 in chips) 
Seat 5: Le gros pic ($26.35 in chips) 
Seat 6: Mrinaldi ($42.60 in chips) 
Seat 7: Alameda22 ($24.25 in chips) 
Seat 8: Cardini 23 ($25 in chips) 
Seat 9: Dj Kenny S ($6.90 in chips) 
Le gros pic: posts small blind $0.10
Mrinaldi: posts big blind $0.25
*** HOLE CARDS ***
Dealt to Alameda22 [6h Td]
Alameda22: folds 
Cardini 23: folds 
Dj Kenny S: folds 
gong4da: folds 
daisy108: folds 
][MPACKING$$: raises $0.75 to $1
ctojeira: folds 
Le gros pic: folds 
Mrinaldi: folds 
Uncalled bet ($0.75) returned to ][MPACKING$$
][MPACKING$$ collected $0.60 from pot
][MPACKING$$: doesn't show hand 
*** SUMMARY ***
Total pot $0.60 | Rake $0 
Seat 1: gong4da folded before Flop (didn't bet)
Seat 2: daisy108 folded before Flop (didn't bet)
Seat 3: ][MPACKING$$ collected ($0.60)
Seat 4: ctojeira (button) folded before Flop (didn't bet)
Seat 5: Le gros pic (small blind) folded before Flop
Seat 6: Mrinaldi (big blind) folded before Flop
Seat 7: Alameda22 folded before Flop (didn't bet)
Seat 8: Cardini 23 folded before Flop (didn't bet)
Seat 9: Dj Kenny S folded before Flop (didn't bet)



PokerStars Game #19978638002:  Hold'em No Limit ($0.10/$0.25) - 2008/08/28 - 22:49:33 (ET)
Table 'Hippasos IV' 9-max Seat #5 is the button
Seat 1: gong4da ($5.65 in chips) 
Seat 2: daisy108 ($25.15 in chips) 
Seat 3: ][MPACKING$$ ($11.85 in chips) 
Seat 4: ctojeira ($25.05 in chips) 
Seat 5: Le gros pic ($26.25 in chips) 
Seat 6: Mrinaldi ($42.35 in chips) 
Seat 7: Alameda22 ($24.25 in chips) 
Seat 8: Cardini 23 ($25 in chips) 
Seat 9: Dj Kenny S ($6.90 in chips) 
Mrinaldi: posts small blind $0.10
Alameda22: posts big blind $0.25
*** HOLE CARDS ***
Dealt to Alameda22 [3c 8s]
Cardini 23: folds 
Dj Kenny S: calls $0.25
gong4da: folds 
daisy108: folds 
][MPACKING$$: raises $0.25 to $0.50
ctojeira: folds 
Le gros pic: folds 
Mrinaldi: folds 
Alameda22: folds 
Dj Kenny S: calls $0.25
*** FLOP *** [6h 5h 9d]
Dj Kenny S: checks 
][MPACKING$$: checks 
*** TURN *** [6h 5h 9d] [Tc]
Dj Kenny S: checks 
][MPACKING$$: checks 
*** RIVER *** [6h 5h 9d Tc] [8d]
Dj Kenny S: checks 
][MPACKING$$: bets $0.25
Dj Kenny S: folds 
Uncalled bet ($0.25) returned to ][MPACKING$$
][MPACKING$$ collected $1.30 from pot
][MPACKING$$: doesn't show hand 
*** SUMMARY ***
Total pot $1.35 | Rake $0.05 
Board [6h 5h 9d Tc 8d]
Seat 1: gong4da folded before Flop (didn't bet)
Seat 2: daisy108 folded before Flop (didn't bet)
Seat 3: ][MPACKING$$ collected ($1.30)
Seat 4: ctojeira folded before Flop (didn't bet)
Seat 5: Le gros pic (button) folded before Flop (didn't bet)
Seat 6: Mrinaldi (small blind) folded before Flop
Seat 7: Alameda22 (big blind) folded before Flop
Seat 8: Cardini 23 folded before Flop (didn't bet)
Seat 9: Dj Kenny S folded on the River



PokerStars Game #19978659567:  Hold'em No Limit ($0.10/$0.25) - 2008/08/28 - 22:50:31 (ET)
Table 'Hippasos IV' 9-max Seat #6 is the button
Seat 1: gong4da ($5.65 in chips) 
Seat 2: daisy108 ($25.15 in chips) 
Seat 3: ][MPACKING$$ ($12.65 in chips) 
Seat 4: ctojeira ($25.05 in chips) 
Seat 5: Le gros pic ($26.25 in chips) 
Seat 6: Mrinaldi ($42.25 in chips) 
Seat 7: Alameda22 ($24 in chips) 
Seat 8: Cardini 23 ($25 in chips) 
Seat 9: Dj Kenny S ($6.40 in chips) 
Alameda22: posts small blind $0.10
Cardini 23: posts big blind $0.25
*** HOLE CARDS ***
Dealt to Alameda22 [Kc Jc]
Dj Kenny S: calls $0.25
gong4da: folds 
daisy108: folds 
][MPACKING$$: folds 
ctojeira: raises $0.75 to $1
Le gros pic: folds 
Mrinaldi: folds 
Alameda22: folds 
Cardini 23: folds 
Dj Kenny S: calls $0.75
*** FLOP *** [Qh As 3c]
Dj Kenny S: bets $1
ctojeira: folds 
Uncalled bet ($1) returned to Dj Kenny S
Dj Kenny S collected $2.25 from pot
*** SUMMARY ***
Total pot $2.35 | Rake $0.10 
Board [Qh As 3c]
Seat 1: gong4da folded before Flop (didn't bet)
Seat 2: daisy108 folded before Flop (didn't bet)
Seat 3: ][MPACKING$$ folded before Flop (didn't bet)
Seat 4: ctojeira folded on the Flop
Seat 5: Le gros pic folded before Flop (didn't bet)
Seat 6: Mrinaldi (button) folded before Flop (didn't bet)
Seat 7: Alameda22 (small blind) folded before Flop
Seat 8: Cardini 23 (big blind) folded before Flop
Seat 9: Dj Kenny S collected ($2.25)



PokerStars Game #19978678626:  Hold'em No Limit ($0.10/$0.25) - 2008/08/28 - 22:51:24 (ET)
Table 'Hippasos IV' 9-max Seat #7 is the button
Seat 1: gong4da ($5.65 in chips) 
Seat 2: daisy108 ($25.15 in chips) 
Seat 3: ][MPACKING$$ ($12.65 in chips) 
Seat 4: ctojeira ($24.05 in chips) 
Seat 5: Le gros pic ($26.25 in chips) 
Seat 6: Mrinaldi ($42.25 in chips) 
Seat 7: Alameda22 ($23.90 in chips) 
Seat 8: Cardini 23 ($24.75 in chips) 
Seat 9: Dj Kenny S ($7.65 in chips) 
Cardini 23: posts small blind $0.10
Dj Kenny S: posts big blind $0.25
*** HOLE CARDS ***
Dealt to Alameda22 [2s Qc]
gong4da: folds 
daisy108: folds 
][MPACKING$$ is disconnected 
][MPACKING$$ has timed out while disconnected
][MPACKING$$: folds 
][MPACKING$$ is sitting out
ctojeira: folds 
Le gros pic: folds 
Mrinaldi: raises $0.50 to $0.75
Alameda22: folds 
Cardini 23: folds 
Dj Kenny S: folds 
Uncalled bet ($0.50) returned to Mrinaldi
Mrinaldi collected $0.60 from pot
Mrinaldi: doesn't show hand 
*** SUMMARY ***
Total pot $0.60 | Rake $0 
Seat 1: gong4da folded before Flop (didn't bet)
Seat 2: daisy108 folded before Flop (didn't bet)
Seat 3: ][MPACKING$$ folded before Flop (didn't bet)
Seat 4: ctojeira folded before Flop (didn't bet)
Seat 5: Le gros pic folded before Flop (didn't bet)
Seat 6: Mrinaldi collected ($0.60)
Seat 7: Alameda22 (button) folded before Flop (didn't bet)
Seat 8: Cardini 23 (small blind) folded before Flop
Seat 9: Dj Kenny S (big blind) folded before Flop



PokerStars Game #19978699803:  Hold'em No Limit ($0.10/$0.25) - 2008/08/28 - 22:52:23 (ET)
Table 'Hippasos IV' 9-max Seat #8 is the button
Seat 1: gong4da ($5.65 in chips) 
Seat 2: daisy108 ($25.15 in chips) 
Seat 4: ctojeira ($24.05 in chips) 
Seat 5: Le gros pic ($26.25 in chips) 
Seat 6: Mrinaldi ($42.60 in chips) 
Seat 7: Alameda22 ($23.90 in chips) 
Seat 8: Cardini 23 ($24.65 in chips) 
Seat 9: Dj Kenny S ($7.40 in chips) 
Dj Kenny S: posts small blind $0.10
gong4da: posts big blind $0.25
*** HOLE CARDS ***
Dealt to Alameda22 [Td 5c]
daisy108: folds 
ctojeira: raises $0.50 to $0.75
Le gros pic: folds 
Mrinaldi: folds 
Alameda22: folds 
Cardini 23: folds 
Dj Kenny S: folds 
gong4da: folds 
Uncalled bet ($0.50) returned to ctojeira
ctojeira collected $0.60 from pot
ctojeira: doesn't show hand 
*** SUMMARY ***
Total pot $0.60 | Rake $0 
Seat 1: gong4da (big blind) folded before Flop
Seat 2: daisy108 folded before Flop (didn't bet)
Seat 4: ctojeira collected ($0.60)
Seat 5: Le gros pic folded before Flop (didn't bet)
Seat 6: Mrinaldi folded before Flop (didn't bet)
Seat 7: Alameda22 folded before Flop (didn't bet)
Seat 8: Cardini 23 (button) folded before Flop (didn't bet)
Seat 9: Dj Kenny S (small blind) folded before Flop



PokerStars Game #19978709855:  Hold'em No Limit ($0.10/$0.25) - 2008/08/28 - 22:52:51 (ET)
Table 'Hippasos IV' 9-max Seat #9 is the button
Seat 1: gong4da ($5.40 in chips) 
Seat 2: daisy108 ($25.15 in chips) 
Seat 4: ctojeira ($24.40 in chips) 
Seat 5: Le gros pic ($26.25 in chips) 
Seat 6: Mrinaldi ($42.60 in chips) 
Seat 7: Alameda22 ($23.90 in chips) 
Seat 8: Cardini 23 ($24.65 in chips) 
Seat 9: Dj Kenny S ($7.30 in chips) 
gong4da: posts small blind $0.10
daisy108: posts big blind $0.25
*** HOLE CARDS ***
Dealt to Alameda22 [Qd 4s]
ctojeira: folds 
Le gros pic: folds 
Mrinaldi: folds 
Alameda22: folds 
Cardini 23: folds 
Dj Kenny S: folds 
gong4da: folds 
Uncalled bet ($0.15) returned to daisy108
daisy108 collected $0.20 from pot
daisy108: doesn't show hand 
*** SUMMARY ***
Total pot $0.20 | Rake $0 
Seat 1: gong4da (small blind) folded before Flop
Seat 2: daisy108 (big blind) collected ($0.20)
Seat 4: ctojeira folded before Flop (didn't bet)
Seat 5: Le gros pic folded before Flop (didn't bet)
Seat 6: Mrinaldi folded before Flop (didn't bet)
Seat 7: Alameda22 folded before Flop (didn't bet)
Seat 8: Cardini 23 folded before Flop (didn't bet)
Seat 9: Dj Kenny S (button) folded before Flop (didn't bet)



PokerStars Game #19978717824:  Hold'em No Limit ($0.10/$0.25) - 2008/08/28 - 22:53:14 (ET)
Table 'Hippasos IV' 9-max Seat #1 is the button
Seat 1: gong4da ($5.30 in chips) 
Seat 2: daisy108 ($25.25 in chips) 
Seat 4: ctojeira ($24.40 in chips) 
Seat 5: Le gros pic ($26.25 in chips) 
Seat 6: Mrinaldi ($42.60 in chips) 
Seat 7: Alameda22 ($23.90 in chips) 
Seat 8: Cardini 23 ($24.65 in chips) 
Seat 9: Dj Kenny S ($7.30 in chips) 
daisy108: posts small blind $0.10
ctojeira: posts big blind $0.25
*** HOLE CARDS ***
Dealt to Alameda22 [Tc 7h]
Le gros pic: folds 
Mrinaldi: folds 
Alameda22: folds 
Cardini 23: folds 
Dj Kenny S: folds 
gong4da: folds 
daisy108: folds 
Uncalled bet ($0.15) returned to ctojeira
ctojeira collected $0.20 from pot
ctojeira: doesn't show hand 
*** SUMMARY ***
Total pot $0.20 | Rake $0 
Seat 1: gong4da (button) folded before Flop (didn't bet)
Seat 2: daisy108 (small blind) folded before Flop
Seat 4: ctojeira (big blind) collected ($0.20)
Seat 5: Le gros pic folded before Flop (didn't bet)
Seat 6: Mrinaldi folded before Flop (didn't bet)
Seat 7: Alameda22 folded before Flop (didn't bet)
Seat 8: Cardini 23 folded before Flop (didn't bet)
Seat 9: Dj Kenny S folded before Flop (didn't bet)



PokerStars Game #19978725409:  Hold'em No Limit ($0.10/$0.25) - 2008/08/28 - 22:53:35 (ET)
Table 'Hippasos IV' 9-max Seat #2 is the button
Seat 1: gong4da ($5.30 in chips) 
Seat 2: daisy108 ($25.15 in chips) 
Seat 4: ctojeira ($24.50 in chips) 
Seat 5: Le gros pic ($26.25 in chips) 
Seat 6: Mrinaldi ($42.60 in chips) 
Seat 7: Alameda22 ($23.90 in chips) 
Seat 8: Cardini 23 ($24.65 in chips) 
Seat 9: Dj Kenny S ($7.30 in chips) 
ctojeira: posts small blind $0.10
Le gros pic: posts big blind $0.25
*** HOLE CARDS ***
Dealt to Alameda22 [9c 7s]
Mrinaldi: raises $0.25 to $0.50
Alameda22: folds 
Cardini 23: folds 
Dj Kenny S: folds 
gong4da: folds 
daisy108: folds 
ctojeira: folds 
Le gros pic: calls $0.25
*** FLOP *** [Kd 7d Jd]
Le gros pic: checks 
Mrinaldi: bets $1.25
Le gros pic: calls $1.25
*** TURN *** [Kd 7d Jd] [5d]
Le gros pic: checks 
Mrinaldi: checks 
*** RIVER *** [Kd 7d Jd 5d] [6s]
Le gros pic: bets $4
Mrinaldi: folds 
Uncalled bet ($4) returned to Le gros pic
Le gros pic collected $3.45 from pot
Le gros pic: doesn't show hand 
*** SUMMARY ***
Total pot $3.60 | Rake $0.15 
Board [Kd 7d Jd 5d 6s]
Seat 1: gong4da folded before Flop (didn't bet)
Seat 2: daisy108 (button) folded before Flop (didn't bet)
Seat 4: ctojeira (small blind) folded before Flop
Seat 5: Le gros pic (big blind) collected ($3.45)
Seat 6: Mrinaldi folded on the River
Seat 7: Alameda22 folded before Flop (didn't bet)
Seat 8: Cardini 23 folded before Flop (didn't bet)
Seat 9: Dj Kenny S folded before Flop (didn't bet)



PokerStars Game #19978749314:  Hold'em No Limit ($0.10/$0.25) - 2008/08/28 - 22:54:43 (ET)
Table 'Hippasos IV' 9-max Seat #4 is the button
Seat 1: gong4da ($5.30 in chips) 
Seat 2: daisy108 ($25.15 in chips) 
Seat 4: ctojeira ($24.40 in chips) 
Seat 5: Le gros pic ($27.95 in chips) 
Seat 6: Mrinaldi ($40.85 in chips) 
Seat 7: Alameda22 ($23.90 in chips) 
Seat 8: Cardini 23 ($24.65 in chips) 
Seat 9: Dj Kenny S ($7.30 in chips) 
Le gros pic: posts small blind $0.10
Mrinaldi: posts big blind $0.25
*** HOLE CARDS ***
Dealt to Alameda22 [6h 8c]
Alameda22: folds 
Cardini 23: folds 
Dj Kenny S: folds 
gong4da: folds 
daisy108: folds 
ctojeira: raises $0.75 to $1
Le gros pic: raises $1 to $2
Mrinaldi: raises $2.50 to $4.50
ctojeira: calls $3.50
Le gros pic: folds 
*** FLOP *** [2h 3d 4d]
Mrinaldi: bets $5
ctojeira said, "jj"
ctojeira: folds 
Uncalled bet ($5) returned to Mrinaldi
Mrinaldi collected $10.45 from pot
Mrinaldi: doesn't show hand 
*** SUMMARY ***
Total pot $11 | Rake $0.55 
Board [2h 3d 4d]
Seat 1: gong4da folded before Flop (didn't bet)
Seat 2: daisy108 folded before Flop (didn't bet)
Seat 4: ctojeira (button) folded on the Flop
Seat 5: Le gros pic (small blind) folded before Flop
Seat 6: Mrinaldi (big blind) collected ($10.45)
Seat 7: Alameda22 folded before Flop (didn't bet)
Seat 8: Cardini 23 folded before Flop (didn't bet)
Seat 9: Dj Kenny S folded before Flop (didn't bet)



PokerStars Game #19978783422:  Hold'em No Limit ($0.10/$0.25) - 2008/08/28 - 22:56:19 (ET)
Table 'Hippasos IV' 9-max Seat #5 is the button
Seat 1: gong4da ($5.30 in chips) 
Seat 2: daisy108 ($25.15 in chips) 
Seat 4: ctojeira ($19.90 in chips) 
Seat 5: Le gros pic ($25.95 in chips) 
Seat 6: Mrinaldi ($46.80 in chips) 
Seat 7: Alameda22 ($23.90 in chips) 
Seat 8: Cardini 23 ($24.65 in chips) 
Seat 9: Dj Kenny S ($7.30 in chips) 
Mrinaldi: posts small blind $0.10
Alameda22: posts big blind $0.25
*** HOLE CARDS ***
Dealt to Alameda22 [Qs Ac]
Cardini 23: folds 
ctojeira said, "have to put you on kk or aa there"
Dj Kenny S: folds 
gong4da: folds 
daisy108: folds 
ctojeira: raises $0.50 to $0.75
Le gros pic: calls $0.75
Mrinaldi: folds 
Mrinaldi said, "nice read"
Alameda22: calls $0.50
*** FLOP *** [Jd 6s 2c]
ctojeira said, "i hope so"
Alameda22: checks 
ctojeira: bets $1.25
Le gros pic: raises $1.25 to $2.50
Alameda22: folds 
ctojeira: raises $2.50 to $5
Le gros pic: raises $18.25 to $23.25
Dj Kenny S leaves the table
ctojeira: calls $14.15 and is all-in
Uncalled bet ($4.10) returned to Le gros pic
*** TURN *** [Jd 6s 2c] [Kd]
*** RIVER *** [Jd 6s 2c Kd] [3s]
*** SHOW DOWN ***
ctojeira: shows [Kh Ks] (three of a kind, Kings)
Le gros pic: mucks hand 
ctojeira collected $38.65 from pot
*** SUMMARY ***
Total pot $40.65 | Rake $2 
Board [Jd 6s 2c Kd 3s]
Seat 1: gong4da folded before Flop (didn't bet)
Seat 2: daisy108 folded before Flop (didn't bet)
Seat 4: ctojeira showed [Kh Ks] and won ($38.65) with three of a kind, Kings
Seat 5: Le gros pic (button) mucked [2d 2s]
Seat 6: Mrinaldi (small blind) folded before Flop
Seat 7: Alameda22 (big blind) folded on the Flop
Seat 8: Cardini 23 folded before Flop (didn't bet)
Seat 9: Dj Kenny S folded before Flop (didn't bet)



PokerStars Game #19978823705:  Hold'em No Limit ($0.10/$0.25) - 2008/08/28 - 22:58:15 (ET)
Table 'Hippasos IV' 9-max Seat #6 is the button
Seat 1: gong4da ($5.30 in chips) 
Seat 2: daisy108 ($25.15 in chips) 
Seat 4: ctojeira ($38.65 in chips) 
Seat 5: Le gros pic ($6.05 in chips) 
Seat 6: Mrinaldi ($46.70 in chips) 
Seat 7: Alameda22 ($23.15 in chips) 
Seat 8: Cardini 23 ($24.65 in chips) 
Alameda22: posts small blind $0.10
Cardini 23: posts big blind $0.25
*** HOLE CARDS ***
Dealt to Alameda22 [Ad 7d]
gong4da: calls $0.25
daisy108: folds 
ctojeira: folds 
Le gros pic: calls $0.25
Mrinaldi: folds 
Alameda22: calls $0.15
Cardini 23: checks 
*** FLOP *** [7c 8c Tc]
Alameda22: checks 
Cardini 23: checks 
gong4da: checks 
Le gros pic: checks 
*** TURN *** [7c 8c Tc] [8d]
Alameda22: checks 
Cardini 23: checks 
gong4da: checks 
Le gros pic: checks 
*** RIVER *** [7c 8c Tc 8d] [Jh]
Alameda22: checks 
Cardini 23: checks 
gong4da: checks 
Le gros pic: checks 
*** SHOW DOWN ***
Alameda22: shows [Ad 7d] (two pair, Eights and Sevens)
Cardini 23: mucks hand 
gong4da: mucks hand 
Le gros pic: shows [Kc Js] (two pair, Jacks and Eights)
Le gros pic collected $0.95 from pot
*** SUMMARY ***
Total pot $1 | Rake $0.05 
Board [7c 8c Tc 8d Jh]
Seat 1: gong4da mucked [3d 3c]
Seat 2: daisy108 folded before Flop (didn't bet)
Seat 4: ctojeira folded before Flop (didn't bet)
Seat 5: Le gros pic showed [Kc Js] and won ($0.95) with two pair, Jacks and Eights
Seat 6: Mrinaldi (button) folded before Flop (didn't bet)
Seat 7: Alameda22 (small blind) showed [Ad 7d] and lost with two pair, Eights and Sevens
Seat 8: Cardini 23 (big blind) mucked [Kd 4s]



PokerStars Game #19978863371:  Hold'em No Limit ($0.10/$0.25) - 2008/08/28 - 23:00:10 (ET)
Table 'Hippasos IV' 9-max Seat #7 is the button
Seat 1: gong4da ($5.05 in chips) 
Seat 2: daisy108 ($25.15 in chips) 
Seat 4: ctojeira ($38.65 in chips) 
Seat 5: Le gros pic ($25 in chips) 
Seat 6: Mrinaldi ($46.70 in chips) 
Seat 7: Alameda22 ($22.90 in chips) 
Seat 8: Cardini 23 ($24.40 in chips) 
Cardini 23: posts small blind $0.10
gong4da: posts big blind $0.25
*** HOLE CARDS ***
Dealt to Alameda22 [7s 4c]
daisy108: folds 
ctojeira: raises $0.75 to $1
Le gros pic: folds 
Mrinaldi: folds 
Alameda22: folds 
Cardini 23: folds 
gong4da: folds 
Uncalled bet ($0.75) returned to ctojeira
ctojeira collected $0.60 from pot
ctojeira: doesn't show hand 
*** SUMMARY ***
Total pot $0.60 | Rake $0 
Seat 1: gong4da (big blind) folded before Flop
Seat 2: daisy108 folded before Flop (didn't bet)
Seat 4: ctojeira collected ($0.60)
Seat 5: Le gros pic folded before Flop (didn't bet)
Seat 6: Mrinaldi folded before Flop (didn't bet)
Seat 7: Alameda22 (button) folded before Flop (didn't bet)
Seat 8: Cardini 23 (small blind) folded before Flop



PokerStars Game #19978882498:  Hold'em No Limit ($0.10/$0.25) - 2008/08/28 - 23:01:06 (ET)
Table 'Hippasos IV' 9-max Seat #8 is the button
Seat 1: gong4da ($4.80 in chips) 
Seat 2: daisy108 ($25.15 in chips) 
Seat 4: ctojeira ($39 in chips) 
Seat 5: Le gros pic ($25 in chips) 
Seat 6: Mrinaldi ($46.70 in chips) 
Seat 7: Alameda22 ($22.90 in chips) 
Seat 8: Cardini 23 ($24.30 in chips) 
gong4da: posts small blind $0.10
daisy108: posts big blind $0.25
*** HOLE CARDS ***
Dealt to Alameda22 [Kd 7c]
ctojeira: folds 
Le gros pic: folds 
Mrinaldi: folds 
Alameda22: folds 
Cardini 23: calls $0.25
gong4da: folds 
daisy108: checks 
*** FLOP *** [9c Ac Ks]
daisy108: bets $1.25
Cardini 23: folds 
Uncalled bet ($1.25) returned to daisy108
daisy108 collected $0.60 from pot
daisy108: doesn't show hand 
*** SUMMARY ***
Total pot $0.60 | Rake $0 
Board [9c Ac Ks]
Seat 1: gong4da (small blind) folded before Flop
Seat 2: daisy108 (big blind) collected ($0.60)
Seat 4: ctojeira folded before Flop (didn't bet)
Seat 5: Le gros pic folded before Flop (didn't bet)
Seat 6: Mrinaldi folded before Flop (didn't bet)
Seat 7: Alameda22 folded before Flop (didn't bet)
Seat 8: Cardini 23 (button) folded on the Flop



PokerStars Game #19978898800:  Hold'em No Limit ($0.10/$0.25) - 2008/08/28 - 23:01:54 (ET)
Table 'Hippasos IV' 9-max Seat #1 is the button
Seat 1: gong4da ($4.70 in chips) 
Seat 2: daisy108 ($25.50 in chips) 
Seat 4: ctojeira ($39 in chips) 
Seat 5: Le gros pic ($25 in chips) 
Seat 6: Mrinaldi ($46.70 in chips) 
Seat 7: Alameda22 ($22.90 in chips) 
Seat 8: Cardini 23 ($24.05 in chips) 
daisy108: posts small blind $0.10
ctojeira: posts big blind $0.25
*** HOLE CARDS ***
Dealt to Alameda22 [Jd 6d]
Le gros pic: folds 
Mrinaldi: folds 
Alameda22: folds 
Cardini 23: folds 
][MPACKING$$ was removed from the table for failing to post
gong4da: folds 
daisy108: folds 
Uncalled bet ($0.15) returned to ctojeira
ctojeira collected $0.20 from pot
ctojeira: doesn't show hand 
*** SUMMARY ***
Total pot $0.20 | Rake $0 
Seat 1: gong4da (button) folded before Flop (didn't bet)
Seat 2: daisy108 (small blind) folded before Flop
Seat 4: ctojeira (big blind) collected ($0.20)
Seat 5: Le gros pic folded before Flop (didn't bet)
Seat 6: Mrinaldi folded before Flop (didn't bet)
Seat 7: Alameda22 folded before Flop (didn't bet)
Seat 8: Cardini 23 folded before Flop (didn't bet)



PokerStars Game #19978906464:  Hold'em No Limit ($0.10/$0.25) - 2008/08/28 - 23:02:16 (ET)
Table 'Hippasos IV' 9-max Seat #2 is the button
Seat 1: gong4da ($4.70 in chips) 
Seat 2: daisy108 ($25.40 in chips) 
Seat 4: ctojeira ($39.10 in chips) 
Seat 5: Le gros pic ($25 in chips) 
Seat 6: Mrinaldi ($46.70 in chips) 
Seat 7: Alameda22 ($22.90 in chips) 
Seat 8: Cardini 23 ($24.05 in chips) 
ctojeira: posts small blind $0.10
Le gros pic: posts big blind $0.25
*** HOLE CARDS ***
Dealt to Alameda22 [5s Jh]
Mrinaldi: raises $0.50 to $0.75
Alameda22: folds 
Cardini 23: folds 
gong4da: folds 
daisy108: folds 
ctojeira: folds 
Le gros pic: folds 
Uncalled bet ($0.50) returned to Mrinaldi
Mrinaldi collected $0.60 from pot
Mrinaldi: doesn't show hand 
*** SUMMARY ***
Total pot $0.60 | Rake $0 
Seat 1: gong4da folded before Flop (didn't bet)
Seat 2: daisy108 (button) folded before Flop (didn't bet)
Seat 4: ctojeira (small blind) folded before Flop
Seat 5: Le gros pic (big blind) folded before Flop
Seat 6: Mrinaldi collected ($0.60)
Seat 7: Alameda22 folded before Flop (didn't bet)
Seat 8: Cardini 23 folded before Flop (didn't bet)



PokerStars Game #19978917933:  Hold'em No Limit ($0.10/$0.25) - 2008/08/28 - 23:02:50 (ET)
Table 'Hippasos IV' 9-max Seat #4 is the button
Seat 1: gong4da ($4.70 in chips) 
Seat 2: daisy108 ($25.40 in chips) 
Seat 4: ctojeira ($39 in chips) 
Seat 5: Le gros pic ($24.75 in chips) 
Seat 6: Mrinaldi ($47.05 in chips) 
Seat 7: Alameda22 ($22.90 in chips) 
Seat 8: Cardini 23 ($24.05 in chips) 
Le gros pic: posts small blind $0.10
Mrinaldi: posts big blind $0.25
*** HOLE CARDS ***
Dealt to Alameda22 [Qc 2d]
Alameda22: folds 
Cardini 23: folds 
Cardini 23 is sitting out
gong4da: folds 
daisy108: folds 
ctojeira: raises $0.50 to $0.75
Le gros pic: folds 
Mrinaldi: folds 
Uncalled bet ($0.50) returned to ctojeira
ctojeira collected $0.60 from pot
ctojeira: doesn't show hand 
*** SUMMARY ***
Total pot $0.60 | Rake $0 
Seat 1: gong4da folded before Flop (didn't bet)
Seat 2: daisy108 folded before Flop (didn't bet)
Seat 4: ctojeira (button) collected ($0.60)
Seat 5: Le gros pic (small blind) folded before Flop
Seat 6: Mrinaldi (big blind) folded before Flop
Seat 7: Alameda22 folded before Flop (didn't bet)
Seat 8: Cardini 23 folded before Flop (didn't bet)



PokerStars Game #19978929224:  Hold'em No Limit ($0.10/$0.25) - 2008/08/28 - 23:03:22 (ET)
Table 'Hippasos IV' 9-max Seat #5 is the button
Seat 1: gong4da ($4.70 in chips) 
Seat 2: daisy108 ($25.40 in chips) 
Seat 4: ctojeira ($39.35 in chips) 
Seat 5: Le gros pic ($24.65 in chips) 
Seat 6: Mrinaldi ($46.80 in chips) 
Seat 7: Alameda22 ($22.90 in chips) 
Mrinaldi: posts small blind $0.10
Alameda22: posts big blind $0.25
*** HOLE CARDS ***
Dealt to Alameda22 [8h 9h]
gong4da: folds 
daisy108: raises $0.75 to $1
ctojeira: folds 
Le gros pic: folds 
Mrinaldi: folds 
Alameda22: calls $0.75
*** FLOP *** [Th Ah 9d]
Alameda22: checks 
daisy108: bets $2
Alameda22: raises $4 to $6
daisy108: folds 
Uncalled bet ($4) returned to Alameda22
Alameda22 collected $5.80 from pot
Alameda22: doesn't show hand 
*** SUMMARY ***
Total pot $6.10 | Rake $0.30 
Board [Th Ah 9d]
Seat 1: gong4da folded before Flop (didn't bet)
Seat 2: daisy108 folded on the Flop
Seat 4: ctojeira folded before Flop (didn't bet)
Seat 5: Le gros pic (button) folded before Flop (didn't bet)
Seat 6: Mrinaldi (small blind) folded before Flop
Seat 7: Alameda22 (big blind) collected ($5.80)



PokerStars Game #19978953922:  Hold'em No Limit ($0.10/$0.25) - 2008/08/28 - 23:04:35 (ET)
Table 'Hippasos IV' 9-max Seat #6 is the button
Seat 1: gong4da ($4.70 in chips) 
Seat 2: daisy108 ($25 in chips) 
Seat 4: ctojeira ($39.35 in chips) 
Seat 5: Le gros pic ($24.65 in chips) 
Seat 6: Mrinaldi ($46.70 in chips) 
Seat 7: Alameda22 ($25.70 in chips) 
Alameda22: posts small blind $0.10
gong4da: posts big blind $0.25
*** HOLE CARDS ***
Dealt to Alameda22 [Td 2s]
daisy108: folds 
ctojeira: folds 
Le gros pic: folds 
Mrinaldi: raises $0.50 to $0.75
Alameda22: folds 
gong4da: folds 
Uncalled bet ($0.50) returned to Mrinaldi
Mrinaldi collected $0.60 from pot
Mrinaldi: doesn't show hand 
*** SUMMARY ***
Total pot $0.60 | Rake $0 
Seat 1: gong4da (big blind) folded before Flop
Seat 2: daisy108 folded before Flop (didn't bet)
Seat 4: ctojeira folded before Flop (didn't bet)
Seat 5: Le gros pic folded before Flop (didn't bet)
Seat 6: Mrinaldi (button) collected ($0.60)
Seat 7: Alameda22 (small blind) folded before Flop



PokerStars Game #19978959841:  Hold'em No Limit ($0.10/$0.25) - 2008/08/28 - 23:04:53 (ET)
Table 'Hippasos IV' 9-max Seat #7 is the button
Seat 1: gong4da ($4.45 in chips) 
Seat 2: daisy108 ($25 in chips) 
Seat 4: ctojeira ($39.35 in chips) 
Seat 5: Le gros pic ($24.65 in chips) 
Seat 6: Mrinaldi ($47.05 in chips) 
Seat 7: Alameda22 ($25.60 in chips) 
gong4da: posts small blind $0.10
daisy108: posts big blind $0.25
*** HOLE CARDS ***
Dealt to Alameda22 [Ac Td]
ctojeira: folds 
Le gros pic: folds 
Mrinaldi: folds 
Alameda22: folds 
gong4da: folds 
Uncalled bet ($0.15) returned to daisy108
daisy108 collected $0.20 from pot
daisy108: doesn't show hand 
*** SUMMARY ***
Total pot $0.20 | Rake $0 
Seat 1: gong4da (small blind) folded before Flop
Seat 2: daisy108 (big blind) collected ($0.20)
Seat 4: ctojeira folded before Flop (didn't bet)
Seat 5: Le gros pic folded before Flop (didn't bet)
Seat 6: Mrinaldi folded before Flop (didn't bet)
Seat 7: Alameda22 (button) folded before Flop (didn't bet)



PokerStars Game #19978966247:  Hold'em No Limit ($0.10/$0.25) - 2008/08/28 - 23:05:12 (ET)
Table 'Hippasos IV' 9-max Seat #1 is the button
Seat 1: gong4da ($4.35 in chips) 
Seat 2: daisy108 ($25.10 in chips) 
Seat 4: ctojeira ($39.35 in chips) 
Seat 5: Le gros pic ($24.65 in chips) 
Seat 6: Mrinaldi ($47.05 in chips) 
Seat 7: Alameda22 ($25.60 in chips) 
daisy108: posts small blind $0.10
ctojeira: posts big blind $0.25
*** HOLE CARDS ***
Dealt to Alameda22 [7c 2c]
Le gros pic: folds 
Mrinaldi: folds 
Alameda22: folds 
gong4da: folds 
daisy108: folds 
Uncalled bet ($0.15) returned to ctojeira
ctojeira collected $0.20 from pot
ctojeira: doesn't show hand 
*** SUMMARY ***
Total pot $0.20 | Rake $0 
Seat 1: gong4da (button) folded before Flop (didn't bet)
Seat 2: daisy108 (small blind) folded before Flop
Seat 4: ctojeira (big blind) collected ($0.20)
Seat 5: Le gros pic folded before Flop (didn't bet)
Seat 6: Mrinaldi folded before Flop (didn't bet)
Seat 7: Alameda22 folded before Flop (didn't bet)



PokerStars Game #19978971938:  Hold'em No Limit ($0.10/$0.25) - 2008/08/28 - 23:05:29 (ET)
Table 'Hippasos IV' 9-max Seat #2 is the button
Seat 1: gong4da ($4.35 in chips) 
Seat 2: daisy108 ($25 in chips) 
Seat 4: ctojeira ($39.45 in chips) 
Seat 5: Le gros pic ($24.65 in chips) 
Seat 6: Mrinaldi ($47.05 in chips) 
Seat 7: Alameda22 ($25.60 in chips) 
ctojeira: posts small blind $0.10
Le gros pic: posts big blind $0.25
*** HOLE CARDS ***
Dealt to Alameda22 [Ah 3d]
Mrinaldi: folds 
Alameda22: folds 
gong4da: folds 
daisy108: folds 
ctojeira: calls $0.15
Le gros pic: checks 
*** FLOP *** [2s Jh 5h]
ctojeira: checks 
Le gros pic: bets $0.50
ctojeira: folds 
Uncalled bet ($0.50) returned to Le gros pic
Le gros pic collected $0.50 from pot
Le gros pic: doesn't show hand 
*** SUMMARY ***
Total pot $0.50 | Rake $0 
Board [2s Jh 5h]
Seat 1: gong4da folded before Flop (didn't bet)
Seat 2: daisy108 (button) folded before Flop (didn't bet)
Seat 4: ctojeira (small blind) folded on the Flop
Seat 5: Le gros pic (big blind) collected ($0.50)
Seat 6: Mrinaldi folded before Flop (didn't bet)
Seat 7: Alameda22 folded before Flop (didn't bet)



PokerStars Game #19978986930:  Hold'em No Limit ($0.10/$0.25) - 2008/08/28 - 23:06:13 (ET)
Table 'Hippasos IV' 9-max Seat #4 is the button
Seat 1: gong4da ($4.35 in chips) 
Seat 2: daisy108 ($25 in chips) 
Seat 4: ctojeira ($39.20 in chips) 
Seat 5: Le gros pic ($24.90 in chips) 
Seat 6: Mrinaldi ($47.05 in chips) 
Seat 7: Alameda22 ($25.60 in chips) 
Le gros pic: posts small blind $0.10
Mrinaldi: posts big blind $0.25
*** HOLE CARDS ***
Dealt to Alameda22 [Ad 9c]
Alameda22: folds 
gong4da: folds 
daisy108: folds 
ctojeira: raises $0.75 to $1
Le gros pic: folds 
Mrinaldi: folds 
Uncalled bet ($0.75) returned to ctojeira
ctojeira collected $0.60 from pot
ctojeira: doesn't show hand 
*** SUMMARY ***
Total pot $0.60 | Rake $0 
Seat 1: gong4da folded before Flop (didn't bet)
Seat 2: daisy108 folded before Flop (didn't bet)
Seat 4: ctojeira (button) collected ($0.60)
Seat 5: Le gros pic (small blind) folded before Flop
Seat 6: Mrinaldi (big blind) folded before Flop
Seat 7: Alameda22 folded before Flop (didn't bet)



PokerStars Game #19978995842:  Hold'em No Limit ($0.10/$0.25) - 2008/08/28 - 23:06:39 (ET)
Table 'Hippasos IV' 9-max Seat #5 is the button
Seat 1: gong4da ($4.35 in chips) 
Seat 2: daisy108 ($25 in chips) 
Seat 4: ctojeira ($39.55 in chips) 
Seat 5: Le gros pic ($24.80 in chips) 
Seat 6: Mrinaldi ($46.80 in chips) 
Seat 7: Alameda22 ($25.60 in chips) 
Mrinaldi: posts small blind $0.10
Alameda22: posts big blind $0.25
*** HOLE CARDS ***
Dealt to Alameda22 [Kd 8c]
gong4da: folds 
daisy108: folds 
ctojeira: calls $0.25
Le gros pic: calls $0.25
Mrinaldi: calls $0.15
Alameda22: checks 
*** FLOP *** [Qs 9h 9s]
Mrinaldi: checks 
Alameda22: checks 
ctojeira: checks 
Le gros pic: bets $0.75
Mrinaldi: folds 
Alameda22: folds 
ctojeira: folds 
Uncalled bet ($0.75) returned to Le gros pic
Le gros pic collected $0.95 from pot
Le gros pic: doesn't show hand 
*** SUMMARY ***
Total pot $1 | Rake $0.05 
Board [Qs 9h 9s]
Seat 1: gong4da folded before Flop (didn't bet)
Seat 2: daisy108 folded before Flop (didn't bet)
Seat 4: ctojeira folded on the Flop
Seat 5: Le gros pic (button) collected ($0.95)
Seat 6: Mrinaldi (small blind) folded on the Flop
Seat 7: Alameda22 (big blind) folded on the Flop



PokerStars Game #19979034457:  Hold'em No Limit ($0.10/$0.25) - 2008/08/28 - 23:08:34 (ET)
Table 'Hippasos IV' 9-max Seat #6 is the button
Seat 1: gong4da ($4.35 in chips) 
Seat 2: daisy108 ($25 in chips) 
Seat 4: ctojeira ($39.30 in chips) 
Seat 5: Le gros pic ($25.50 in chips) 
Seat 6: Mrinaldi ($46.55 in chips) 
Seat 7: Alameda22 ($25.35 in chips) 
Alameda22: posts small blind $0.10
gong4da: posts big blind $0.25
*** HOLE CARDS ***
Dealt to Alameda22 [Jd 2d]
daisy108: folds 
ctojeira: folds 
Le gros pic: raises $0.75 to $1
Mrinaldi: folds 
Alameda22: folds 
gong4da: folds 
Uncalled bet ($0.75) returned to Le gros pic
Le gros pic collected $0.60 from pot
Le gros pic: doesn't show hand 
*** SUMMARY ***
Total pot $0.60 | Rake $0 
Seat 1: gong4da (big blind) folded before Flop
Seat 2: daisy108 folded before Flop (didn't bet)
Seat 4: ctojeira folded before Flop (didn't bet)
Seat 5: Le gros pic collected ($0.60)
Seat 6: Mrinaldi (button) folded before Flop (didn't bet)
Seat 7: Alameda22 (small blind) folded before Flop



PokerStars Game #19979042854:  Hold'em No Limit ($0.10/$0.25) - 2008/08/28 - 23:08:58 (ET)
Table 'Hippasos IV' 9-max Seat #7 is the button
Seat 1: gong4da ($4.10 in chips) 
Seat 2: daisy108 ($25 in chips) 
Seat 4: ctojeira ($39.30 in chips) 
Seat 5: Le gros pic ($25.85 in chips) 
Seat 6: Mrinaldi ($46.55 in chips) 
Seat 7: Alameda22 ($25.25 in chips) 
gong4da: posts small blind $0.10
daisy108: posts big blind $0.25
*** HOLE CARDS ***
Dealt to Alameda22 [Tc 7s]
ctojeira: raises $0.50 to $0.75
Le gros pic: folds 
Mrinaldi: folds 
Alameda22: folds 
gong4da: folds 
daisy108: raises $1.75 to $2.50
ctojeira: folds 
Uncalled bet ($1.75) returned to daisy108
daisy108 collected $1.60 from pot
daisy108: doesn't show hand 
*** SUMMARY ***
Total pot $1.60 | Rake $0 
Seat 1: gong4da (small blind) folded before Flop
Seat 2: daisy108 (big blind) collected ($1.60)
Seat 4: ctojeira folded before Flop
Seat 5: Le gros pic folded before Flop (didn't bet)
Seat 6: Mrinaldi folded before Flop (didn't bet)
Seat 7: Alameda22 (button) folded before Flop (didn't bet)



PokerStars Game #19979059229:  Hold'em No Limit ($0.10/$0.25) - 2008/08/28 - 23:09:48 (ET)
Table 'Hippasos IV' 9-max Seat #1 is the button
Seat 1: gong4da ($4 in chips) 
Seat 2: daisy108 ($25.85 in chips) 
Seat 4: ctojeira ($38.55 in chips) 
Seat 5: Le gros pic ($25.85 in chips) 
Seat 6: Mrinaldi ($46.55 in chips) 
Seat 7: Alameda22 ($25.25 in chips) 
daisy108: posts small blind $0.10
ctojeira: posts big blind $0.25
*** HOLE CARDS ***
Dealt to Alameda22 [As Qs]
Le gros pic: folds 
Mrinaldi: folds 
Alameda22: raises $0.50 to $0.75
gong4da: folds 
daisy108: folds 
ctojeira: folds 
Uncalled bet ($0.50) returned to Alameda22
Alameda22 collected $0.60 from pot
Alameda22: doesn't show hand 
*** SUMMARY ***
Total pot $0.60 | Rake $0 
Seat 1: gong4da (button) folded before Flop (didn't bet)
Seat 2: daisy108 (small blind) folded before Flop
Seat 4: ctojeira (big blind) folded before Flop
Seat 5: Le gros pic folded before Flop (didn't bet)
Seat 6: Mrinaldi folded before Flop (didn't bet)
Seat 7: Alameda22 collected ($0.60)



PokerStars Game #19979068747:  Hold'em No Limit ($0.10/$0.25) - 2008/08/28 - 23:10:16 (ET)
Table 'Hippasos IV' 9-max Seat #2 is the button
Seat 1: gong4da ($4 in chips) 
Seat 2: daisy108 ($25.75 in chips) 
Seat 4: ctojeira ($38.30 in chips) 
Seat 5: Le gros pic ($25.85 in chips) 
Seat 6: Mrinaldi ($46.55 in chips) 
Seat 7: Alameda22 ($25.60 in chips) 
ctojeira: posts small blind $0.10
Le gros pic: posts big blind $0.25
*** HOLE CARDS ***
Dealt to Alameda22 [7h Ts]
Mrinaldi: folds 
Alameda22: folds 
gong4da: folds 
Powder42cm joins the table at seat #3 
daisy108: folds 
Powder42cm is sitting out
ctojeira: calls $0.15
Le gros pic: checks 
*** FLOP *** [6h Jd 7d]
ctojeira: bets $0.50
Le gros pic: folds 
Uncalled bet ($0.50) returned to ctojeira
ctojeira collected $0.50 from pot
ctojeira: doesn't show hand 
Powder42cm leaves the table
*** SUMMARY ***
Total pot $0.50 | Rake $0 
Board [6h Jd 7d]
Seat 1: gong4da folded before Flop (didn't bet)
Seat 2: daisy108 (button) folded before Flop (didn't bet)
Seat 4: ctojeira (small blind) collected ($0.50)
Seat 5: Le gros pic (big blind) folded on the Flop
Seat 6: Mrinaldi folded before Flop (didn't bet)
Seat 7: Alameda22 folded before Flop (didn't bet)



PokerStars Game #19979087103:  Hold'em No Limit ($0.10/$0.25) - 2008/08/28 - 23:11:11 (ET)
Table 'Hippasos IV' 9-max Seat #4 is the button
Seat 1: gong4da ($4 in chips) 
Seat 2: daisy108 ($25.75 in chips) 
Seat 4: ctojeira ($38.55 in chips) 
Seat 5: Le gros pic ($25.60 in chips) 
Seat 6: Mrinaldi ($46.55 in chips) 
Seat 7: Alameda22 ($25.60 in chips) 
Le gros pic: posts small blind $0.10
Mrinaldi: posts big blind $0.25
*** HOLE CARDS ***
Dealt to Alameda22 [7s 3d]
Alameda22: folds 
gong4da: folds 
daisy108: folds 
ctojeira: folds 
Le gros pic: calls $0.15
Mrinaldi: checks 
*** FLOP *** [4h 5h 2s]
Le gros pic: checks 
Mrinaldi: checks 
*** TURN *** [4h 5h 2s] [3c]
Le gros pic: checks 
Mrinaldi: checks 
*** RIVER *** [4h 5h 2s 3c] [6d]
Le gros pic: checks 
Mrinaldi: bets $0.50
Le gros pic: folds 
Uncalled bet ($0.50) returned to Mrinaldi
Mrinaldi collected $0.50 from pot
Mrinaldi: doesn't show hand 
*** SUMMARY ***
Total pot $0.50 | Rake $0 
Board [4h 5h 2s 3c 6d]
Seat 1: gong4da folded before Flop (didn't bet)
Seat 2: daisy108 folded before Flop (didn't bet)
Seat 4: ctojeira (button) folded before Flop (didn't bet)
Seat 5: Le gros pic (small blind) folded on the River
Seat 6: Mrinaldi (big blind) collected ($0.50)
Seat 7: Alameda22 folded before Flop (didn't bet)



