PokerStars Game #19976536011:  Hold'em No Limit ($0.10/$0.25) - 2008/08/28 - 21:13:41 (ET)
Table 'Vesta III' 9-max Seat #1 is the button
Seat 1: quickkilllah ($24.65 in chips) 
Seat 2: Dakotah Kid ($14.25 in chips) 
Seat 3: KIDNIC ($15 in chips) 
Seat 4: mcdougal2 ($24.40 in chips) 
Seat 5: jm_mathurin ($25 in chips) 
Seat 6: GUTFEELN ($14.10 in chips) 
Seat 7: BigSoonerFan ($15.05 in chips) 
Seat 8: Mr.JackPot81 ($24.65 in chips) 
Seat 9: Alameda22 ($25 in chips) 
Dakotah Kid: posts small blind $0.10
KIDNIC: posts big blind $0.25
Alameda22: posts big blind $0.25
*** HOLE CARDS ***
Dealt to Alameda22 [3s Jd]
mcdougal2: calls $0.25
jm_mathurin: calls $0.25
GUTFEELN: folds 
BigSoonerFan: folds 
Mr.JackPot81: folds 
Alameda22: checks 
quickkilllah: folds 
Dakotah Kid: folds 
KIDNIC: checks 
*** FLOP *** [9c Kc 4s]
KIDNIC: checks 
mcdougal2: checks 
jm_mathurin: checks 
Alameda22: checks 
*** TURN *** [9c Kc 4s] [Tc]
KIDNIC: checks 
mcdougal2: checks 
jm_mathurin: checks 
Alameda22: checks 
*** RIVER *** [9c Kc 4s Tc] [Qd]
KIDNIC: checks 
mcdougal2: checks 
jm_mathurin: checks 
Alameda22: bets $0.50
KIDNIC: folds 
mcdougal2: folds 
jm_mathurin: folds 
Uncalled bet ($0.50) returned to Alameda22
Alameda22 collected $1.05 from pot
Alameda22: doesn't show hand 
*** SUMMARY ***
Total pot $1.10 | Rake $0.05 
Board [9c Kc 4s Tc Qd]
Seat 1: quickkilllah (button) folded before Flop (didn't bet)
Seat 2: Dakotah Kid (small blind) folded before Flop
Seat 3: KIDNIC (big blind) folded on the River
Seat 4: mcdougal2 folded on the River
Seat 5: jm_mathurin folded on the River
Seat 6: GUTFEELN folded before Flop (didn't bet)
Seat 7: BigSoonerFan folded before Flop (didn't bet)
Seat 8: Mr.JackPot81 folded before Flop (didn't bet)
Seat 9: Alameda22 collected ($1.05)



PokerStars Game #19976579719:  Hold'em No Limit ($0.10/$0.25) - 2008/08/28 - 21:15:40 (ET)
Table 'Vesta III' 9-max Seat #2 is the button
Seat 1: quickkilllah ($24.65 in chips) 
Seat 2: Dakotah Kid ($14.15 in chips) 
Seat 3: KIDNIC ($14.75 in chips) 
Seat 4: mcdougal2 ($24.15 in chips) 
Seat 5: jm_mathurin ($24.75 in chips) 
Seat 6: GUTFEELN ($14.10 in chips) 
Seat 7: BigSoonerFan ($15.05 in chips) 
Seat 8: Mr.JackPot81 ($24.65 in chips) 
Seat 9: Alameda22 ($25.80 in chips) 
KIDNIC: posts small blind $0.10
mcdougal2: posts big blind $0.25
*** HOLE CARDS ***
Dealt to Alameda22 [6h 3c]
jm_mathurin: folds 
GUTFEELN: calls $0.25
BigSoonerFan: folds 
Mr.JackPot81: folds 
Alameda22: folds 
quickkilllah: folds 
Dakotah Kid: folds 
KIDNIC: folds 
mcdougal2: checks 
*** FLOP *** [Qh 2c Kc]
mcdougal2: checks 
GUTFEELN: bets $0.75
mcdougal2: folds 
Uncalled bet ($0.75) returned to GUTFEELN
GUTFEELN collected $0.60 from pot
GUTFEELN: doesn't show hand 
*** SUMMARY ***
Total pot $0.60 | Rake $0 
Board [Qh 2c Kc]
Seat 1: quickkilllah folded before Flop (didn't bet)
Seat 2: Dakotah Kid (button) folded before Flop (didn't bet)
Seat 3: KIDNIC (small blind) folded before Flop
Seat 4: mcdougal2 (big blind) folded on the Flop
Seat 5: jm_mathurin folded before Flop (didn't bet)
Seat 6: GUTFEELN collected ($0.60)
Seat 7: BigSoonerFan folded before Flop (didn't bet)
Seat 8: Mr.JackPot81 folded before Flop (didn't bet)
Seat 9: Alameda22 folded before Flop (didn't bet)



PokerStars Game #19976603713:  Hold'em No Limit ($0.10/$0.25) - 2008/08/28 - 21:16:45 (ET)
Table 'Vesta III' 9-max Seat #3 is the button
Seat 1: quickkilllah ($24.65 in chips) 
Seat 2: Dakotah Kid ($14.15 in chips) 
Seat 3: KIDNIC ($14.65 in chips) 
Seat 4: mcdougal2 ($23.90 in chips) 
Seat 5: jm_mathurin ($24.75 in chips) 
Seat 6: GUTFEELN ($14.45 in chips) 
Seat 7: BigSoonerFan ($15.05 in chips) 
Seat 8: Mr.JackPot81 ($24.65 in chips) 
Seat 9: Alameda22 ($25.80 in chips) 
mcdougal2: posts small blind $0.10
jm_mathurin: posts big blind $0.25
*** HOLE CARDS ***
Dealt to Alameda22 [Jc Th]
GUTFEELN: calls $0.25
BigSoonerFan: folds 
Mr.JackPot81: folds 
Alameda22: folds 
quickkilllah: folds 
Dakotah Kid: folds 
KIDNIC: folds 
mcdougal2: calls $0.15
jm_mathurin: checks 
*** FLOP *** [8c 6h 7h]
mcdougal2: bets $1
jm_mathurin: folds 
GUTFEELN: calls $1
*** TURN *** [8c 6h 7h] [Qs]
mcdougal2: bets $2
GUTFEELN: calls $2
*** RIVER *** [8c 6h 7h Qs] [Ad]
mcdougal2: bets $2
GUTFEELN: raises $3.25 to $5.25
mcdougal2: calls $3.25
*** SHOW DOWN ***
GUTFEELN: shows [9c Ah] (a pair of Aces)
mcdougal2: shows [7d 8d] (two pair, Eights and Sevens)
mcdougal2 collected $16.45 from pot
*** SUMMARY ***
Total pot $17.25 | Rake $0.80 
Board [8c 6h 7h Qs Ad]
Seat 1: quickkilllah folded before Flop (didn't bet)
Seat 2: Dakotah Kid folded before Flop (didn't bet)
Seat 3: KIDNIC (button) folded before Flop (didn't bet)
Seat 4: mcdougal2 (small blind) showed [7d 8d] and won ($16.45) with two pair, Eights and Sevens
Seat 5: jm_mathurin (big blind) folded on the Flop
Seat 6: GUTFEELN showed [9c Ah] and lost with a pair of Aces
Seat 7: BigSoonerFan folded before Flop (didn't bet)
Seat 8: Mr.JackPot81 folded before Flop (didn't bet)
Seat 9: Alameda22 folded before Flop (didn't bet)



PokerStars Game #19976631630:  Hold'em No Limit ($0.10/$0.25) - 2008/08/28 - 21:18:02 (ET)
Table 'Vesta III' 9-max Seat #4 is the button
Seat 1: quickkilllah ($24.65 in chips) 
Seat 2: Dakotah Kid ($14.15 in chips) 
Seat 3: KIDNIC ($14.65 in chips) 
Seat 4: mcdougal2 ($31.85 in chips) 
Seat 5: jm_mathurin ($24.50 in chips) 
Seat 6: GUTFEELN ($5.95 in chips) 
Seat 7: BigSoonerFan ($15.05 in chips) 
Seat 8: Mr.JackPot81 ($24.65 in chips) 
Seat 9: Alameda22 ($25.80 in chips) 
jm_mathurin: posts small blind $0.10
GUTFEELN: posts big blind $0.25
*** HOLE CARDS ***
Dealt to Alameda22 [Ah 8h]
BigSoonerFan: folds 
Mr.JackPot81: folds 
Alameda22: folds 
quickkilllah: folds 
Dakotah Kid: calls $0.25
KIDNIC: folds 
mcdougal2: folds 
jm_mathurin: calls $0.15
GUTFEELN: checks 
*** FLOP *** [2h 9d 2s]
jm_mathurin: checks 
GUTFEELN: checks 
Dakotah Kid: checks 
*** TURN *** [2h 9d 2s] [Kc]
jm_mathurin: checks 
GUTFEELN: checks 
Dakotah Kid: checks 
*** RIVER *** [2h 9d 2s Kc] [Jc]
jm_mathurin: checks 
GUTFEELN: checks 
Dakotah Kid: bets $0.50
jm_mathurin: folds 
GUTFEELN: folds 
Uncalled bet ($0.50) returned to Dakotah Kid
Dakotah Kid collected $0.75 from pot
Dakotah Kid: doesn't show hand 
*** SUMMARY ***
Total pot $0.75 | Rake $0 
Board [2h 9d 2s Kc Jc]
Seat 1: quickkilllah folded before Flop (didn't bet)
Seat 2: Dakotah Kid collected ($0.75)
Seat 3: KIDNIC folded before Flop (didn't bet)
Seat 4: mcdougal2 (button) folded before Flop (didn't bet)
Seat 5: jm_mathurin (small blind) folded on the River
Seat 6: GUTFEELN (big blind) folded on the River
Seat 7: BigSoonerFan folded before Flop (didn't bet)
Seat 8: Mr.JackPot81 folded before Flop (didn't bet)
Seat 9: Alameda22 folded before Flop (didn't bet)



PokerStars Game #19976654188:  Hold'em No Limit ($0.10/$0.25) - 2008/08/28 - 21:19:03 (ET)
Table 'Vesta III' 9-max Seat #5 is the button
Seat 1: quickkilllah ($24.65 in chips) 
Seat 2: Dakotah Kid ($14.65 in chips) 
Seat 3: KIDNIC ($14.65 in chips) 
Seat 4: mcdougal2 ($31.85 in chips) 
Seat 5: jm_mathurin ($24.25 in chips) 
Seat 6: GUTFEELN ($5.70 in chips) 
Seat 7: BigSoonerFan ($15.05 in chips) 
Seat 8: Mr.JackPot81 ($24.65 in chips) 
Seat 9: Alameda22 ($25.80 in chips) 
GUTFEELN: posts small blind $0.10
BigSoonerFan: posts big blind $0.25
*** HOLE CARDS ***
Dealt to Alameda22 [5s 3c]
Mr.JackPot81: folds 
Alameda22: folds 
quickkilllah: folds 
Dakotah Kid: folds 
KIDNIC: folds 
mcdougal2: folds 
jm_mathurin: raises $0.75 to $1
GUTFEELN: folds 
BigSoonerFan: folds 
Uncalled bet ($0.75) returned to jm_mathurin
jm_mathurin collected $0.60 from pot
*** SUMMARY ***
Total pot $0.60 | Rake $0 
Seat 1: quickkilllah folded before Flop (didn't bet)
Seat 2: Dakotah Kid folded before Flop (didn't bet)
Seat 3: KIDNIC folded before Flop (didn't bet)
Seat 4: mcdougal2 folded before Flop (didn't bet)
Seat 5: jm_mathurin (button) collected ($0.60)
Seat 6: GUTFEELN (small blind) folded before Flop
Seat 7: BigSoonerFan (big blind) folded before Flop
Seat 8: Mr.JackPot81 folded before Flop (didn't bet)
Seat 9: Alameda22 folded before Flop (didn't bet)



PokerStars Game #19976672421:  Hold'em No Limit ($0.10/$0.25) - 2008/08/28 - 21:19:52 (ET)
Table 'Vesta III' 9-max Seat #6 is the button
Seat 1: quickkilllah ($24.65 in chips) 
Seat 2: Dakotah Kid ($14.65 in chips) 
Seat 3: KIDNIC ($14.65 in chips) 
Seat 4: mcdougal2 ($31.85 in chips) 
Seat 5: jm_mathurin ($24.60 in chips) 
Seat 6: GUTFEELN ($5.60 in chips) 
Seat 7: BigSoonerFan ($14.80 in chips) 
Seat 9: Alameda22 ($25.80 in chips) 
BigSoonerFan: posts small blind $0.10
Mr.JackPot81: is sitting out 
Alameda22: posts big blind $0.25
*** HOLE CARDS ***
Dealt to Alameda22 [4h 7h]
quickkilllah: raises $0.75 to $1
Dakotah Kid: folds 
KIDNIC: folds 
mcdougal2: folds 
jm_mathurin: folds 
GUTFEELN: calls $1
BigSoonerFan: folds 
Alameda22: folds 
*** FLOP *** [5d Qc Ah]
quickkilllah: bets $1.75
GUTFEELN: raises $2.85 to $4.60 and is all-in
quickkilllah: calls $2.85
*** TURN *** [5d Qc Ah] [Js]
*** RIVER *** [5d Qc Ah Js] [6d]
*** SHOW DOWN ***
quickkilllah: shows [Kd Ks] (a pair of Kings)
GUTFEELN: mucks hand 
quickkilllah collected $11 from pot
*** SUMMARY ***
Total pot $11.55 | Rake $0.55 
Board [5d Qc Ah Js 6d]
Seat 1: quickkilllah showed [Kd Ks] and won ($11) with a pair of Kings
Seat 2: Dakotah Kid folded before Flop (didn't bet)
Seat 3: KIDNIC folded before Flop (didn't bet)
Seat 4: mcdougal2 folded before Flop (didn't bet)
Seat 5: jm_mathurin folded before Flop (didn't bet)
Seat 6: GUTFEELN (button) mucked [Qh Td]
Seat 7: BigSoonerFan (small blind) folded before Flop
Seat 9: Alameda22 (big blind) folded before Flop



PokerStars Game #19976709019:  Hold'em No Limit ($0.10/$0.25) - 2008/08/28 - 21:21:33 (ET)
Table 'Vesta III' 9-max Seat #7 is the button
Seat 1: quickkilllah ($30.05 in chips) 
Seat 2: Dakotah Kid ($14.65 in chips) 
Seat 3: KIDNIC ($14.65 in chips) 
Seat 4: mcdougal2 ($31.85 in chips) 
Seat 5: jm_mathurin ($24.60 in chips) 
Seat 7: BigSoonerFan ($14.70 in chips) 
Seat 9: Alameda22 ($25.55 in chips) 
Alameda22: posts small blind $0.10
quickkilllah: posts big blind $0.25
*** HOLE CARDS ***
Dealt to Alameda22 [Jd 4d]
Dakotah Kid: folds 
GUTFEELN leaves the table
KIDNIC: calls $0.25
mcdougal2: folds 
jm_mathurin: raises $1 to $1.25
BigSoonerFan: folds 
Alameda22: folds 
Stapher joins the table at seat #6 
quickkilllah: folds 
KIDNIC: folds 
Uncalled bet ($1) returned to jm_mathurin
jm_mathurin collected $0.85 from pot
*** SUMMARY ***
Total pot $0.85 | Rake $0 
Seat 1: quickkilllah (big blind) folded before Flop
Seat 2: Dakotah Kid folded before Flop (didn't bet)
Seat 3: KIDNIC folded before Flop
Seat 4: mcdougal2 folded before Flop (didn't bet)
Seat 5: jm_mathurin collected ($0.85)
Seat 7: BigSoonerFan (button) folded before Flop (didn't bet)
Seat 9: Alameda22 (small blind) folded before Flop



PokerStars Game #19976732904:  Hold'em No Limit ($0.10/$0.25) - 2008/08/28 - 21:22:37 (ET)
Table 'Vesta III' 9-max Seat #9 is the button
Seat 1: quickkilllah ($29.80 in chips) 
Seat 2: Dakotah Kid ($14.65 in chips) 
Seat 3: KIDNIC ($14.40 in chips) 
Seat 4: mcdougal2 ($31.85 in chips) 
Seat 5: jm_mathurin ($25.20 in chips) 
Seat 6: Stapher ($25 in chips) 
Seat 7: BigSoonerFan ($14.70 in chips) 
Seat 9: Alameda22 ($25.45 in chips) 
quickkilllah: posts small blind $0.10
Dakotah Kid: posts big blind $0.25
Stapher: posts big blind $0.25
*** HOLE CARDS ***
Dealt to Alameda22 [3d 9s]
KIDNIC: folds 
mcdougal2: calls $0.25
jm_mathurin: calls $0.25
Stapher: checks 
BigSoonerFan: folds 
Alameda22: folds 
quickkilllah: calls $0.15
Dakotah Kid: checks 
*** FLOP *** [8d Kh Qc]
quickkilllah: checks 
Dakotah Kid: checks 
mcdougal2: checks 
jm_mathurin: checks 
Stapher: checks 
*** TURN *** [8d Kh Qc] [7d]
quickkilllah: bets $0.50
Dakotah Kid: folds 
mcdougal2: folds 
jm_mathurin: calls $0.50
Stapher: folds 
*** RIVER *** [8d Kh Qc 7d] [3h]
quickkilllah: checks 
jm_mathurin: checks 
*** SHOW DOWN ***
quickkilllah: shows [Qd Jd] (a pair of Queens)
jm_mathurin: mucks hand 
quickkilllah collected $2.15 from pot
*** SUMMARY ***
Total pot $2.25 | Rake $0.10 
Board [8d Kh Qc 7d 3h]
Seat 1: quickkilllah (small blind) showed [Qd Jd] and won ($2.15) with a pair of Queens
Seat 2: Dakotah Kid (big blind) folded on the Turn
Seat 3: KIDNIC folded before Flop (didn't bet)
Seat 4: mcdougal2 folded on the Turn
Seat 5: jm_mathurin mucked [Jc Ts]
Seat 6: Stapher folded on the Turn
Seat 7: BigSoonerFan folded before Flop (didn't bet)
Seat 9: Alameda22 (button) folded before Flop (didn't bet)



PokerStars Game #19976768353:  Hold'em No Limit ($0.10/$0.25) - 2008/08/28 - 21:24:13 (ET)
Table 'Vesta III' 9-max Seat #1 is the button
Seat 1: quickkilllah ($31.20 in chips) 
Seat 2: Dakotah Kid ($14.40 in chips) 
Seat 3: KIDNIC ($14.40 in chips) 
Seat 4: mcdougal2 ($31.60 in chips) 
Seat 5: jm_mathurin ($24.45 in chips) 
Seat 6: Stapher ($24.75 in chips) 
Seat 7: BigSoonerFan ($14.70 in chips) 
Seat 9: Alameda22 ($25.45 in chips) 
Dakotah Kid: posts small blind $0.10
KIDNIC: posts big blind $0.25
*** HOLE CARDS ***
Dealt to Alameda22 [8c 4d]
mcdougal2: folds 
jm_mathurin: raises $1.25 to $1.50
Stapher: calls $1.50
BigSoonerFan: folds 
Alameda22: folds 
quickkilllah: folds 
Dakotah Kid: folds 
KIDNIC: folds 
*** FLOP *** [5s Tc 4c]
jm_mathurin: bets $2.75
Stapher: folds 
Uncalled bet ($2.75) returned to jm_mathurin
jm_mathurin collected $3.20 from pot
*** SUMMARY ***
Total pot $3.35 | Rake $0.15 
Board [5s Tc 4c]
Seat 1: quickkilllah (button) folded before Flop (didn't bet)
Seat 2: Dakotah Kid (small blind) folded before Flop
Seat 3: KIDNIC (big blind) folded before Flop
Seat 4: mcdougal2 folded before Flop (didn't bet)
Seat 5: jm_mathurin collected ($3.20)
Seat 6: Stapher folded on the Flop
Seat 7: BigSoonerFan folded before Flop (didn't bet)
Seat 9: Alameda22 folded before Flop (didn't bet)



PokerStars Game #19976785786:  Hold'em No Limit ($0.10/$0.25) - 2008/08/28 - 21:25:01 (ET)
Table 'Vesta III' 9-max Seat #2 is the button
Seat 1: quickkilllah ($31.20 in chips) 
Seat 2: Dakotah Kid ($14.30 in chips) 
Seat 3: KIDNIC ($14.15 in chips) 
Seat 4: mcdougal2 ($31.60 in chips) 
Seat 5: jm_mathurin ($26.15 in chips) 
Seat 6: Stapher ($23.25 in chips) 
Seat 7: BigSoonerFan ($14.70 in chips) 
Seat 9: Alameda22 ($25.45 in chips) 
KIDNIC: posts small blind $0.10
mcdougal2: posts big blind $0.25
*** HOLE CARDS ***
Dealt to Alameda22 [Td 5h]
jm_mathurin: folds 
Stapher: folds 
BigSoonerFan: folds 
Alameda22: folds 
quickkilllah: folds 
Dakotah Kid: folds 
KIDNIC: folds 
Uncalled bet ($0.15) returned to mcdougal2
mcdougal2 collected $0.20 from pot
mcdougal2: doesn't show hand 
*** SUMMARY ***
Total pot $0.20 | Rake $0 
Seat 1: quickkilllah folded before Flop (didn't bet)
Seat 2: Dakotah Kid (button) folded before Flop (didn't bet)
Seat 3: KIDNIC (small blind) folded before Flop
Seat 4: mcdougal2 (big blind) collected ($0.20)
Seat 5: jm_mathurin folded before Flop (didn't bet)
Seat 6: Stapher folded before Flop (didn't bet)
Seat 7: BigSoonerFan folded before Flop (didn't bet)
Seat 9: Alameda22 folded before Flop (didn't bet)



PokerStars Game #19976800925:  Hold'em No Limit ($0.10/$0.25) - 2008/08/28 - 21:25:41 (ET)
Table 'Vesta III' 9-max Seat #3 is the button
Seat 1: quickkilllah ($31.20 in chips) 
Seat 2: Dakotah Kid ($14.30 in chips) 
Seat 3: KIDNIC ($14.05 in chips) 
Seat 4: mcdougal2 ($31.70 in chips) 
Seat 5: jm_mathurin ($26.15 in chips) 
Seat 6: Stapher ($23.25 in chips) 
Seat 7: BigSoonerFan ($14.70 in chips) 
Seat 9: Alameda22 ($25.45 in chips) 
mcdougal2: posts small blind $0.10
jm_mathurin: posts big blind $0.25
*** HOLE CARDS ***
Dealt to Alameda22 [Ah 7s]
Stapher: folds 
BigSoonerFan: folds 
Alameda22: folds 
quickkilllah: folds 
Dakotah Kid: folds 
KIDNIC: folds 
mcdougal2: calls $0.15
jm_mathurin: checks 
*** FLOP *** [Th 9d 8c]
mcdougal2: checks 
jm_mathurin: checks 
*** TURN *** [Th 9d 8c] [7d]
mcdougal2: checks 
jm_mathurin: bets $0.50
mcdougal2: folds 
Uncalled bet ($0.50) returned to jm_mathurin
jm_mathurin collected $0.50 from pot
*** SUMMARY ***
Total pot $0.50 | Rake $0 
Board [Th 9d 8c 7d]
Seat 1: quickkilllah folded before Flop (didn't bet)
Seat 2: Dakotah Kid folded before Flop (didn't bet)
Seat 3: KIDNIC (button) folded before Flop (didn't bet)
Seat 4: mcdougal2 (small blind) folded on the Turn
Seat 5: jm_mathurin (big blind) collected ($0.50)
Seat 6: Stapher folded before Flop (didn't bet)
Seat 7: BigSoonerFan folded before Flop (didn't bet)
Seat 9: Alameda22 folded before Flop (didn't bet)



PokerStars Game #19976826101:  Hold'em No Limit ($0.10/$0.25) - 2008/08/28 - 21:26:50 (ET)
Table 'Vesta III' 9-max Seat #4 is the button
Seat 1: quickkilllah ($31.20 in chips) 
Seat 2: Dakotah Kid ($14.30 in chips) 
Seat 3: KIDNIC ($14.05 in chips) 
Seat 4: mcdougal2 ($31.45 in chips) 
Seat 5: jm_mathurin ($26.40 in chips) 
Seat 6: Stapher ($23.25 in chips) 
Seat 7: BigSoonerFan ($14.70 in chips) 
Seat 9: Alameda22 ($25.45 in chips) 
jm_mathurin: posts small blind $0.10
Stapher: posts big blind $0.25
*** HOLE CARDS ***
Dealt to Alameda22 [9h 6s]
BigSoonerFan: folds 
Alameda22: folds 
quickkilllah: folds 
Dakotah Kid: folds 
KIDNIC: raises $0.50 to $0.75
mcdougal2: folds 
jm_mathurin: folds 
Stapher: folds 
Uncalled bet ($0.50) returned to KIDNIC
KIDNIC collected $0.60 from pot
*** SUMMARY ***
Total pot $0.60 | Rake $0 
Seat 1: quickkilllah folded before Flop (didn't bet)
Seat 2: Dakotah Kid folded before Flop (didn't bet)
Seat 3: KIDNIC collected ($0.60)
Seat 4: mcdougal2 (button) folded before Flop (didn't bet)
Seat 5: jm_mathurin (small blind) folded before Flop
Seat 6: Stapher (big blind) folded before Flop
Seat 7: BigSoonerFan folded before Flop (didn't bet)
Seat 9: Alameda22 folded before Flop (didn't bet)



PokerStars Game #19976840194:  Hold'em No Limit ($0.10/$0.25) - 2008/08/28 - 21:27:28 (ET)
Table 'Vesta III' 9-max Seat #5 is the button
Seat 1: quickkilllah ($31.20 in chips) 
Seat 2: Dakotah Kid ($14.30 in chips) 
Seat 3: KIDNIC ($14.40 in chips) 
Seat 4: mcdougal2 ($31.45 in chips) 
Seat 5: jm_mathurin ($26.30 in chips) 
Seat 6: Stapher ($23 in chips) 
Seat 7: BigSoonerFan ($14.70 in chips) 
Seat 9: Alameda22 ($25.45 in chips) 
Stapher: posts small blind $0.10
BigSoonerFan: posts big blind $0.25
*** HOLE CARDS ***
Dealt to Alameda22 [2h Jc]
Alameda22: folds 
quickkilllah: raises $0.75 to $1
Dakotah Kid: folds 
KIDNIC: folds 
mcdougal2: folds 
jm_mathurin: calls $1
Stapher: folds 
BigSoonerFan: folds 
*** FLOP *** [9d Kc 6d]
quickkilllah: bets $1.50
jm_mathurin: calls $1.50
*** TURN *** [9d Kc 6d] [5h]
quickkilllah: checks 
jm_mathurin: bets $3
quickkilllah: folds 
Uncalled bet ($3) returned to jm_mathurin
jm_mathurin collected $5.10 from pot
*** SUMMARY ***
Total pot $5.35 | Rake $0.25 
Board [9d Kc 6d 5h]
Seat 1: quickkilllah folded on the Turn
Seat 2: Dakotah Kid folded before Flop (didn't bet)
Seat 3: KIDNIC folded before Flop (didn't bet)
Seat 4: mcdougal2 folded before Flop (didn't bet)
Seat 5: jm_mathurin (button) collected ($5.10)
Seat 6: Stapher (small blind) folded before Flop
Seat 7: BigSoonerFan (big blind) folded before Flop
Seat 9: Alameda22 folded before Flop (didn't bet)



PokerStars Game #19976865095:  Hold'em No Limit ($0.10/$0.25) - 2008/08/28 - 21:28:35 (ET)
Table 'Vesta III' 9-max Seat #6 is the button
Seat 1: quickkilllah ($28.70 in chips) 
Seat 2: Dakotah Kid ($14.30 in chips) 
Seat 3: KIDNIC ($14.40 in chips) 
Seat 4: mcdougal2 ($31.45 in chips) 
Seat 5: jm_mathurin ($28.90 in chips) 
Seat 6: Stapher ($22.90 in chips) 
Seat 7: BigSoonerFan ($14.45 in chips) 
Seat 9: Alameda22 ($25.45 in chips) 
BigSoonerFan: posts small blind $0.10
Alameda22: posts big blind $0.25
*** HOLE CARDS ***
Dealt to Alameda22 [5c Jc]
quickkilllah: folds 
Dakotah Kid: folds 
KIDNIC: folds 
mcdougal2: folds 
jm_mathurin: raises $1 to $1.25
Stapher: folds 
BigSoonerFan: folds 
Alameda22: folds 
Uncalled bet ($1) returned to jm_mathurin
jm_mathurin collected $0.60 from pot
*** SUMMARY ***
Total pot $0.60 | Rake $0 
Seat 1: quickkilllah folded before Flop (didn't bet)
Seat 2: Dakotah Kid folded before Flop (didn't bet)
Seat 3: KIDNIC folded before Flop (didn't bet)
Seat 4: mcdougal2 folded before Flop (didn't bet)
Seat 5: jm_mathurin collected ($0.60)
Seat 6: Stapher (button) folded before Flop (didn't bet)
Seat 7: BigSoonerFan (small blind) folded before Flop
Seat 9: Alameda22 (big blind) folded before Flop



PokerStars Game #19976879667:  Hold'em No Limit ($0.10/$0.25) - 2008/08/28 - 21:29:15 (ET)
Table 'Vesta III' 9-max Seat #7 is the button
Seat 1: quickkilllah ($28.70 in chips) 
Seat 2: Dakotah Kid ($14.30 in chips) 
Seat 3: KIDNIC ($14.40 in chips) 
Seat 4: mcdougal2 ($31.45 in chips) 
Seat 5: jm_mathurin ($29.25 in chips) 
Seat 6: Stapher ($22.90 in chips) 
Seat 7: BigSoonerFan ($14.35 in chips) 
Seat 9: Alameda22 ($25.20 in chips) 
Alameda22: posts small blind $0.10
quickkilllah: posts big blind $0.25
*** HOLE CARDS ***
Dealt to Alameda22 [3c Ks]
Dakotah Kid: folds 
KIDNIC: calls $0.25
mcdougal2: folds 
jm_mathurin: folds 
Stapher: folds 
BigSoonerFan: calls $0.25
Alameda22: folds 
quickkilllah: checks 
*** FLOP *** [8d Kh 9s]
quickkilllah: checks 
KIDNIC: checks 
BigSoonerFan: bets $0.75
quickkilllah: folds 
KIDNIC: folds 
Uncalled bet ($0.75) returned to BigSoonerFan
BigSoonerFan collected $0.85 from pot
BigSoonerFan: doesn't show hand 
*** SUMMARY ***
Total pot $0.85 | Rake $0 
Board [8d Kh 9s]
Seat 1: quickkilllah (big blind) folded on the Flop
Seat 2: Dakotah Kid folded before Flop (didn't bet)
Seat 3: KIDNIC folded on the Flop
Seat 4: mcdougal2 folded before Flop (didn't bet)
Seat 5: jm_mathurin folded before Flop (didn't bet)
Seat 6: Stapher folded before Flop (didn't bet)
Seat 7: BigSoonerFan (button) collected ($0.85)
Seat 9: Alameda22 (small blind) folded before Flop



PokerStars Game #19976900449:  Hold'em No Limit ($0.10/$0.25) - 2008/08/28 - 21:30:12 (ET)
Table 'Vesta III' 9-max Seat #9 is the button
Seat 1: quickkilllah ($28.45 in chips) 
Seat 2: Dakotah Kid ($14.30 in chips) 
Seat 3: KIDNIC ($14.15 in chips) 
Seat 4: mcdougal2 ($31.45 in chips) 
Seat 5: jm_mathurin ($29.25 in chips) 
Seat 6: Stapher ($22.90 in chips) 
Seat 7: BigSoonerFan ($14.95 in chips) 
Seat 9: Alameda22 ($25.10 in chips) 
quickkilllah: posts small blind $0.10
Dakotah Kid: posts big blind $0.25
*** HOLE CARDS ***
Dealt to Alameda22 [6h 8d]
KIDNIC: folds 
mcdougal2: raises $0.25 to $0.50
jm_mathurin: folds 
Stapher: calls $0.50
BigSoonerFan: raises $1.50 to $2
Alameda22: folds 
quickkilllah: folds 
Dakotah Kid: folds 
mcdougal2: folds 
Stapher: calls $1.50
*** FLOP *** [Js 7d Td]
Stapher: checks 
BigSoonerFan: bets $2.50
Stapher: calls $2.50
*** TURN *** [Js 7d Td] [Jd]
Stapher: checks 
BigSoonerFan: bets $10.45 and is all-in
Stapher: folds 
Uncalled bet ($10.45) returned to BigSoonerFan
BigSoonerFan collected $9.40 from pot
BigSoonerFan: doesn't show hand 
*** SUMMARY ***
Total pot $9.85 | Rake $0.45 
Board [Js 7d Td Jd]
Seat 1: quickkilllah (small blind) folded before Flop
Seat 2: Dakotah Kid (big blind) folded before Flop
Seat 3: KIDNIC folded before Flop (didn't bet)
Seat 4: mcdougal2 folded before Flop
Seat 5: jm_mathurin folded before Flop (didn't bet)
Seat 6: Stapher folded on the Turn
Seat 7: BigSoonerFan collected ($9.40)
Seat 9: Alameda22 (button) folded before Flop (didn't bet)



PokerStars Game #19976930411:  Hold'em No Limit ($0.10/$0.25) - 2008/08/28 - 21:31:34 (ET)
Table 'Vesta III' 9-max Seat #1 is the button
Seat 1: quickkilllah ($28.35 in chips) 
Seat 2: Dakotah Kid ($14.05 in chips) 
Seat 3: KIDNIC ($14.15 in chips) 
Seat 4: mcdougal2 ($30.95 in chips) 
Seat 5: jm_mathurin ($29.25 in chips) 
Seat 6: Stapher ($18.40 in chips) 
Seat 7: BigSoonerFan ($25 in chips) 
Seat 9: Alameda22 ($25.10 in chips) 
Dakotah Kid: posts small blind $0.10
KIDNIC: posts big blind $0.25
*** HOLE CARDS ***
Dealt to Alameda22 [9h Kc]
mcdougal2: folds 
jm_mathurin: folds 
Stapher: folds 
BigSoonerFan: raises $1 to $1.25
Alameda22: folds 
quickkilllah: folds 
Dakotah Kid: folds 
KIDNIC: folds 
Uncalled bet ($1) returned to BigSoonerFan
BigSoonerFan collected $0.60 from pot
BigSoonerFan: doesn't show hand 
*** SUMMARY ***
Total pot $0.60 | Rake $0 
Seat 1: quickkilllah (button) folded before Flop (didn't bet)
Seat 2: Dakotah Kid (small blind) folded before Flop
Seat 3: KIDNIC (big blind) folded before Flop
Seat 4: mcdougal2 folded before Flop (didn't bet)
Seat 5: jm_mathurin folded before Flop (didn't bet)
Seat 6: Stapher folded before Flop (didn't bet)
Seat 7: BigSoonerFan collected ($0.60)
Seat 9: Alameda22 folded before Flop (didn't bet)



PokerStars Game #19976944230:  Hold'em No Limit ($0.10/$0.25) - 2008/08/28 - 21:32:12 (ET)
Table 'Vesta III' 9-max Seat #2 is the button
Seat 1: quickkilllah ($28.35 in chips) 
Seat 2: Dakotah Kid ($13.95 in chips) 
Seat 3: KIDNIC ($13.90 in chips) 
Seat 4: mcdougal2 ($30.95 in chips) 
Seat 5: jm_mathurin ($29.25 in chips) 
Seat 6: Stapher ($18.40 in chips) 
Seat 7: BigSoonerFan ($25.35 in chips) 
Seat 9: Alameda22 ($25.10 in chips) 
KIDNIC: posts small blind $0.10
mcdougal2: posts big blind $0.25
*** HOLE CARDS ***
Dealt to Alameda22 [Ts 4d]
jm_mathurin: folds 
Stapher: raises $0.75 to $1
BigSoonerFan: folds 
Alameda22: folds 
quickkilllah: folds 
Dakotah Kid: folds 
KIDNIC: folds 
mcdougal2: calls $0.75
*** FLOP *** [4s 6c Tc]
mcdougal2: checks 
Stapher: bets $1.25
mcdougal2: folds 
Uncalled bet ($1.25) returned to Stapher
Stapher collected $2 from pot
Stapher: doesn't show hand 
*** SUMMARY ***
Total pot $2.10 | Rake $0.10 
Board [4s 6c Tc]
Seat 1: quickkilllah folded before Flop (didn't bet)
Seat 2: Dakotah Kid (button) folded before Flop (didn't bet)
Seat 3: KIDNIC (small blind) folded before Flop
Seat 4: mcdougal2 (big blind) folded on the Flop
Seat 5: jm_mathurin folded before Flop (didn't bet)
Seat 6: Stapher collected ($2)
Seat 7: BigSoonerFan folded before Flop (didn't bet)
Seat 9: Alameda22 folded before Flop (didn't bet)



PokerStars Game #19976961602:  Hold'em No Limit ($0.10/$0.25) - 2008/08/28 - 21:33:00 (ET)
Table 'Vesta III' 9-max Seat #3 is the button
Seat 1: quickkilllah ($28.35 in chips) 
Seat 2: Dakotah Kid ($13.95 in chips) 
Seat 3: KIDNIC ($13.80 in chips) 
Seat 4: mcdougal2 ($29.95 in chips) 
Seat 5: jm_mathurin ($29.25 in chips) 
Seat 6: Stapher ($19.40 in chips) 
Seat 7: BigSoonerFan ($25.35 in chips) 
Seat 9: Alameda22 ($25.10 in chips) 
mcdougal2: posts small blind $0.10
jm_mathurin: posts big blind $0.25
*** HOLE CARDS ***
Dealt to Alameda22 [2c 8s]
Stapher: calls $0.25
BigSoonerFan: folds 
Alameda22: folds 
quickkilllah: folds 
Dakotah Kid: calls $0.25
KIDNIC: calls $0.25
mcdougal2: calls $0.15
jm_mathurin: checks 
*** FLOP *** [4s 8c 6d]
mcdougal2: checks 
jm_mathurin: checks 
Stapher: checks 
Dakotah Kid: checks 
KIDNIC: checks 
*** TURN *** [4s 8c 6d] [6c]
mcdougal2: bets $1
jm_mathurin: folds 
Stapher: folds 
Dakotah Kid: folds 
KIDNIC: folds 
Uncalled bet ($1) returned to mcdougal2
mcdougal2 collected $1.20 from pot
mcdougal2: doesn't show hand 
*** SUMMARY ***
Total pot $1.25 | Rake $0.05 
Board [4s 8c 6d 6c]
Seat 1: quickkilllah folded before Flop (didn't bet)
Seat 2: Dakotah Kid folded on the Turn
Seat 3: KIDNIC (button) folded on the Turn
Seat 4: mcdougal2 (small blind) collected ($1.20)
Seat 5: jm_mathurin (big blind) folded on the Turn
Seat 6: Stapher folded on the Turn
Seat 7: BigSoonerFan folded before Flop (didn't bet)
Seat 9: Alameda22 folded before Flop (didn't bet)



PokerStars Game #19976987025:  Hold'em No Limit ($0.10/$0.25) - 2008/08/28 - 21:34:10 (ET)
Table 'Vesta III' 9-max Seat #4 is the button
Seat 1: quickkilllah ($28.35 in chips) 
Seat 2: Dakotah Kid ($13.70 in chips) 
Seat 3: KIDNIC ($13.55 in chips) 
Seat 4: mcdougal2 ($30.90 in chips) 
Seat 5: jm_mathurin ($29 in chips) 
Seat 6: Stapher ($19.15 in chips) 
Seat 7: BigSoonerFan ($25.35 in chips) 
Seat 9: Alameda22 ($25.10 in chips) 
jm_mathurin: posts small blind $0.10
Stapher: posts big blind $0.25
*** HOLE CARDS ***
Dealt to Alameda22 [Jh 7h]
BigSoonerFan: folds 
Alameda22: folds 
quickkilllah: folds 
Dakotah Kid: folds 
KIDNIC: folds 
mcdougal2: calls $0.25
jm_mathurin: calls $0.15
Stapher: raises $0.75 to $1
mcdougal2: folds 
jm_mathurin: folds 
Uncalled bet ($0.75) returned to Stapher
Stapher collected $0.75 from pot
Stapher: doesn't show hand 
*** SUMMARY ***
Total pot $0.75 | Rake $0 
Seat 1: quickkilllah folded before Flop (didn't bet)
Seat 2: Dakotah Kid folded before Flop (didn't bet)
Seat 3: KIDNIC folded before Flop (didn't bet)
Seat 4: mcdougal2 (button) folded before Flop
Seat 5: jm_mathurin (small blind) folded before Flop
Seat 6: Stapher (big blind) collected ($0.75)
Seat 7: BigSoonerFan folded before Flop (didn't bet)
Seat 9: Alameda22 folded before Flop (didn't bet)



PokerStars Game #19977000894:  Hold'em No Limit ($0.10/$0.25) - 2008/08/28 - 21:34:49 (ET)
Table 'Vesta III' 9-max Seat #5 is the button
Seat 1: quickkilllah ($28.35 in chips) 
Seat 2: Dakotah Kid ($13.70 in chips) 
Seat 3: KIDNIC ($13.55 in chips) 
Seat 4: mcdougal2 ($30.65 in chips) 
Seat 5: jm_mathurin ($28.75 in chips) 
Seat 6: Stapher ($19.65 in chips) 
Seat 9: Alameda22 ($25.10 in chips) 
Stapher: posts small blind $0.10
BigSoonerFan: is sitting out 
Alameda22: posts big blind $0.25
*** HOLE CARDS ***
Dealt to Alameda22 [6s 4h]
BigSoonerFan leaves the table
quickkilllah: raises $0.75 to $1
Dakotah Kid: folds 
KIDNIC: folds 
mcdougal2: folds 
jm_mathurin: calls $1
Stapher: folds 
Alameda22: folds 
*** FLOP *** [Ad Td 9h]
quickkilllah: bets $1.25
jm_mathurin: calls $1.25
*** TURN *** [Ad Td 9h] [2d]
quickkilllah: checks 
jm_mathurin: bets $3
quickkilllah: calls $3
*** RIVER *** [Ad Td 9h 2d] [Ts]
thing93001 joins the table at seat #7 
quickkilllah: checks 
jm_mathurin: bets $23.50 and is all-in
quickkilllah: folds 
Uncalled bet ($23.50) returned to jm_mathurin
jm_mathurin collected $10.35 from pot
*** SUMMARY ***
Total pot $10.85 | Rake $0.50 
Board [Ad Td 9h 2d Ts]
Seat 1: quickkilllah folded on the River
Seat 2: Dakotah Kid folded before Flop (didn't bet)
Seat 3: KIDNIC folded before Flop (didn't bet)
Seat 4: mcdougal2 folded before Flop (didn't bet)
Seat 5: jm_mathurin (button) collected ($10.35)
Seat 6: Stapher (small blind) folded before Flop
Seat 9: Alameda22 (big blind) folded before Flop



PokerStars Game #19977048819:  Hold'em No Limit ($0.10/$0.25) - 2008/08/28 - 21:37:02 (ET)
Table 'Vesta III' 9-max Seat #6 is the button
Seat 1: quickkilllah ($23.10 in chips) 
Seat 2: Dakotah Kid ($13.70 in chips) 
Seat 3: KIDNIC ($13.55 in chips) 
Seat 4: mcdougal2 ($30.65 in chips) 
Seat 5: jm_mathurin ($33.85 in chips) 
Seat 6: Stapher ($19.55 in chips) 
Seat 9: Alameda22 ($24.85 in chips) 
thing93001 will be allowed to play after the button
Alameda22: posts small blind $0.10
quickkilllah: posts big blind $0.25
*** HOLE CARDS ***
Dealt to Alameda22 [Ks Qh]
Dakotah Kid: folds 
KIDNIC: raises $0.75 to $1
mcdougal2: calls $1
jm_mathurin: calls $1
Stapher: folds 
Alameda22: folds 
quickkilllah: folds 
*** FLOP *** [5s Kd Ts]
KIDNIC: checks 
mcdougal2: checks 
jm_mathurin: bets $2
KIDNIC: folds 
mcdougal2: folds 
Uncalled bet ($2) returned to jm_mathurin
jm_mathurin collected $3.20 from pot
*** SUMMARY ***
Total pot $3.35 | Rake $0.15 
Board [5s Kd Ts]
Seat 1: quickkilllah (big blind) folded before Flop
Seat 2: Dakotah Kid folded before Flop (didn't bet)
Seat 3: KIDNIC folded on the Flop
Seat 4: mcdougal2 folded on the Flop
Seat 5: jm_mathurin collected ($3.20)
Seat 6: Stapher (button) folded before Flop (didn't bet)
Seat 9: Alameda22 (small blind) folded before Flop



PokerStars Game #19977078950:  Hold'em No Limit ($0.10/$0.25) - 2008/08/28 - 21:38:25 (ET)
Table 'Vesta III' 9-max Seat #9 is the button
Seat 1: quickkilllah ($22.85 in chips) 
Seat 2: Dakotah Kid ($13.70 in chips) 
Seat 3: KIDNIC ($12.55 in chips) 
Seat 4: mcdougal2 ($29.65 in chips) 
Seat 5: jm_mathurin ($36.05 in chips) 
Seat 6: Stapher ($19.55 in chips) 
Seat 7: thing93001 ($25 in chips) 
Seat 9: Alameda22 ($24.75 in chips) 
quickkilllah: posts small blind $0.10
Dakotah Kid: posts big blind $0.25
thing93001: posts big blind $0.25
*** HOLE CARDS ***
Dealt to Alameda22 [Ac Qd]
KIDNIC: folds 
mcdougal2: folds 
jm_mathurin: folds 
Stapher: folds 
thing93001: checks 
Alameda22: raises $0.75 to $1
quickkilllah: folds 
Dakotah Kid: folds 
thing93001: calls $0.75
*** FLOP *** [6d Js 5d]
thing93001: checks 
Alameda22: bets $1.50
thing93001: folds 
Uncalled bet ($1.50) returned to Alameda22
Alameda22 collected $2.25 from pot
Alameda22: doesn't show hand 
*** SUMMARY ***
Total pot $2.35 | Rake $0.10 
Board [6d Js 5d]
Seat 1: quickkilllah (small blind) folded before Flop
Seat 2: Dakotah Kid (big blind) folded before Flop
Seat 3: KIDNIC folded before Flop (didn't bet)
Seat 4: mcdougal2 folded before Flop (didn't bet)
Seat 5: jm_mathurin folded before Flop (didn't bet)
Seat 6: Stapher folded before Flop (didn't bet)
Seat 7: thing93001 folded on the Flop
Seat 9: Alameda22 (button) collected ($2.25)



PokerStars Game #19977103921:  Hold'em No Limit ($0.10/$0.25) - 2008/08/28 - 21:39:34 (ET)
Table 'Vesta III' 9-max Seat #1 is the button
Seat 1: quickkilllah ($22.75 in chips) 
Seat 2: Dakotah Kid ($13.45 in chips) 
Seat 3: KIDNIC ($12.55 in chips) 
Seat 4: mcdougal2 ($29.65 in chips) 
Seat 5: jm_mathurin ($36.05 in chips) 
Seat 6: Stapher ($19.55 in chips) 
Seat 7: thing93001 ($25 in chips) 
Seat 9: Alameda22 ($26 in chips) 
Dakotah Kid: posts small blind $0.10
KIDNIC: posts big blind $0.25
*** HOLE CARDS ***
Dealt to Alameda22 [9c 6c]
mcdougal2: folds 
jm_mathurin: folds 
Stapher: folds 
thing93001: folds 
Alameda22: folds 
quickkilllah: folds 
Dakotah Kid: calls $0.15
KIDNIC: checks 
*** FLOP *** [9s Qc Tc]
Dakotah Kid: checks 
KIDNIC: checks 
*** TURN *** [9s Qc Tc] [Js]
Dakotah Kid: checks 
KIDNIC: bets $0.75
Dakotah Kid: folds 
Uncalled bet ($0.75) returned to KIDNIC
KIDNIC collected $0.50 from pot
KIDNIC: shows [3d 4h] (high card Queen)
*** SUMMARY ***
Total pot $0.50 | Rake $0 
Board [9s Qc Tc Js]
Seat 1: quickkilllah (button) folded before Flop (didn't bet)
Seat 2: Dakotah Kid (small blind) folded on the Turn
Seat 3: KIDNIC (big blind) collected ($0.50)
Seat 4: mcdougal2 folded before Flop (didn't bet)
Seat 5: jm_mathurin folded before Flop (didn't bet)
Seat 6: Stapher folded before Flop (didn't bet)
Seat 7: thing93001 folded before Flop (didn't bet)
Seat 9: Alameda22 folded before Flop (didn't bet)



PokerStars Game #19977130539:  Hold'em No Limit ($0.10/$0.25) - 2008/08/28 - 21:40:48 (ET)
Table 'Vesta III' 9-max Seat #2 is the button
Seat 1: quickkilllah ($22.75 in chips) 
Seat 2: Dakotah Kid ($13.20 in chips) 
Seat 3: KIDNIC ($12.80 in chips) 
Seat 4: mcdougal2 ($29.65 in chips) 
Seat 5: jm_mathurin ($36.05 in chips) 
Seat 6: Stapher ($19.55 in chips) 
Seat 7: thing93001 ($25 in chips) 
Seat 9: Alameda22 ($26 in chips) 
KIDNIC: posts small blind $0.10
mcdougal2: posts big blind $0.25
*** HOLE CARDS ***
Dealt to Alameda22 [3d 2d]
jm_mathurin: folds 
Stapher: folds 
thing93001: folds 
Alameda22: folds 
quickkilllah: raises $0.75 to $1
Dakotah Kid: folds 
KIDNIC: folds 
mcdougal2: folds 
Uncalled bet ($0.75) returned to quickkilllah
quickkilllah collected $0.60 from pot
quickkilllah: doesn't show hand 
*** SUMMARY ***
Total pot $0.60 | Rake $0 
Seat 1: quickkilllah collected ($0.60)
Seat 2: Dakotah Kid (button) folded before Flop (didn't bet)
Seat 3: KIDNIC (small blind) folded before Flop
Seat 4: mcdougal2 (big blind) folded before Flop
Seat 5: jm_mathurin folded before Flop (didn't bet)
Seat 6: Stapher folded before Flop (didn't bet)
Seat 7: thing93001 folded before Flop (didn't bet)
Seat 9: Alameda22 folded before Flop (didn't bet)



PokerStars Game #19977142018:  Hold'em No Limit ($0.10/$0.25) - 2008/08/28 - 21:41:18 (ET)
Table 'Vesta III' 9-max Seat #3 is the button
Seat 1: quickkilllah ($23.10 in chips) 
Seat 2: Dakotah Kid ($13.20 in chips) 
Seat 3: KIDNIC ($12.70 in chips) 
Seat 4: mcdougal2 ($29.40 in chips) 
Seat 5: jm_mathurin ($36.05 in chips) 
Seat 6: Stapher ($19.55 in chips) 
Seat 7: thing93001 ($25 in chips) 
Seat 9: Alameda22 ($26 in chips) 
mcdougal2: posts small blind $0.10
jm_mathurin: posts big blind $0.25
*** HOLE CARDS ***
Dealt to Alameda22 [8c Qc]
Stapher: folds 
thing93001: folds 
Alameda22: folds 
quickkilllah: folds 
Dakotah Kid: folds 
KIDNIC: folds 
mcdougal2: calls $0.15
jm_mathurin: checks 
*** FLOP *** [9c 4d 8h]
mcdougal2: checks 
jm_mathurin: checks 
*** TURN *** [9c 4d 8h] [6s]
mcdougal2: checks 
jm_mathurin: checks 
*** RIVER *** [9c 4d 8h 6s] [6d]
mcdougal2: checks 
jm_mathurin: checks 
*** SHOW DOWN ***
mcdougal2: shows [Kc 5h] (a pair of Sixes)
jm_mathurin: mucks hand 
mcdougal2 collected $0.50 from pot
*** SUMMARY ***
Total pot $0.50 | Rake $0 
Board [9c 4d 8h 6s 6d]
Seat 1: quickkilllah folded before Flop (didn't bet)
Seat 2: Dakotah Kid folded before Flop (didn't bet)
Seat 3: KIDNIC (button) folded before Flop (didn't bet)
Seat 4: mcdougal2 (small blind) showed [Kc 5h] and won ($0.50) with a pair of Sixes
Seat 5: jm_mathurin (big blind) mucked [2h 3s]
Seat 6: Stapher folded before Flop (didn't bet)
Seat 7: thing93001 folded before Flop (didn't bet)
Seat 9: Alameda22 folded before Flop (didn't bet)



PokerStars Game #19977160668:  Hold'em No Limit ($0.10/$0.25) - 2008/08/28 - 21:42:10 (ET)
Table 'Vesta III' 9-max Seat #4 is the button
Seat 1: quickkilllah ($23.10 in chips) 
Seat 2: Dakotah Kid ($13.20 in chips) 
Seat 3: KIDNIC ($12.70 in chips) 
Seat 4: mcdougal2 ($29.65 in chips) 
Seat 5: jm_mathurin ($35.80 in chips) 
Seat 6: Stapher ($19.55 in chips) 
Seat 7: thing93001 ($25 in chips) 
Seat 9: Alameda22 ($26 in chips) 
jm_mathurin: posts small blind $0.10
Stapher: posts big blind $0.25
*** HOLE CARDS ***
Dealt to Alameda22 [Ts 8h]
thing93001: folds 
Alameda22: folds 
quickkilllah: folds 
Dakotah Kid: folds 
KIDNIC: calls $0.25
mcdougal2: folds 
jm_mathurin: folds 
Stapher: checks 
*** FLOP *** [8d 9s 4h]
Stapher: checks 
KIDNIC: checks 
*** TURN *** [8d 9s 4h] [3d]
Stapher: checks 
KIDNIC: bets $0.50
Stapher: folds 
Uncalled bet ($0.50) returned to KIDNIC
KIDNIC collected $0.60 from pot
*** SUMMARY ***
Total pot $0.60 | Rake $0 
Board [8d 9s 4h 3d]
Seat 1: quickkilllah folded before Flop (didn't bet)
Seat 2: Dakotah Kid folded before Flop (didn't bet)
Seat 3: KIDNIC collected ($0.60)
Seat 4: mcdougal2 (button) folded before Flop (didn't bet)
Seat 5: jm_mathurin (small blind) folded before Flop
Seat 6: Stapher (big blind) folded on the Turn
Seat 7: thing93001 folded before Flop (didn't bet)
Seat 9: Alameda22 folded before Flop (didn't bet)



PokerStars Game #19977177561:  Hold'em No Limit ($0.10/$0.25) - 2008/08/28 - 21:42:56 (ET)
Table 'Vesta III' 9-max Seat #5 is the button
Seat 1: quickkilllah ($23.10 in chips) 
Seat 2: Dakotah Kid ($13.20 in chips) 
Seat 3: KIDNIC ($13.05 in chips) 
Seat 4: mcdougal2 ($29.65 in chips) 
Seat 5: jm_mathurin ($35.70 in chips) 
Seat 6: Stapher ($19.30 in chips) 
Seat 7: thing93001 ($25 in chips) 
Seat 9: Alameda22 ($26 in chips) 
Stapher: posts small blind $0.10
thing93001: posts big blind $0.25
*** HOLE CARDS ***
Dealt to Alameda22 [2h Kc]
Alameda22: folds 
quickkilllah: folds 
Dakotah Kid: folds 
KIDNIC: folds 
mcdougal2: calls $0.25
jm_mathurin: folds 
Stapher: calls $0.15
thing93001: checks 
*** FLOP *** [5c 2c 3s]
Stapher: checks 
thing93001: checks 
mcdougal2: checks 
*** TURN *** [5c 2c 3s] [8s]
Stapher: bets $0.50
thing93001: folds 
mcdougal2: calls $0.50
*** RIVER *** [5c 2c 3s 8s] [Ac]
Stapher: checks 
mcdougal2: checks 
*** SHOW DOWN ***
Stapher: shows [6c 6h] (a pair of Sixes)
mcdougal2: shows [Jh 8h] (a pair of Eights)
mcdougal2 collected $1.70 from pot
*** SUMMARY ***
Total pot $1.75 | Rake $0.05 
Board [5c 2c 3s 8s Ac]
Seat 1: quickkilllah folded before Flop (didn't bet)
Seat 2: Dakotah Kid folded before Flop (didn't bet)
Seat 3: KIDNIC folded before Flop (didn't bet)
Seat 4: mcdougal2 showed [Jh 8h] and won ($1.70) with a pair of Eights
Seat 5: jm_mathurin (button) folded before Flop (didn't bet)
Seat 6: Stapher (small blind) showed [6c 6h] and lost with a pair of Sixes
Seat 7: thing93001 (big blind) folded on the Turn
Seat 9: Alameda22 folded before Flop (didn't bet)



PokerStars Game #19977202070:  Hold'em No Limit ($0.10/$0.25) - 2008/08/28 - 21:44:02 (ET)
Table 'Vesta III' 9-max Seat #6 is the button
Seat 1: quickkilllah ($23.10 in chips) 
Seat 2: Dakotah Kid ($13.20 in chips) 
Seat 3: KIDNIC ($13.05 in chips) 
Seat 4: mcdougal2 ($30.60 in chips) 
Seat 5: jm_mathurin ($35.70 in chips) 
Seat 6: Stapher ($18.55 in chips) 
Seat 7: thing93001 ($24.75 in chips) 
Seat 9: Alameda22 ($26 in chips) 
thing93001: posts small blind $0.10
Alameda22: posts big blind $0.25
*** HOLE CARDS ***
Dealt to Alameda22 [Js Qc]
quickkilllah: folds 
Dakotah Kid: folds 
KIDNIC: folds 
mcdougal2: raises $0.25 to $0.50
jm_mathurin: folds 
Stapher: folds 
thing93001: folds 
Alameda22: folds 
Uncalled bet ($0.25) returned to mcdougal2
mcdougal2 collected $0.60 from pot
mcdougal2: doesn't show hand 
*** SUMMARY ***
Total pot $0.60 | Rake $0 
Seat 1: quickkilllah folded before Flop (didn't bet)
Seat 2: Dakotah Kid folded before Flop (didn't bet)
Seat 3: KIDNIC folded before Flop (didn't bet)
Seat 4: mcdougal2 collected ($0.60)
Seat 5: jm_mathurin folded before Flop (didn't bet)
Seat 6: Stapher (button) folded before Flop (didn't bet)
Seat 7: thing93001 (small blind) folded before Flop
Seat 9: Alameda22 (big blind) folded before Flop



PokerStars Game #19977215991:  Hold'em No Limit ($0.10/$0.25) - 2008/08/28 - 21:44:40 (ET)
Table 'Vesta III' 9-max Seat #7 is the button
Seat 1: quickkilllah ($23.10 in chips) 
Seat 2: Dakotah Kid ($13.20 in chips) 
Seat 3: KIDNIC ($13.05 in chips) 
Seat 4: mcdougal2 ($30.95 in chips) 
Seat 5: jm_mathurin ($35.70 in chips) 
Seat 6: Stapher ($18.55 in chips) 
Seat 7: thing93001 ($24.65 in chips) 
Seat 9: Alameda22 ($25.75 in chips) 
Mr.JackPot81 was removed from the table for failing to post
Alameda22: posts small blind $0.10
quickkilllah: posts big blind $0.25
*** HOLE CARDS ***
Dealt to Alameda22 [Ks 7s]
Dakotah Kid: folds 
KIDNIC: folds 
mcdougal2: folds 
jm_mathurin: raises $1 to $1.25
Stapher: calls $1.25
thing93001: folds 
Alameda22: folds 
quickkilllah: folds 
*** FLOP *** [4s 4d 6h]
jm_mathurin: bets $1.75
Stapher: folds 
Uncalled bet ($1.75) returned to jm_mathurin
jm_mathurin collected $2.75 from pot
*** SUMMARY ***
Total pot $2.85 | Rake $0.10 
Board [4s 4d 6h]
Seat 1: quickkilllah (big blind) folded before Flop
Seat 2: Dakotah Kid folded before Flop (didn't bet)
Seat 3: KIDNIC folded before Flop (didn't bet)
Seat 4: mcdougal2 folded before Flop (didn't bet)
Seat 5: jm_mathurin collected ($2.75)
Seat 6: Stapher folded on the Flop
Seat 7: thing93001 (button) folded before Flop (didn't bet)
Seat 9: Alameda22 (small blind) folded before Flop



PokerStars Game #19977239153:  Hold'em No Limit ($0.10/$0.25) - 2008/08/28 - 21:45:42 (ET)
Table 'Vesta III' 9-max Seat #9 is the button
Seat 1: quickkilllah ($22.85 in chips) 
Seat 2: Dakotah Kid ($13.20 in chips) 
Seat 3: KIDNIC ($13.05 in chips) 
Seat 4: mcdougal2 ($30.95 in chips) 
Seat 5: jm_mathurin ($37.20 in chips) 
Seat 6: Stapher ($17.30 in chips) 
Seat 7: thing93001 ($24.65 in chips) 
Seat 9: Alameda22 ($25.65 in chips) 
quickkilllah: posts small blind $0.10
Dakotah Kid: posts big blind $0.25
*** HOLE CARDS ***
Dealt to Alameda22 [As 9s]
KIDNIC: folds 
mcdougal2: folds 
jm_mathurin: folds 
Stapher: folds 
thing93001: folds 
Alameda22: raises $0.50 to $0.75
quickkilllah: folds 
Dakotah Kid: folds 
Uncalled bet ($0.50) returned to Alameda22
Alameda22 collected $0.60 from pot
Alameda22: doesn't show hand 
*** SUMMARY ***
Total pot $0.60 | Rake $0 
Seat 1: quickkilllah (small blind) folded before Flop
Seat 2: Dakotah Kid (big blind) folded before Flop
Seat 3: KIDNIC folded before Flop (didn't bet)
Seat 4: mcdougal2 folded before Flop (didn't bet)
Seat 5: jm_mathurin folded before Flop (didn't bet)
Seat 6: Stapher folded before Flop (didn't bet)
Seat 7: thing93001 folded before Flop (didn't bet)
Seat 9: Alameda22 (button) collected ($0.60)



PokerStars Game #19977256515:  Hold'em No Limit ($0.10/$0.25) - 2008/08/28 - 21:46:29 (ET)
Table 'Vesta III' 9-max Seat #1 is the button
Seat 1: quickkilllah ($22.75 in chips) 
Seat 2: Dakotah Kid ($12.95 in chips) 
Seat 3: KIDNIC ($13.05 in chips) 
Seat 4: mcdougal2 ($30.95 in chips) 
Seat 5: jm_mathurin ($37.20 in chips) 
Seat 6: Stapher ($17.30 in chips) 
Seat 7: thing93001 ($24.65 in chips) 
Seat 9: Alameda22 ($26 in chips) 
Dakotah Kid: posts small blind $0.10
KIDNIC: posts big blind $0.25
*** HOLE CARDS ***
Dealt to Alameda22 [3s 6s]
mcdougal2: folds 
jm_mathurin: folds 
mauro320 joins the table at seat #8 
Stapher: folds 
thing93001: folds 
Alameda22: folds 
quickkilllah: folds 
Dakotah Kid: calls $0.15
KIDNIC: checks 
*** FLOP *** [7c Ts Ks]
Dakotah Kid: checks 
KIDNIC: checks 
*** TURN *** [7c Ts Ks] [8c]
Dakotah Kid: checks 
KIDNIC: checks 
*** RIVER *** [7c Ts Ks 8c] [Tc]
Dakotah Kid: checks 
KIDNIC: bets $1.75
Dakotah Kid: calls $1.75
*** SHOW DOWN ***
KIDNIC: shows [5s 2c] (a pair of Tens)
Dakotah Kid: shows [6c 6h] (two pair, Tens and Sixes)
Dakotah Kid collected $3.80 from pot
*** SUMMARY ***
Total pot $4 | Rake $0.20 
Board [7c Ts Ks 8c Tc]
Seat 1: quickkilllah (button) folded before Flop (didn't bet)
Seat 2: Dakotah Kid (small blind) showed [6c 6h] and won ($3.80) with two pair, Tens and Sixes
Seat 3: KIDNIC (big blind) showed [5s 2c] and lost with a pair of Tens
Seat 4: mcdougal2 folded before Flop (didn't bet)
Seat 5: jm_mathurin folded before Flop (didn't bet)
Seat 6: Stapher folded before Flop (didn't bet)
Seat 7: thing93001 folded before Flop (didn't bet)
Seat 9: Alameda22 folded before Flop (didn't bet)



PokerStars Game #19977292410:  Hold'em No Limit ($0.10/$0.25) - 2008/08/28 - 21:48:05 (ET)
Table 'Vesta III' 9-max Seat #2 is the button
Seat 1: quickkilllah ($22.75 in chips) 
Seat 2: Dakotah Kid ($14.75 in chips) 
Seat 3: KIDNIC ($11.05 in chips) 
Seat 4: mcdougal2 ($30.95 in chips) 
Seat 5: jm_mathurin ($37.20 in chips) 
Seat 6: Stapher ($17.30 in chips) 
Seat 7: thing93001 ($24.65 in chips) 
Seat 8: mauro320 ($10 in chips) 
Seat 9: Alameda22 ($26 in chips) 
KIDNIC: posts small blind $0.10
mcdougal2: posts big blind $0.25
mauro320: posts big blind $0.25
*** HOLE CARDS ***
Dealt to Alameda22 [Qd 4s]
jm_mathurin: folds 
Stapher: folds 
thing93001: raises $0.75 to $1
mauro320: calls $0.75
Alameda22: folds 
quickkilllah: folds 
Dakotah Kid: folds 
KIDNIC: folds 
mcdougal2: folds 
*** FLOP *** [Jc Kc Kh]
thing93001: checks 
mauro320: checks 
*** TURN *** [Jc Kc Kh] [7d]
thing93001: bets $1.50
mauro320: calls $1.50
*** RIVER *** [Jc Kc Kh 7d] [8c]
thing93001: checks 
mauro320: checks 
*** SHOW DOWN ***
thing93001: shows [6s 6h] (two pair, Kings and Sixes)
mauro320: shows [8s 9c] (two pair, Kings and Eights)
mauro320 collected $5.10 from pot
*** SUMMARY ***
Total pot $5.35 | Rake $0.25 
Board [Jc Kc Kh 7d 8c]
Seat 1: quickkilllah folded before Flop (didn't bet)
Seat 2: Dakotah Kid (button) folded before Flop (didn't bet)
Seat 3: KIDNIC (small blind) folded before Flop
Seat 4: mcdougal2 (big blind) folded before Flop
Seat 5: jm_mathurin folded before Flop (didn't bet)
Seat 6: Stapher folded before Flop (didn't bet)
Seat 7: thing93001 showed [6s 6h] and lost with two pair, Kings and Sixes
Seat 8: mauro320 showed [8s 9c] and won ($5.10) with two pair, Kings and Eights
Seat 9: Alameda22 folded before Flop (didn't bet)



PokerStars Game #19977318564:  Hold'em No Limit ($0.10/$0.25) - 2008/08/28 - 21:49:16 (ET)
Table 'Vesta III' 9-max Seat #3 is the button
Seat 1: quickkilllah ($22.75 in chips) 
Seat 2: Dakotah Kid ($14.75 in chips) 
Seat 3: KIDNIC ($10.95 in chips) 
Seat 4: mcdougal2 ($30.70 in chips) 
Seat 5: jm_mathurin ($37.20 in chips) 
Seat 6: Stapher ($17.30 in chips) 
Seat 7: thing93001 ($22.15 in chips) 
Seat 8: mauro320 ($12.60 in chips) 
Seat 9: Alameda22 ($26 in chips) 
mcdougal2: posts small blind $0.10
jm_mathurin: posts big blind $0.25
*** HOLE CARDS ***
Dealt to Alameda22 [5d Th]
Stapher: folds 
thing93001: folds 
mauro320: calls $0.25
Alameda22: folds 
quickkilllah: folds 
Dakotah Kid: calls $0.25
KIDNIC: calls $0.25
mcdougal2: calls $0.15
jm_mathurin: raises $1.25 to $1.50
mauro320: calls $1.25
Dakotah Kid: folds 
KIDNIC: folds 
mcdougal2: folds 
*** FLOP *** [2c Ah Qd]
jm_mathurin: bets $2.75
mauro320: folds 
Uncalled bet ($2.75) returned to jm_mathurin
jm_mathurin collected $3.60 from pot
*** SUMMARY ***
Total pot $3.75 | Rake $0.15 
Board [2c Ah Qd]
Seat 1: quickkilllah folded before Flop (didn't bet)
Seat 2: Dakotah Kid folded before Flop
Seat 3: KIDNIC (button) folded before Flop
Seat 4: mcdougal2 (small blind) folded before Flop
Seat 5: jm_mathurin (big blind) collected ($3.60)
Seat 6: Stapher folded before Flop (didn't bet)
Seat 7: thing93001 folded before Flop (didn't bet)
Seat 8: mauro320 folded on the Flop
Seat 9: Alameda22 folded before Flop (didn't bet)



PokerStars Game #19977343272:  Hold'em No Limit ($0.10/$0.25) - 2008/08/28 - 21:50:22 (ET)
Table 'Vesta III' 9-max Seat #4 is the button
Seat 1: quickkilllah ($22.75 in chips) 
Seat 2: Dakotah Kid ($14.50 in chips) 
Seat 3: KIDNIC ($10.70 in chips) 
Seat 4: mcdougal2 ($30.45 in chips) 
Seat 5: jm_mathurin ($39.30 in chips) 
Seat 6: Stapher ($17.30 in chips) 
Seat 7: thing93001 ($25 in chips) 
Seat 8: mauro320 ($11.10 in chips) 
Seat 9: Alameda22 ($26 in chips) 
jm_mathurin: posts small blind $0.10
Stapher: posts big blind $0.25
*** HOLE CARDS ***
Dealt to Alameda22 [4c 2d]
thing93001: folds 
mauro320: calls $0.25
Alameda22: folds 
quickkilllah: folds 
Dakotah Kid: folds 
KIDNIC: folds 
mcdougal2: folds 
jm_mathurin: calls $0.15
Stapher: checks 
*** FLOP *** [9c 9s Jh]
jm_mathurin: checks 
Stapher: bets $0.50
mauro320: calls $0.50
jm_mathurin: folds 
*** TURN *** [9c 9s Jh] [Kh]
Stapher: bets $1
mauro320: calls $1
*** RIVER *** [9c 9s Jh Kh] [Ks]
Stapher: bets $2.25
mauro320: calls $2.25
*** SHOW DOWN ***
Stapher: shows [3h 9h] (a full house, Nines full of Kings)
mauro320: mucks hand 
mauro320 is sitting out
Stapher collected $7.85 from pot
*** SUMMARY ***
Total pot $8.25 | Rake $0.40 
Board [9c 9s Jh Kh Ks]
Seat 1: quickkilllah folded before Flop (didn't bet)
Seat 2: Dakotah Kid folded before Flop (didn't bet)
Seat 3: KIDNIC folded before Flop (didn't bet)
Seat 4: mcdougal2 (button) folded before Flop (didn't bet)
Seat 5: jm_mathurin (small blind) folded on the Flop
Seat 6: Stapher (big blind) showed [3h 9h] and won ($7.85) with a full house, Nines full of Kings
Seat 7: thing93001 folded before Flop (didn't bet)
Seat 8: mauro320 mucked [Js Tc]
Seat 9: Alameda22 folded before Flop (didn't bet)



PokerStars Game #19977374889:  Hold'em No Limit ($0.10/$0.25) - 2008/08/28 - 21:51:48 (ET)
Table 'Vesta III' 9-max Seat #5 is the button
Seat 1: quickkilllah ($22.75 in chips) 
Seat 2: Dakotah Kid ($14.50 in chips) 
Seat 3: KIDNIC ($10.70 in chips) 
Seat 4: mcdougal2 ($30.45 in chips) 
Seat 5: jm_mathurin ($39.05 in chips) 
Seat 6: Stapher ($21.15 in chips) 
Seat 7: thing93001 ($25 in chips) 
Seat 9: Alameda22 ($26 in chips) 
Stapher: posts small blind $0.10
thing93001: posts big blind $0.25
*** HOLE CARDS ***
Dealt to Alameda22 [Ts 9s]
Alameda22: folds 
quickkilllah: folds 
Dakotah Kid: folds 
KIDNIC: calls $0.25
mcdougal2: folds 
jm_mathurin: folds 
Stapher: raises $0.75 to $1
thing93001: folds 
KIDNIC: folds 
Uncalled bet ($0.75) returned to Stapher
Stapher collected $0.75 from pot
Stapher: doesn't show hand 
*** SUMMARY ***
Total pot $0.75 | Rake $0 
Seat 1: quickkilllah folded before Flop (didn't bet)
Seat 2: Dakotah Kid folded before Flop (didn't bet)
Seat 3: KIDNIC folded before Flop
Seat 4: mcdougal2 folded before Flop (didn't bet)
Seat 5: jm_mathurin (button) folded before Flop (didn't bet)
Seat 6: Stapher (small blind) collected ($0.75)
Seat 7: thing93001 (big blind) folded before Flop
Seat 9: Alameda22 folded before Flop (didn't bet)



PokerStars Game #19977393810:  Hold'em No Limit ($0.10/$0.25) - 2008/08/28 - 21:52:39 (ET)
Table 'Vesta III' 9-max Seat #6 is the button
Seat 1: quickkilllah ($22.75 in chips) 
Seat 2: Dakotah Kid ($14.50 in chips) 
Seat 3: KIDNIC ($10.45 in chips) 
Seat 4: mcdougal2 ($30.45 in chips) 
Seat 5: jm_mathurin ($39.05 in chips) 
Seat 6: Stapher ($21.65 in chips) 
Seat 7: thing93001 ($24.75 in chips) 
Seat 9: Alameda22 ($26 in chips) 
thing93001: posts small blind $0.10
Alameda22: posts big blind $0.25
*** HOLE CARDS ***
Dealt to Alameda22 [3c 2d]
quickkilllah: folds 
Dakotah Kid: folds 
KIDNIC: raises $0.25 to $0.50
mcdougal2: calls $0.50
jm_mathurin: folds 
Stapher: folds 
thing93001: raises $2 to $2.50
Alameda22: folds 
KIDNIC: folds 
mcdougal2: folds 
Uncalled bet ($2) returned to thing93001
thing93001 collected $1.75 from pot
thing93001: doesn't show hand 
*** SUMMARY ***
Total pot $1.75 | Rake $0 
Seat 1: quickkilllah folded before Flop (didn't bet)
Seat 2: Dakotah Kid folded before Flop (didn't bet)
Seat 3: KIDNIC folded before Flop
Seat 4: mcdougal2 folded before Flop
Seat 5: jm_mathurin folded before Flop (didn't bet)
Seat 6: Stapher (button) folded before Flop (didn't bet)
Seat 7: thing93001 (small blind) collected ($1.75)
Seat 9: Alameda22 (big blind) folded before Flop



PokerStars Game #19977413680:  Hold'em No Limit ($0.10/$0.25) - 2008/08/28 - 21:53:33 (ET)
Table 'Vesta III' 9-max Seat #7 is the button
Seat 1: quickkilllah ($22.75 in chips) 
Seat 2: Dakotah Kid ($14.50 in chips) 
Seat 3: KIDNIC ($9.95 in chips) 
Seat 4: mcdougal2 ($29.95 in chips) 
Seat 5: jm_mathurin ($39.05 in chips) 
Seat 6: Stapher ($21.65 in chips) 
Seat 7: thing93001 ($26 in chips) 
Seat 9: Alameda22 ($25.75 in chips) 
Alameda22: posts small blind $0.10
quickkilllah: posts big blind $0.25
*** HOLE CARDS ***
Dealt to Alameda22 [Ks Js]
Dakotah Kid: folds 
KIDNIC: folds 
mcdougal2: folds 
jm_mathurin: folds 
Stapher: folds 
thing93001: folds 
Alameda22: calls $0.15
quickkilllah: checks 
*** FLOP *** [2h 4s 9s]
Alameda22: bets $0.50
quickkilllah: folds 
Uncalled bet ($0.50) returned to Alameda22
Alameda22 collected $0.50 from pot
Alameda22: doesn't show hand 
*** SUMMARY ***
Total pot $0.50 | Rake $0 
Board [2h 4s 9s]
Seat 1: quickkilllah (big blind) folded on the Flop
Seat 2: Dakotah Kid folded before Flop (didn't bet)
Seat 3: KIDNIC folded before Flop (didn't bet)
Seat 4: mcdougal2 folded before Flop (didn't bet)
Seat 5: jm_mathurin folded before Flop (didn't bet)
Seat 6: Stapher folded before Flop (didn't bet)
Seat 7: thing93001 (button) folded before Flop (didn't bet)
Seat 9: Alameda22 (small blind) collected ($0.50)



PokerStars Game #19977433278:  Hold'em No Limit ($0.10/$0.25) - 2008/08/28 - 21:54:26 (ET)
Table 'Vesta III' 9-max Seat #9 is the button
Seat 1: quickkilllah ($22.50 in chips) 
Seat 2: Dakotah Kid ($14.50 in chips) 
Seat 3: KIDNIC ($9.95 in chips) 
Seat 4: mcdougal2 ($29.95 in chips) 
Seat 5: jm_mathurin ($39.05 in chips) 
Seat 6: Stapher ($21.65 in chips) 
Seat 7: thing93001 ($26 in chips) 
Seat 9: Alameda22 ($26 in chips) 
quickkilllah: posts small blind $0.10
Dakotah Kid: posts big blind $0.25
*** HOLE CARDS ***
Dealt to Alameda22 [5h Kc]
KIDNIC: folds 
mcdougal2: folds 
jm_mathurin: raises $0.75 to $1
Stapher: folds 
thing93001: folds 
Alameda22: folds 
quickkilllah: folds 
Dakotah Kid: folds 
Uncalled bet ($0.75) returned to jm_mathurin
jm_mathurin collected $0.60 from pot
*** SUMMARY ***
Total pot $0.60 | Rake $0 
Seat 1: quickkilllah (small blind) folded before Flop
Seat 2: Dakotah Kid (big blind) folded before Flop
Seat 3: KIDNIC folded before Flop (didn't bet)
Seat 4: mcdougal2 folded before Flop (didn't bet)
Seat 5: jm_mathurin collected ($0.60)
Seat 6: Stapher folded before Flop (didn't bet)
Seat 7: thing93001 folded before Flop (didn't bet)
Seat 9: Alameda22 (button) folded before Flop (didn't bet)



PokerStars Game #19977451515:  Hold'em No Limit ($0.10/$0.25) - 2008/08/28 - 21:55:16 (ET)
Table 'Vesta III' 9-max Seat #1 is the button
Seat 1: quickkilllah ($22.40 in chips) 
Seat 2: Dakotah Kid ($14.25 in chips) 
Seat 3: KIDNIC ($9.95 in chips) 
Seat 4: mcdougal2 ($29.95 in chips) 
Seat 5: jm_mathurin ($39.40 in chips) 
Seat 6: Stapher ($21.65 in chips) 
Seat 7: thing93001 ($26 in chips) 
Seat 9: Alameda22 ($26 in chips) 
Dakotah Kid: posts small blind $0.10
KIDNIC: posts big blind $0.25
*** HOLE CARDS ***
Dealt to Alameda22 [9h Ac]
mcdougal2: folds 
jm_mathurin: folds 
Stapher: folds 
thing93001: raises $0.50 to $0.75
Alameda22: folds 
quickkilllah: folds 
Dakotah Kid: folds 
KIDNIC: folds 
Uncalled bet ($0.50) returned to thing93001
thing93001 collected $0.60 from pot
thing93001: doesn't show hand 
*** SUMMARY ***
Total pot $0.60 | Rake $0 
Seat 1: quickkilllah (button) folded before Flop (didn't bet)
Seat 2: Dakotah Kid (small blind) folded before Flop
Seat 3: KIDNIC (big blind) folded before Flop
Seat 4: mcdougal2 folded before Flop (didn't bet)
Seat 5: jm_mathurin folded before Flop (didn't bet)
Seat 6: Stapher folded before Flop (didn't bet)
Seat 7: thing93001 collected ($0.60)
Seat 9: Alameda22 folded before Flop (didn't bet)



PokerStars Game #19977461202:  Hold'em No Limit ($0.10/$0.25) - 2008/08/28 - 21:55:43 (ET)
Table 'Vesta III' 9-max Seat #2 is the button
Seat 1: quickkilllah ($22.40 in chips) 
Seat 2: Dakotah Kid ($14.15 in chips) 
Seat 3: KIDNIC ($9.70 in chips) 
Seat 4: mcdougal2 ($29.95 in chips) 
Seat 5: jm_mathurin ($39.40 in chips) 
Seat 6: Stapher ($21.65 in chips) 
Seat 7: thing93001 ($26.35 in chips) 
Seat 9: Alameda22 ($26 in chips) 
KIDNIC: posts small blind $0.10
mcdougal2: posts big blind $0.25
*** HOLE CARDS ***
Dealt to Alameda22 [2c 4h]
jm_mathurin: calls $0.25
Stapher: folds 
thing93001: folds 
Alameda22: folds 
quickkilllah: raises $1 to $1.25
Dakotah Kid: folds 
KIDNIC: folds 
mcdougal2: calls $1
jm_mathurin: calls $1
*** FLOP *** [6c 3h Ts]
mcdougal2: checks 
jm_mathurin: checks 
quickkilllah: bets $2
mcdougal2: folds 
jm_mathurin: folds 
Uncalled bet ($2) returned to quickkilllah
quickkilllah collected $3.70 from pot
quickkilllah: doesn't show hand 
*** SUMMARY ***
Total pot $3.85 | Rake $0.15 
Board [6c 3h Ts]
Seat 1: quickkilllah collected ($3.70)
Seat 2: Dakotah Kid (button) folded before Flop (didn't bet)
Seat 3: KIDNIC (small blind) folded before Flop
Seat 4: mcdougal2 (big blind) folded on the Flop
Seat 5: jm_mathurin folded on the Flop
Seat 6: Stapher folded before Flop (didn't bet)
Seat 7: thing93001 folded before Flop (didn't bet)
Seat 9: Alameda22 folded before Flop (didn't bet)



PokerStars Game #19977486411:  Hold'em No Limit ($0.10/$0.25) - 2008/08/28 - 21:56:52 (ET)
Table 'Vesta III' 9-max Seat #3 is the button
Seat 1: quickkilllah ($24.85 in chips) 
Seat 2: Dakotah Kid ($14.15 in chips) 
Seat 3: KIDNIC ($9.60 in chips) 
Seat 4: mcdougal2 ($28.70 in chips) 
Seat 5: jm_mathurin ($38.15 in chips) 
Seat 6: Stapher ($21.65 in chips) 
Seat 7: thing93001 ($26.35 in chips) 
Seat 9: Alameda22 ($26 in chips) 
mcdougal2: posts small blind $0.10
jm_mathurin: posts big blind $0.25
*** HOLE CARDS ***
Dealt to Alameda22 [8h Jd]
Stapher: folds 
brujo120 joins the table at seat #8 
thing93001: raises $0.50 to $0.75
Alameda22: folds 
quickkilllah: folds 
Dakotah Kid: folds 
KIDNIC: folds 
mcdougal2: folds 
jm_mathurin: folds 
Uncalled bet ($0.50) returned to thing93001
thing93001 collected $0.60 from pot
thing93001: doesn't show hand 
*** SUMMARY ***
Total pot $0.60 | Rake $0 
Seat 1: quickkilllah folded before Flop (didn't bet)
Seat 2: Dakotah Kid folded before Flop (didn't bet)
Seat 3: KIDNIC (button) folded before Flop (didn't bet)
Seat 4: mcdougal2 (small blind) folded before Flop
Seat 5: jm_mathurin (big blind) folded before Flop
Seat 6: Stapher folded before Flop (didn't bet)
Seat 7: thing93001 collected ($0.60)
Seat 9: Alameda22 folded before Flop (didn't bet)



PokerStars Game #19977506485:  Hold'em No Limit ($0.10/$0.25) - 2008/08/28 - 21:57:47 (ET)
Table 'Vesta III' 9-max Seat #4 is the button
Seat 1: quickkilllah ($24.85 in chips) 
Seat 2: Dakotah Kid ($14.15 in chips) 
Seat 3: KIDNIC ($9.60 in chips) 
Seat 4: mcdougal2 ($28.60 in chips) 
Seat 5: jm_mathurin ($37.90 in chips) 
Seat 6: Stapher ($21.65 in chips) 
Seat 7: thing93001 ($26.70 in chips) 
Seat 8: brujo120 ($15 in chips) 
Seat 9: Alameda22 ($26 in chips) 
jm_mathurin: posts small blind $0.10
Stapher: posts big blind $0.25
brujo120: posts big blind $0.25
*** HOLE CARDS ***
Dealt to Alameda22 [Qd 7c]
thing93001: folds 
brujo120: checks 
Alameda22: folds 
quickkilllah: folds 
Dakotah Kid: folds 
KIDNIC: folds 
mcdougal2: folds 
jm_mathurin: folds 
Stapher: checks 
*** FLOP *** [4d 3h Ad]
Stapher: checks 
brujo120: bets $0.50
Stapher: folds 
Uncalled bet ($0.50) returned to brujo120
brujo120 collected $0.60 from pot
brujo120: doesn't show hand 
*** SUMMARY ***
Total pot $0.60 | Rake $0 
Board [4d 3h Ad]
Seat 1: quickkilllah folded before Flop (didn't bet)
Seat 2: Dakotah Kid folded before Flop (didn't bet)
Seat 3: KIDNIC folded before Flop (didn't bet)
Seat 4: mcdougal2 (button) folded before Flop (didn't bet)
Seat 5: jm_mathurin (small blind) folded before Flop
Seat 6: Stapher (big blind) folded on the Flop
Seat 7: thing93001 folded before Flop (didn't bet)
Seat 8: brujo120 collected ($0.60)
Seat 9: Alameda22 folded before Flop (didn't bet)



PokerStars Game #19977521803:  Hold'em No Limit ($0.10/$0.25) - 2008/08/28 - 21:58:29 (ET)
Table 'Vesta III' 9-max Seat #5 is the button
Seat 1: quickkilllah ($24.85 in chips) 
Seat 2: Dakotah Kid ($14.15 in chips) 
Seat 3: KIDNIC ($9.60 in chips) 
Seat 4: mcdougal2 ($28.60 in chips) 
Seat 5: jm_mathurin ($37.80 in chips) 
Seat 6: Stapher ($21.40 in chips) 
Seat 7: thing93001 ($26.70 in chips) 
Seat 8: brujo120 ($15.35 in chips) 
Seat 9: Alameda22 ($26 in chips) 
Stapher: posts small blind $0.10
thing93001: posts big blind $0.25
*** HOLE CARDS ***
Dealt to Alameda22 [Ts 5c]
brujo120: folds 
Alameda22: folds 
quickkilllah: folds 
Dakotah Kid: folds 
KIDNIC: folds 
mcdougal2: folds 
jm_mathurin: raises $0.75 to $1
Stapher: folds 
thing93001: folds 
Uncalled bet ($0.75) returned to jm_mathurin
jm_mathurin collected $0.60 from pot
*** SUMMARY ***
Total pot $0.60 | Rake $0 
Seat 1: quickkilllah folded before Flop (didn't bet)
Seat 2: Dakotah Kid folded before Flop (didn't bet)
Seat 3: KIDNIC folded before Flop (didn't bet)
Seat 4: mcdougal2 folded before Flop (didn't bet)
Seat 5: jm_mathurin (button) collected ($0.60)
Seat 6: Stapher (small blind) folded before Flop
Seat 7: thing93001 (big blind) folded before Flop
Seat 8: brujo120 folded before Flop (didn't bet)
Seat 9: Alameda22 folded before Flop (didn't bet)



PokerStars Game #19977538701:  Hold'em No Limit ($0.10/$0.25) - 2008/08/28 - 21:59:16 (ET)
Table 'Vesta III' 9-max Seat #6 is the button
Seat 1: quickkilllah ($24.85 in chips) 
Seat 2: Dakotah Kid ($14.15 in chips) 
Seat 3: KIDNIC ($9.60 in chips) 
Seat 4: mcdougal2 ($28.60 in chips) 
Seat 5: jm_mathurin ($38.15 in chips) 
Seat 6: Stapher ($21.30 in chips) 
Seat 7: thing93001 ($26.45 in chips) 
Seat 8: brujo120 ($15.35 in chips) 
Seat 9: Alameda22 ($26 in chips) 
thing93001: posts small blind $0.10
brujo120: posts big blind $0.25
*** HOLE CARDS ***
Dealt to Alameda22 [Kc Jh]
Alameda22: folds 
quickkilllah: folds 
Dakotah Kid: folds 
KIDNIC: calls $0.25
mcdougal2: folds 
jm_mathurin: folds 
Stapher: folds 
thing93001: folds 
brujo120: checks 
*** FLOP *** [Jd Ah 6c]
brujo120: checks 
KIDNIC: bets $0.50
brujo120: folds 
Uncalled bet ($0.50) returned to KIDNIC
KIDNIC collected $0.60 from pot
KIDNIC: doesn't show hand 
*** SUMMARY ***
Total pot $0.60 | Rake $0 
Board [Jd Ah 6c]
Seat 1: quickkilllah folded before Flop (didn't bet)
Seat 2: Dakotah Kid folded before Flop (didn't bet)
Seat 3: KIDNIC collected ($0.60)
Seat 4: mcdougal2 folded before Flop (didn't bet)
Seat 5: jm_mathurin folded before Flop (didn't bet)
Seat 6: Stapher (button) folded before Flop (didn't bet)
Seat 7: thing93001 (small blind) folded before Flop
Seat 8: brujo120 (big blind) folded on the Flop
Seat 9: Alameda22 folded before Flop (didn't bet)



PokerStars Game #19977555970:  Hold'em No Limit ($0.10/$0.25) - 2008/08/28 - 22:00:01 (ET)
Table 'Vesta III' 9-max Seat #7 is the button
Seat 1: quickkilllah ($24.85 in chips) 
Seat 2: Dakotah Kid ($14.15 in chips) 
Seat 3: KIDNIC ($9.95 in chips) 
Seat 4: mcdougal2 ($28.60 in chips) 
Seat 5: jm_mathurin ($38.15 in chips) 
Seat 6: Stapher ($21.30 in chips) 
Seat 7: thing93001 ($26.35 in chips) 
Seat 8: brujo120 ($15.10 in chips) 
Seat 9: Alameda22 ($26 in chips) 
brujo120: posts small blind $0.10
Alameda22: posts big blind $0.25
*** HOLE CARDS ***
Dealt to Alameda22 [Qh 4s]
quickkilllah: folds 
Dakotah Kid: folds 
KIDNIC: folds 
mcdougal2: folds 
jm_mathurin: folds 
Stapher: folds 
thing93001: folds 
brujo120: calls $0.15
Alameda22: checks 
*** FLOP *** [6c 2s 2d]
brujo120: checks 
Alameda22: checks 
*** TURN *** [6c 2s 2d] [6s]
brujo120: checks 
Alameda22: checks 
*** RIVER *** [6c 2s 2d 6s] [Ks]
brujo120: checks 
Alameda22: checks 
*** SHOW DOWN ***
brujo120: shows [4h 5h] (two pair, Sixes and Deuces)
Alameda22: shows [Qh 4s] (two pair, Sixes and Deuces)
brujo120 collected $0.25 from pot
Alameda22 collected $0.25 from pot
*** SUMMARY ***
Total pot $0.50 | Rake $0 
Board [6c 2s 2d 6s Ks]
Seat 1: quickkilllah folded before Flop (didn't bet)
Seat 2: Dakotah Kid folded before Flop (didn't bet)
Seat 3: KIDNIC folded before Flop (didn't bet)
Seat 4: mcdougal2 folded before Flop (didn't bet)
Seat 5: jm_mathurin folded before Flop (didn't bet)
Seat 6: Stapher folded before Flop (didn't bet)
Seat 7: thing93001 (button) folded before Flop (didn't bet)
Seat 8: brujo120 (small blind) showed [4h 5h] and won ($0.25) with two pair, Sixes and Deuces
Seat 9: Alameda22 (big blind) showed [Qh 4s] and won ($0.25) with two pair, Sixes and Deuces



PokerStars Game #19977585726:  Hold'em No Limit ($0.10/$0.25) - 2008/08/28 - 22:01:21 (ET)
Table 'Vesta III' 9-max Seat #8 is the button
Seat 1: quickkilllah ($24.85 in chips) 
Seat 2: Dakotah Kid ($14.15 in chips) 
Seat 3: KIDNIC ($9.95 in chips) 
Seat 4: mcdougal2 ($28.60 in chips) 
Seat 5: jm_mathurin ($38.15 in chips) 
Seat 6: Stapher ($21.30 in chips) 
Seat 7: thing93001 ($26.35 in chips) 
Seat 8: brujo120 ($15.10 in chips) 
Seat 9: Alameda22 ($26 in chips) 
Alameda22: posts small blind $0.10
quickkilllah: posts big blind $0.25
*** HOLE CARDS ***
Dealt to Alameda22 [4s Jh]
Dakotah Kid: folds 
KIDNIC: folds 
mcdougal2: folds 
jm_mathurin: folds 
Stapher: folds 
thing93001: folds 
brujo120: folds 
Alameda22: folds 
Uncalled bet ($0.15) returned to quickkilllah
quickkilllah collected $0.20 from pot
quickkilllah: doesn't show hand 
*** SUMMARY ***
Total pot $0.20 | Rake $0 
Seat 1: quickkilllah (big blind) collected ($0.20)
Seat 2: Dakotah Kid folded before Flop (didn't bet)
Seat 3: KIDNIC folded before Flop (didn't bet)
Seat 4: mcdougal2 folded before Flop (didn't bet)
Seat 5: jm_mathurin folded before Flop (didn't bet)
Seat 6: Stapher folded before Flop (didn't bet)
Seat 7: thing93001 folded before Flop (didn't bet)
Seat 8: brujo120 (button) folded before Flop (didn't bet)
Seat 9: Alameda22 (small blind) folded before Flop



PokerStars Game #19977601621:  Hold'em No Limit ($0.10/$0.25) - 2008/08/28 - 22:02:05 (ET)
Table 'Vesta III' 9-max Seat #9 is the button
Seat 1: quickkilllah ($24.95 in chips) 
Seat 2: Dakotah Kid ($14.15 in chips) 
Seat 3: KIDNIC ($9.95 in chips) 
Seat 4: mcdougal2 ($28.60 in chips) 
Seat 5: jm_mathurin ($38.15 in chips) 
Seat 6: Stapher ($21.30 in chips) 
Seat 7: thing93001 ($26.35 in chips) 
Seat 8: brujo120 ($15.10 in chips) 
Seat 9: Alameda22 ($25.90 in chips) 
quickkilllah: posts small blind $0.10
Dakotah Kid: posts big blind $0.25
*** HOLE CARDS ***
Dealt to Alameda22 [5h Kd]
KIDNIC: folds 
mcdougal2: folds 
jm_mathurin: folds 
Stapher: folds 
thing93001: folds 
brujo120: folds 
Alameda22: folds 
quickkilllah: raises $0.50 to $0.75
Dakotah Kid: calls $0.50
*** FLOP *** [Ad 8c Jd]
quickkilllah: checks 
Dakotah Kid: bets $0.50
quickkilllah: calls $0.50
*** TURN *** [Ad 8c Jd] [2h]
quickkilllah: checks 
Dakotah Kid: bets $0.50
quickkilllah: calls $0.50
*** RIVER *** [Ad 8c Jd 2h] [8d]
quickkilllah: checks 
Dakotah Kid: bets $1
quickkilllah: folds 
Uncalled bet ($1) returned to Dakotah Kid
Dakotah Kid collected $3.35 from pot
Dakotah Kid: doesn't show hand 
*** SUMMARY ***
Total pot $3.50 | Rake $0.15 
Board [Ad 8c Jd 2h 8d]
Seat 1: quickkilllah (small blind) folded on the River
Seat 2: Dakotah Kid (big blind) collected ($3.35)
Seat 3: KIDNIC folded before Flop (didn't bet)
Seat 4: mcdougal2 folded before Flop (didn't bet)
Seat 5: jm_mathurin folded before Flop (didn't bet)
Seat 6: Stapher folded before Flop (didn't bet)
Seat 7: thing93001 folded before Flop (didn't bet)
Seat 8: brujo120 folded before Flop (didn't bet)
Seat 9: Alameda22 (button) folded before Flop (didn't bet)



PokerStars Game #19977644142:  Hold'em No Limit ($0.10/$0.25) - 2008/08/28 - 22:04:00 (ET)
Table 'Vesta III' 9-max Seat #1 is the button
Seat 1: quickkilllah ($23.20 in chips) 
Seat 2: Dakotah Kid ($15.75 in chips) 
Seat 3: KIDNIC ($9.95 in chips) 
Seat 4: mcdougal2 ($28.60 in chips) 
Seat 5: jm_mathurin ($38.15 in chips) 
Seat 6: Stapher ($21.30 in chips) 
Seat 7: thing93001 ($26.35 in chips) 
Seat 8: brujo120 ($15.10 in chips) 
Seat 9: Alameda22 ($25.90 in chips) 
Dakotah Kid: posts small blind $0.10
KIDNIC: posts big blind $0.25
*** HOLE CARDS ***
Dealt to Alameda22 [Qc 4d]
mcdougal2: calls $0.25
jm_mathurin: calls $0.25
Stapher: folds 
thing93001: folds 
brujo120: folds 
Alameda22: folds 
quickkilllah: raises $1.25 to $1.50
Dakotah Kid: folds 
KIDNIC: folds 
mcdougal2: raises $3.50 to $5
jm_mathurin: folds 
quickkilllah: folds 
Uncalled bet ($3.50) returned to mcdougal2
mcdougal2 collected $3.60 from pot
mcdougal2: doesn't show hand 
*** SUMMARY ***
Total pot $3.60 | Rake $0 
Seat 1: quickkilllah (button) folded before Flop
Seat 2: Dakotah Kid (small blind) folded before Flop
Seat 3: KIDNIC (big blind) folded before Flop
Seat 4: mcdougal2 collected ($3.60)
Seat 5: jm_mathurin folded before Flop
Seat 6: Stapher folded before Flop (didn't bet)
Seat 7: thing93001 folded before Flop (didn't bet)
Seat 8: brujo120 folded before Flop (didn't bet)
Seat 9: Alameda22 folded before Flop (didn't bet)



PokerStars Game #19977678502:  Hold'em No Limit ($0.10/$0.25) - 2008/08/28 - 22:05:34 (ET)
Table 'Vesta III' 9-max Seat #2 is the button
Seat 1: quickkilllah ($21.70 in chips) 
Seat 2: Dakotah Kid ($15.65 in chips) 
Seat 3: KIDNIC ($9.70 in chips) 
Seat 4: mcdougal2 ($30.70 in chips) 
Seat 5: jm_mathurin ($37.90 in chips) 
Seat 6: Stapher ($21.30 in chips) 
Seat 7: thing93001 ($26.35 in chips) 
Seat 8: brujo120 ($15.10 in chips) 
Seat 9: Alameda22 ($25.90 in chips) 
KIDNIC: posts small blind $0.10
mcdougal2: posts big blind $0.25
*** HOLE CARDS ***
Dealt to Alameda22 [8s As]
jm_mathurin: folds 
Stapher: folds 
thing93001: raises $0.50 to $0.75
brujo120: folds 
Alameda22: folds 
quickkilllah: folds 
Dakotah Kid: folds 
KIDNIC: folds 
mcdougal2: folds 
Uncalled bet ($0.50) returned to thing93001
thing93001 collected $0.60 from pot
thing93001: doesn't show hand 
*** SUMMARY ***
Total pot $0.60 | Rake $0 
Seat 1: quickkilllah folded before Flop (didn't bet)
Seat 2: Dakotah Kid (button) folded before Flop (didn't bet)
Seat 3: KIDNIC (small blind) folded before Flop
Seat 4: mcdougal2 (big blind) folded before Flop
Seat 5: jm_mathurin folded before Flop (didn't bet)
Seat 6: Stapher folded before Flop (didn't bet)
Seat 7: thing93001 collected ($0.60)
Seat 8: brujo120 folded before Flop (didn't bet)
Seat 9: Alameda22 folded before Flop (didn't bet)



PokerStars Game #19977692238:  Hold'em No Limit ($0.10/$0.25) - 2008/08/28 - 22:06:11 (ET)
Table 'Vesta III' 9-max Seat #3 is the button
Seat 1: quickkilllah ($21.70 in chips) 
Seat 2: Dakotah Kid ($15.65 in chips) 
Seat 3: KIDNIC ($9.60 in chips) 
Seat 4: mcdougal2 ($30.45 in chips) 
Seat 5: jm_mathurin ($37.90 in chips) 
Seat 6: Stapher ($21.30 in chips) 
Seat 7: thing93001 ($26.70 in chips) 
Seat 8: brujo120 ($15.10 in chips) 
Seat 9: Alameda22 ($25.90 in chips) 
mcdougal2: posts small blind $0.10
jm_mathurin: posts big blind $0.25
*** HOLE CARDS ***
Dealt to Alameda22 [3c Js]
Stapher: folds 
thing93001: folds 
brujo120: folds 
Alameda22: folds 
quickkilllah: folds 
Dakotah Kid: calls $0.25
KIDNIC: folds 
mcdougal2: calls $0.15
jm_mathurin: checks 
*** FLOP *** [4h 8c Ts]
mcdougal2: checks 
jm_mathurin: checks 
Dakotah Kid: checks 
*** TURN *** [4h 8c Ts] [Ad]
mcdougal2: checks 
jm_mathurin: checks 
Dakotah Kid: checks 
*** RIVER *** [4h 8c Ts Ad] [9s]
mcdougal2: checks 
jm_mathurin: checks 
Dakotah Kid: checks 
*** SHOW DOWN ***
mcdougal2: shows [7s Th] (a pair of Tens)
jm_mathurin: mucks hand 
Dakotah Kid: mucks hand 
mcdougal2 collected $0.75 from pot
*** SUMMARY ***
Total pot $0.75 | Rake $0 
Board [4h 8c Ts Ad 9s]
Seat 1: quickkilllah folded before Flop (didn't bet)
Seat 2: Dakotah Kid mucked [Kh 6h]
Seat 3: KIDNIC (button) folded before Flop (didn't bet)
Seat 4: mcdougal2 (small blind) showed [7s Th] and won ($0.75) with a pair of Tens
Seat 5: jm_mathurin (big blind) mucked [Jh 9d]
Seat 6: Stapher folded before Flop (didn't bet)
Seat 7: thing93001 folded before Flop (didn't bet)
Seat 8: brujo120 folded before Flop (didn't bet)
Seat 9: Alameda22 folded before Flop (didn't bet)



PokerStars Game #19977722712:  Hold'em No Limit ($0.10/$0.25) - 2008/08/28 - 22:07:34 (ET)
Table 'Vesta III' 9-max Seat #4 is the button
Seat 1: quickkilllah ($21.70 in chips) 
Seat 2: Dakotah Kid ($15.40 in chips) 
Seat 3: KIDNIC ($9.60 in chips) 
Seat 4: mcdougal2 ($30.95 in chips) 
Seat 5: jm_mathurin ($37.65 in chips) 
Seat 6: Stapher ($21.30 in chips) 
Seat 7: thing93001 ($26.70 in chips) 
Seat 8: brujo120 ($15.10 in chips) 
Seat 9: Alameda22 ($25.90 in chips) 
jm_mathurin: posts small blind $0.10
Stapher: posts big blind $0.25
*** HOLE CARDS ***
Dealt to Alameda22 [Jh Ks]
thing93001: folds 
brujo120: folds 
Alameda22: folds 
quickkilllah: folds 
Dakotah Kid: folds 
KIDNIC: folds 
mcdougal2: calls $0.25
jm_mathurin: raises $1 to $1.25
Stapher: calls $1
mcdougal2: folds 
*** FLOP *** [7c Qh Qc]
jm_mathurin: checks 
Stapher: bets $1.25
jm_mathurin: calls $1.25
*** TURN *** [7c Qh Qc] [Qs]
jm_mathurin: checks 
Stapher: checks 
*** RIVER *** [7c Qh Qc Qs] [4d]
jm_mathurin: checks 
Stapher: bets $2
jm_mathurin: calls $2
*** SHOW DOWN ***
Stapher: shows [Kc Kd] (a full house, Queens full of Kings)
jm_mathurin: mucks hand 
Stapher collected $8.80 from pot
*** SUMMARY ***
Total pot $9.25 | Rake $0.45 
Board [7c Qh Qc Qs 4d]
Seat 1: quickkilllah folded before Flop (didn't bet)
Seat 2: Dakotah Kid folded before Flop (didn't bet)
Seat 3: KIDNIC folded before Flop (didn't bet)
Seat 4: mcdougal2 (button) folded before Flop
Seat 5: jm_mathurin (small blind) mucked [Ad 9s]
Seat 6: Stapher (big blind) showed [Kc Kd] and won ($8.80) with a full house, Queens full of Kings
Seat 7: thing93001 folded before Flop (didn't bet)
Seat 8: brujo120 folded before Flop (didn't bet)
Seat 9: Alameda22 folded before Flop (didn't bet)



PokerStars Game #19977752687:  Hold'em No Limit ($0.10/$0.25) - 2008/08/28 - 22:08:56 (ET)
Table 'Vesta III' 9-max Seat #5 is the button
Seat 1: quickkilllah ($21.70 in chips) 
Seat 2: Dakotah Kid ($15.40 in chips) 
Seat 3: KIDNIC ($9.60 in chips) 
Seat 4: mcdougal2 ($30.70 in chips) 
Seat 5: jm_mathurin ($33.15 in chips) 
Seat 6: Stapher ($25.60 in chips) 
Seat 7: thing93001 ($26.70 in chips) 
Seat 8: brujo120 ($15.10 in chips) 
Seat 9: Alameda22 ($25.90 in chips) 
Stapher: posts small blind $0.10
thing93001: posts big blind $0.25
*** HOLE CARDS ***
Dealt to Alameda22 [9s Kc]
brujo120: folds 
Alameda22: folds 
quickkilllah: folds 
Dakotah Kid: folds 
KIDNIC: folds 
mcdougal2: calls $0.25
jm_mathurin: folds 
Stapher: calls $0.15
thing93001: checks 
*** FLOP *** [Ts 7c Ad]
Stapher: checks 
thing93001: checks 
mcdougal2: checks 
*** TURN *** [Ts 7c Ad] [3h]
Stapher: checks 
thing93001: checks 
mcdougal2: checks 
*** RIVER *** [Ts 7c Ad 3h] [4s]
Stapher: checks 
thing93001: checks 
mcdougal2: checks 
*** SHOW DOWN ***
Stapher: shows [6d 3s] (a pair of Threes)
thing93001: mucks hand 
mcdougal2: shows [9d Tc] (a pair of Tens)
mcdougal2 collected $0.75 from pot
*** SUMMARY ***
Total pot $0.75 | Rake $0 
Board [Ts 7c Ad 3h 4s]
Seat 1: quickkilllah folded before Flop (didn't bet)
Seat 2: Dakotah Kid folded before Flop (didn't bet)
Seat 3: KIDNIC folded before Flop (didn't bet)
Seat 4: mcdougal2 showed [9d Tc] and won ($0.75) with a pair of Tens
Seat 5: jm_mathurin (button) folded before Flop (didn't bet)
Seat 6: Stapher (small blind) showed [6d 3s] and lost with a pair of Threes
Seat 7: thing93001 (big blind) mucked [Qs Kh]
Seat 8: brujo120 folded before Flop (didn't bet)
Seat 9: Alameda22 folded before Flop (didn't bet)



PokerStars Game #19977778501:  Hold'em No Limit ($0.10/$0.25) - 2008/08/28 - 22:10:07 (ET)
Table 'Vesta III' 9-max Seat #6 is the button
Seat 1: quickkilllah ($21.70 in chips) 
Seat 2: Dakotah Kid ($15.40 in chips) 
Seat 3: KIDNIC ($9.60 in chips) 
Seat 4: mcdougal2 ($31.20 in chips) 
Seat 5: jm_mathurin ($33.15 in chips) 
Seat 6: Stapher ($25.35 in chips) 
Seat 7: thing93001 ($26.45 in chips) 
Seat 8: brujo120 ($15.10 in chips) 
Seat 9: Alameda22 ($25.90 in chips) 
thing93001: posts small blind $0.10
brujo120: posts big blind $0.25
*** HOLE CARDS ***
Dealt to Alameda22 [Tc 5d]
Alameda22: folds 
quickkilllah: folds 
Dakotah Kid: calls $0.25
KIDNIC: calls $0.25
mcdougal2: folds 
jm_mathurin: folds 
Stapher: folds 
thing93001: calls $0.15
brujo120: raises $0.75 to $1
Stapher is sitting out
Dakotah Kid: folds 
KIDNIC: folds 
thing93001: folds 
Uncalled bet ($0.75) returned to brujo120
brujo120 collected $1 from pot
brujo120: doesn't show hand 
*** SUMMARY ***
Total pot $1 | Rake $0 
Seat 1: quickkilllah folded before Flop (didn't bet)
Seat 2: Dakotah Kid folded before Flop
Seat 3: KIDNIC folded before Flop
Seat 4: mcdougal2 folded before Flop (didn't bet)
Seat 5: jm_mathurin folded before Flop (didn't bet)
Seat 6: Stapher (button) folded before Flop (didn't bet)
Seat 7: thing93001 (small blind) folded before Flop
Seat 8: brujo120 (big blind) collected ($1)
Seat 9: Alameda22 folded before Flop (didn't bet)



PokerStars Game #19977803447:  Hold'em No Limit ($0.10/$0.25) - 2008/08/28 - 22:11:15 (ET)
Table 'Vesta III' 9-max Seat #7 is the button
Seat 1: quickkilllah ($21.70 in chips) 
Seat 2: Dakotah Kid ($15.15 in chips) 
Seat 3: KIDNIC ($9.35 in chips) 
Seat 4: mcdougal2 ($31.20 in chips) 
Seat 5: jm_mathurin ($33.15 in chips) 
Seat 7: thing93001 ($26.20 in chips) 
Seat 8: brujo120 ($15.85 in chips) 
Seat 9: Alameda22 ($25.90 in chips) 
brujo120: posts small blind $0.10
Alameda22: posts big blind $0.25
*** HOLE CARDS ***
Dealt to Alameda22 [5s 5d]
quickkilllah: folds 
Dakotah Kid: calls $0.25
KIDNIC: folds 
mcdougal2: folds 
jm_mathurin: folds 
thing93001: folds 
brujo120: calls $0.15
Alameda22: checks 
*** FLOP *** [Kh Ac 6d]
brujo120: checks 
Alameda22: checks 
Dakotah Kid: checks 
*** TURN *** [Kh Ac 6d] [2s]
brujo120: checks 
Alameda22: checks 
Dakotah Kid: checks 
*** RIVER *** [Kh Ac 6d 2s] [7c]
brujo120: checks 
Alameda22: checks 
Dakotah Kid: checks 
*** SHOW DOWN ***
brujo120: shows [Jc Th] (high card Ace)
Alameda22: shows [5s 5d] (a pair of Fives)
Dakotah Kid: mucks hand 
Alameda22 collected $0.75 from pot
*** SUMMARY ***
Total pot $0.75 | Rake $0 
Board [Kh Ac 6d 2s 7c]
Seat 1: quickkilllah folded before Flop (didn't bet)
Seat 2: Dakotah Kid mucked [Qh 8h]
Seat 3: KIDNIC folded before Flop (didn't bet)
Seat 4: mcdougal2 folded before Flop (didn't bet)
Seat 5: jm_mathurin folded before Flop (didn't bet)
Seat 7: thing93001 (button) folded before Flop (didn't bet)
Seat 8: brujo120 (small blind) showed [Jc Th] and lost with high card Ace
Seat 9: Alameda22 (big blind) showed [5s 5d] and won ($0.75) with a pair of Fives



PokerStars Game #19977825124:  Hold'em No Limit ($0.10/$0.25) - 2008/08/28 - 22:12:15 (ET)
Table 'Vesta III' 9-max Seat #8 is the button
Seat 1: quickkilllah ($21.70 in chips) 
Seat 2: Dakotah Kid ($14.90 in chips) 
Seat 3: KIDNIC ($9.35 in chips) 
Seat 4: mcdougal2 ($31.20 in chips) 
Seat 5: jm_mathurin ($33.15 in chips) 
Seat 7: thing93001 ($26.20 in chips) 
Seat 8: brujo120 ($15.60 in chips) 
Seat 9: Alameda22 ($26.40 in chips) 
Alameda22: posts small blind $0.10
quickkilllah: posts big blind $0.25
*** HOLE CARDS ***
Dealt to Alameda22 [Ac 5d]
Dakotah Kid: folds 
KIDNIC: folds 
mcdougal2: calls $0.25
jm_mathurin: folds 
thing93001: raises $0.75 to $1
brujo120: calls $1
Alameda22: folds 
quickkilllah: folds 
mcdougal2: folds 
*** FLOP *** [As 6d 2s]
thing93001: bets $2
brujo120: folds 
Uncalled bet ($2) returned to thing93001
thing93001 collected $2.50 from pot
thing93001: doesn't show hand 
*** SUMMARY ***
Total pot $2.60 | Rake $0.10 
Board [As 6d 2s]
Seat 1: quickkilllah (big blind) folded before Flop
Seat 2: Dakotah Kid folded before Flop (didn't bet)
Seat 3: KIDNIC folded before Flop (didn't bet)
Seat 4: mcdougal2 folded before Flop
Seat 5: jm_mathurin folded before Flop (didn't bet)
Seat 7: thing93001 collected ($2.50)
Seat 8: brujo120 (button) folded on the Flop
Seat 9: Alameda22 (small blind) folded before Flop



PokerStars Game #19977850489:  Hold'em No Limit ($0.10/$0.25) - 2008/08/28 - 22:13:25 (ET)
Table 'Vesta III' 9-max Seat #9 is the button
Seat 1: quickkilllah ($21.45 in chips) 
Seat 2: Dakotah Kid ($14.90 in chips) 
Seat 3: KIDNIC ($9.35 in chips) 
Seat 4: mcdougal2 ($30.95 in chips) 
Seat 5: jm_mathurin ($33.15 in chips) 
Seat 7: thing93001 ($27.70 in chips) 
Seat 8: brujo120 ($14.60 in chips) 
Seat 9: Alameda22 ($26.30 in chips) 
quickkilllah: posts small blind $0.10
Dakotah Kid: posts big blind $0.25
*** HOLE CARDS ***
Dealt to Alameda22 [6h 2c]
KIDNIC: folds 
Stapher has returned
mcdougal2: folds 
jm_mathurin: raises $1 to $1.25
thing93001: folds 
brujo120: folds 
Alameda22: folds 
quickkilllah: folds 
Dakotah Kid: folds 
Uncalled bet ($1) returned to jm_mathurin
jm_mathurin collected $0.60 from pot
*** SUMMARY ***
Total pot $0.60 | Rake $0 
Seat 1: quickkilllah (small blind) folded before Flop
Seat 2: Dakotah Kid (big blind) folded before Flop
Seat 3: KIDNIC folded before Flop (didn't bet)
Seat 4: mcdougal2 folded before Flop (didn't bet)
Seat 5: jm_mathurin collected ($0.60)
Seat 7: thing93001 folded before Flop (didn't bet)
Seat 8: brujo120 folded before Flop (didn't bet)
Seat 9: Alameda22 (button) folded before Flop (didn't bet)



PokerStars Game #19977863262:  Hold'em No Limit ($0.10/$0.25) - 2008/08/28 - 22:14:00 (ET)
Table 'Vesta III' 9-max Seat #1 is the button
Seat 1: quickkilllah ($21.35 in chips) 
Seat 2: Dakotah Kid ($14.65 in chips) 
Seat 3: KIDNIC ($9.35 in chips) 
Seat 4: mcdougal2 ($30.95 in chips) 
Seat 5: jm_mathurin ($33.50 in chips) 
Seat 6: Stapher ($25.35 in chips) 
Seat 7: thing93001 ($27.70 in chips) 
Seat 8: brujo120 ($14.60 in chips) 
Seat 9: Alameda22 ($26.30 in chips) 
Dakotah Kid: posts small blind $0.10
KIDNIC: posts big blind $0.25
*** HOLE CARDS ***
Dealt to Alameda22 [4d 8c]
mcdougal2: folds 
jm_mathurin: folds 
Stapher: folds 
thing93001: raises $0.50 to $0.75
brujo120: folds 
Alameda22: folds 
quickkilllah: folds 
Dakotah Kid: folds 
KIDNIC: folds 
Uncalled bet ($0.50) returned to thing93001
thing93001 collected $0.60 from pot
thing93001: doesn't show hand 
*** SUMMARY ***
Total pot $0.60 | Rake $0 
Seat 1: quickkilllah (button) folded before Flop (didn't bet)
Seat 2: Dakotah Kid (small blind) folded before Flop
Seat 3: KIDNIC (big blind) folded before Flop
Seat 4: mcdougal2 folded before Flop (didn't bet)
Seat 5: jm_mathurin folded before Flop (didn't bet)
Seat 6: Stapher folded before Flop (didn't bet)
Seat 7: thing93001 collected ($0.60)
Seat 8: brujo120 folded before Flop (didn't bet)
Seat 9: Alameda22 folded before Flop (didn't bet)



PokerStars Game #19977875215:  Hold'em No Limit ($0.10/$0.25) - 2008/08/28 - 22:14:33 (ET)
Table 'Vesta III' 9-max Seat #2 is the button
Seat 1: quickkilllah ($21.35 in chips) 
Seat 2: Dakotah Kid ($14.55 in chips) 
Seat 3: KIDNIC ($9.10 in chips) 
Seat 4: mcdougal2 ($30.95 in chips) 
Seat 5: jm_mathurin ($33.50 in chips) 
Seat 6: Stapher ($25.35 in chips) 
Seat 7: thing93001 ($28.05 in chips) 
Seat 8: brujo120 ($14.60 in chips) 
Seat 9: Alameda22 ($26.30 in chips) 
KIDNIC: posts small blind $0.10
mcdougal2: posts big blind $0.25
*** HOLE CARDS ***
Dealt to Alameda22 [3h Qh]
jm_mathurin: folds 
Stapher: folds 
thing93001: folds 
brujo120: folds 
Alameda22: folds 
quickkilllah: raises $0.75 to $1
Dakotah Kid: folds 
KIDNIC: folds 
mcdougal2: folds 
Uncalled bet ($0.75) returned to quickkilllah
quickkilllah collected $0.60 from pot
quickkilllah: doesn't show hand 
*** SUMMARY ***
Total pot $0.60 | Rake $0 
Seat 1: quickkilllah collected ($0.60)
Seat 2: Dakotah Kid (button) folded before Flop (didn't bet)
Seat 3: KIDNIC (small blind) folded before Flop
Seat 4: mcdougal2 (big blind) folded before Flop
Seat 5: jm_mathurin folded before Flop (didn't bet)
Seat 6: Stapher folded before Flop (didn't bet)
Seat 7: thing93001 folded before Flop (didn't bet)
Seat 8: brujo120 folded before Flop (didn't bet)
Seat 9: Alameda22 folded before Flop (didn't bet)



PokerStars Game #19977889801:  Hold'em No Limit ($0.10/$0.25) - 2008/08/28 - 22:15:14 (ET)
Table 'Vesta III' 9-max Seat #3 is the button
Seat 1: quickkilllah ($21.70 in chips) 
Seat 2: Dakotah Kid ($14.55 in chips) 
Seat 3: KIDNIC ($9 in chips) 
Seat 4: mcdougal2 ($30.70 in chips) 
Seat 5: jm_mathurin ($33.50 in chips) 
Seat 6: Stapher ($25.35 in chips) 
Seat 7: thing93001 ($28.05 in chips) 
Seat 8: brujo120 ($14.60 in chips) 
Seat 9: Alameda22 ($26.30 in chips) 
mcdougal2: posts small blind $0.10
jm_mathurin: posts big blind $0.25
*** HOLE CARDS ***
Dealt to Alameda22 [Td 6s]
Stapher: folds 
thing93001: folds 
brujo120: calls $0.25
Alameda22: folds 
quickkilllah: folds 
Dakotah Kid: folds 
KIDNIC: folds 
mcdougal2: calls $0.15
jm_mathurin: checks 
*** FLOP *** [7h Qh 3s]
mcdougal2: bets $0.25
jm_mathurin: folds 
brujo120: calls $0.25
*** TURN *** [7h Qh 3s] [Qs]
mcdougal2: checks 
brujo120: bets $0.75
mcdougal2: folds 
Uncalled bet ($0.75) returned to brujo120
brujo120 collected $1.20 from pot
brujo120: doesn't show hand 
*** SUMMARY ***
Total pot $1.25 | Rake $0.05 
Board [7h Qh 3s Qs]
Seat 1: quickkilllah folded before Flop (didn't bet)
Seat 2: Dakotah Kid folded before Flop (didn't bet)
Seat 3: KIDNIC (button) folded before Flop (didn't bet)
Seat 4: mcdougal2 (small blind) folded on the Turn
Seat 5: jm_mathurin (big blind) folded on the Flop
Seat 6: Stapher folded before Flop (didn't bet)
Seat 7: thing93001 folded before Flop (didn't bet)
Seat 8: brujo120 collected ($1.20)
Seat 9: Alameda22 folded before Flop (didn't bet)



PokerStars Game #19977911148:  Hold'em No Limit ($0.10/$0.25) - 2008/08/28 - 22:16:13 (ET)
Table 'Vesta III' 9-max Seat #4 is the button
Seat 1: quickkilllah ($21.70 in chips) 
Seat 2: Dakotah Kid ($14.55 in chips) 
Seat 3: KIDNIC ($9 in chips) 
Seat 4: mcdougal2 ($30.20 in chips) 
Seat 5: jm_mathurin ($33.25 in chips) 
Seat 6: Stapher ($25.35 in chips) 
Seat 7: thing93001 ($28.05 in chips) 
Seat 8: brujo120 ($15.30 in chips) 
Seat 9: Alameda22 ($26.30 in chips) 
jm_mathurin: posts small blind $0.10
Stapher: posts big blind $0.25
*** HOLE CARDS ***
Dealt to Alameda22 [3h Td]
thing93001: folds 
brujo120: folds 
Alameda22: folds 
quickkilllah: folds 
Dakotah Kid: calls $0.25
KIDNIC: folds 
mcdougal2: folds 
jm_mathurin: calls $0.15
Stapher: checks 
*** FLOP *** [Ah 5s Jd]
jm_mathurin: checks 
Stapher: checks 
Dakotah Kid: checks 
*** TURN *** [Ah 5s Jd] [9s]
jm_mathurin: checks 
Stapher: checks 
Dakotah Kid: checks 
*** RIVER *** [Ah 5s Jd 9s] [Tc]
jm_mathurin: bets $0.75
Stapher: folds 
Dakotah Kid: folds 
Uncalled bet ($0.75) returned to jm_mathurin
jm_mathurin collected $0.75 from pot
*** SUMMARY ***
Total pot $0.75 | Rake $0 
Board [Ah 5s Jd 9s Tc]
Seat 1: quickkilllah folded before Flop (didn't bet)
Seat 2: Dakotah Kid folded on the River
Seat 3: KIDNIC folded before Flop (didn't bet)
Seat 4: mcdougal2 (button) folded before Flop (didn't bet)
Seat 5: jm_mathurin (small blind) collected ($0.75)
Seat 6: Stapher (big blind) folded on the River
Seat 7: thing93001 folded before Flop (didn't bet)
Seat 8: brujo120 folded before Flop (didn't bet)
Seat 9: Alameda22 folded before Flop (didn't bet)



PokerStars Game #19977932041:  Hold'em No Limit ($0.10/$0.25) - 2008/08/28 - 22:17:11 (ET)
Table 'Vesta III' 9-max Seat #5 is the button
Seat 1: quickkilllah ($21.70 in chips) 
Seat 2: Dakotah Kid ($14.30 in chips) 
Seat 3: KIDNIC ($9 in chips) 
Seat 4: mcdougal2 ($30.20 in chips) 
Seat 5: jm_mathurin ($33.75 in chips) 
Seat 6: Stapher ($25.10 in chips) 
Seat 7: thing93001 ($28.05 in chips) 
Seat 8: brujo120 ($15.30 in chips) 
Seat 9: Alameda22 ($26.30 in chips) 
Stapher: posts small blind $0.10
thing93001: posts big blind $0.25
*** HOLE CARDS ***
Dealt to Alameda22 [5c Jd]
brujo120: calls $0.25
Alameda22: folds 
quickkilllah: folds 
Dakotah Kid: folds 
KIDNIC: folds 
mcdougal2: folds 
jm_mathurin: raises $1 to $1.25
Stapher: folds 
thing93001: folds 
brujo120: calls $1
*** FLOP *** [4h 8s 9c]
brujo120: checks 
jm_mathurin: bets $2.25
brujo120: folds 
Uncalled bet ($2.25) returned to jm_mathurin
jm_mathurin collected $2.75 from pot
*** SUMMARY ***
Total pot $2.85 | Rake $0.10 
Board [4h 8s 9c]
Seat 1: quickkilllah folded before Flop (didn't bet)
Seat 2: Dakotah Kid folded before Flop (didn't bet)
Seat 3: KIDNIC folded before Flop (didn't bet)
Seat 4: mcdougal2 folded before Flop (didn't bet)
Seat 5: jm_mathurin (button) collected ($2.75)
Seat 6: Stapher (small blind) folded before Flop
Seat 7: thing93001 (big blind) folded before Flop
Seat 8: brujo120 folded on the Flop
Seat 9: Alameda22 folded before Flop (didn't bet)



PokerStars Game #19977948010:  Hold'em No Limit ($0.10/$0.25) - 2008/08/28 - 22:17:56 (ET)
Table 'Vesta III' 9-max Seat #6 is the button
Seat 1: quickkilllah ($21.70 in chips) 
Seat 2: Dakotah Kid ($14.30 in chips) 
Seat 3: KIDNIC ($9 in chips) 
Seat 4: mcdougal2 ($30.20 in chips) 
Seat 5: jm_mathurin ($35.25 in chips) 
Seat 6: Stapher ($25 in chips) 
Seat 7: thing93001 ($27.80 in chips) 
Seat 8: brujo120 ($14.05 in chips) 
Seat 9: Alameda22 ($26.30 in chips) 
thing93001: posts small blind $0.10
brujo120: posts big blind $0.25
*** HOLE CARDS ***
Dealt to Alameda22 [Ac 6c]
Alameda22: folds 
quickkilllah: folds 
Dakotah Kid: folds 
KIDNIC: calls $0.25
mcdougal2: folds 
jm_mathurin: folds 
Stapher: folds 
thing93001: folds 
brujo120: checks 
*** FLOP *** [4d 5c Jc]
brujo120: checks 
KIDNIC: bets $0.50
brujo120: folds 
Uncalled bet ($0.50) returned to KIDNIC
KIDNIC collected $0.60 from pot
*** SUMMARY ***
Total pot $0.60 | Rake $0 
Board [4d 5c Jc]
Seat 1: quickkilllah folded before Flop (didn't bet)
Seat 2: Dakotah Kid folded before Flop (didn't bet)
Seat 3: KIDNIC collected ($0.60)
Seat 4: mcdougal2 folded before Flop (didn't bet)
Seat 5: jm_mathurin folded before Flop (didn't bet)
Seat 6: Stapher (button) folded before Flop (didn't bet)
Seat 7: thing93001 (small blind) folded before Flop
Seat 8: brujo120 (big blind) folded on the Flop
Seat 9: Alameda22 folded before Flop (didn't bet)



PokerStars Game #19977970275:  Hold'em No Limit ($0.10/$0.25) - 2008/08/28 - 22:18:58 (ET)
Table 'Vesta III' 9-max Seat #7 is the button
Seat 1: quickkilllah ($21.70 in chips) 
Seat 2: Dakotah Kid ($14.30 in chips) 
Seat 3: KIDNIC ($9.35 in chips) 
Seat 4: mcdougal2 ($30.20 in chips) 
Seat 5: jm_mathurin ($35.25 in chips) 
Seat 6: Stapher ($25 in chips) 
Seat 7: thing93001 ($27.70 in chips) 
Seat 8: brujo120 ($13.80 in chips) 
Seat 9: Alameda22 ($26.30 in chips) 
brujo120: posts small blind $0.10
Alameda22: posts big blind $0.25
*** HOLE CARDS ***
Dealt to Alameda22 [2c 9d]
quickkilllah: folds 
Dakotah Kid: folds 
KIDNIC: folds 
mcdougal2: raises $0.25 to $0.50
jm_mathurin: raises $2 to $2.50
Stapher: folds 
thing93001: folds 
brujo120: folds 
Alameda22: folds 
mcdougal2: calls $2
*** FLOP *** [2h Th 2d]
mcdougal2: checks 
jm_mathurin: bets $3.75
mcdougal2: folds 
Uncalled bet ($3.75) returned to jm_mathurin
jm_mathurin collected $5.10 from pot
*** SUMMARY ***
Total pot $5.35 | Rake $0.25 
Board [2h Th 2d]
Seat 1: quickkilllah folded before Flop (didn't bet)
Seat 2: Dakotah Kid folded before Flop (didn't bet)
Seat 3: KIDNIC folded before Flop (didn't bet)
Seat 4: mcdougal2 folded on the Flop
Seat 5: jm_mathurin collected ($5.10)
Seat 6: Stapher folded before Flop (didn't bet)
Seat 7: thing93001 (button) folded before Flop (didn't bet)
Seat 8: brujo120 (small blind) folded before Flop
Seat 9: Alameda22 (big blind) folded before Flop



PokerStars Game #19978004726:  Hold'em No Limit ($0.10/$0.25) - 2008/08/28 - 22:20:34 (ET)
Table 'Vesta III' 9-max Seat #8 is the button
Seat 1: quickkilllah ($21.70 in chips) 
Seat 2: Dakotah Kid ($14.30 in chips) 
Seat 3: KIDNIC ($9.35 in chips) 
Seat 4: mcdougal2 ($27.70 in chips) 
Seat 5: jm_mathurin ($37.85 in chips) 
Seat 6: Stapher ($25 in chips) 
Seat 7: thing93001 ($27.70 in chips) 
Seat 8: brujo120 ($13.70 in chips) 
Seat 9: Alameda22 ($26.05 in chips) 
Alameda22: posts small blind $0.10
quickkilllah: posts big blind $0.25
*** HOLE CARDS ***
Dealt to Alameda22 [5s 7h]
Dakotah Kid: folds 
KIDNIC: calls $0.25
mcdougal2: calls $0.25
Dakotah Kid is sitting out
jm_mathurin: folds 
Stapher: folds 
thing93001: raises $0.75 to $1
brujo120: folds 
Alameda22: folds 
quickkilllah: folds 
KIDNIC: folds 
mcdougal2: calls $0.75
*** FLOP *** [Kh 5d 3c]
mcdougal2: checks 
thing93001: bets $2
mcdougal2: folds 
Uncalled bet ($2) returned to thing93001
thing93001 collected $2.50 from pot
thing93001: doesn't show hand 
*** SUMMARY ***
Total pot $2.60 | Rake $0.10 
Board [Kh 5d 3c]
Seat 1: quickkilllah (big blind) folded before Flop
Seat 2: Dakotah Kid folded before Flop (didn't bet)
Seat 3: KIDNIC folded before Flop
Seat 4: mcdougal2 folded on the Flop
Seat 5: jm_mathurin folded before Flop (didn't bet)
Seat 6: Stapher folded before Flop (didn't bet)
Seat 7: thing93001 collected ($2.50)
Seat 8: brujo120 (button) folded before Flop (didn't bet)
Seat 9: Alameda22 (small blind) folded before Flop



PokerStars Game #19978028744:  Hold'em No Limit ($0.10/$0.25) - 2008/08/28 - 22:21:41 (ET)
Table 'Vesta III' 9-max Seat #9 is the button
Seat 1: quickkilllah ($21.45 in chips) 
Seat 3: KIDNIC ($9.10 in chips) 
Seat 4: mcdougal2 ($26.70 in chips) 
Seat 5: jm_mathurin ($37.85 in chips) 
Seat 6: Stapher ($25 in chips) 
Seat 7: thing93001 ($29.20 in chips) 
Seat 8: brujo120 ($13.70 in chips) 
Seat 9: Alameda22 ($25.95 in chips) 
Dakotah Kid leaves the table
quickkilllah: posts small blind $0.10
KIDNIC: posts big blind $0.25
*** HOLE CARDS ***
Dealt to Alameda22 [Ad 5h]
mcdougal2: raises $0.25 to $0.50
jm_mathurin: folds 
Stapher: folds 
thing93001: folds 
brujo120: folds 
Alameda22: folds 
quickkilllah: folds 
KIDNIC: folds 
Uncalled bet ($0.25) returned to mcdougal2
mcdougal2 collected $0.60 from pot
mcdougal2: doesn't show hand 
*** SUMMARY ***
Total pot $0.60 | Rake $0 
Seat 1: quickkilllah (small blind) folded before Flop
Seat 3: KIDNIC (big blind) folded before Flop
Seat 4: mcdougal2 collected ($0.60)
Seat 5: jm_mathurin folded before Flop (didn't bet)
Seat 6: Stapher folded before Flop (didn't bet)
Seat 7: thing93001 folded before Flop (didn't bet)
Seat 8: brujo120 folded before Flop (didn't bet)
Seat 9: Alameda22 (button) folded before Flop (didn't bet)



PokerStars Game #19978042264:  Hold'em No Limit ($0.10/$0.25) - 2008/08/28 - 22:22:19 (ET)
Table 'Vesta III' 9-max Seat #1 is the button
Seat 1: quickkilllah ($21.35 in chips) 
Seat 3: KIDNIC ($8.85 in chips) 
Seat 4: mcdougal2 ($27.05 in chips) 
Seat 5: jm_mathurin ($37.85 in chips) 
Seat 6: Stapher ($25 in chips) 
Seat 7: thing93001 ($29.20 in chips) 
Seat 8: brujo120 ($13.70 in chips) 
Seat 9: Alameda22 ($25.95 in chips) 
KIDNIC: posts small blind $0.10
mcdougal2: posts big blind $0.25
*** HOLE CARDS ***
Dealt to Alameda22 [Jc Jd]
jm_mathurin: folds 
Stapher: folds 
jumbo10 joins the table at seat #2 
thing93001: folds 
brujo120: calls $0.25
Alameda22: raises $0.75 to $1
quickkilllah: folds 
KIDNIC: folds 
mcdougal2: folds 
brujo120: calls $0.75
*** FLOP *** [Ks 4h 3s]
brujo120: checks 
Alameda22: bets $1.50
brujo120: folds 
Uncalled bet ($1.50) returned to Alameda22
Alameda22 collected $2.25 from pot
Alameda22: doesn't show hand 
*** SUMMARY ***
Total pot $2.35 | Rake $0.10 
Board [Ks 4h 3s]
Seat 1: quickkilllah (button) folded before Flop (didn't bet)
Seat 3: KIDNIC (small blind) folded before Flop
Seat 4: mcdougal2 (big blind) folded before Flop
Seat 5: jm_mathurin folded before Flop (didn't bet)
Seat 6: Stapher folded before Flop (didn't bet)
Seat 7: thing93001 folded before Flop (didn't bet)
Seat 8: brujo120 folded on the Flop
Seat 9: Alameda22 collected ($2.25)



PokerStars Game #19978062056:  Hold'em No Limit ($0.10/$0.25) - 2008/08/28 - 22:23:14 (ET)
Table 'Vesta III' 9-max Seat #3 is the button
Seat 1: quickkilllah ($21.35 in chips) 
Seat 2: jumbo10 ($10 in chips) 
Seat 3: KIDNIC ($8.75 in chips) 
Seat 4: mcdougal2 ($26.80 in chips) 
Seat 5: jm_mathurin ($37.85 in chips) 
Seat 6: Stapher ($25 in chips) 
Seat 7: thing93001 ($29.20 in chips) 
Seat 8: brujo120 ($12.70 in chips) 
Seat 9: Alameda22 ($27.20 in chips) 
mcdougal2: posts small blind $0.10
jm_mathurin: posts big blind $0.25
jumbo10: posts big blind $0.25
*** HOLE CARDS ***
Dealt to Alameda22 [Kd Ad]
Stapher: folds 
thing93001: folds 
brujo120: folds 
Alameda22: raises $0.75 to $1
quickkilllah: folds 
jumbo10: raises $0.75 to $1.75
KIDNIC: folds 
mcdougal2: folds 
jm_mathurin: folds 
Alameda22: raises $25.45 to $27.20 and is all-in
jumbo10: calls $8.25 and is all-in
Uncalled bet ($17.20) returned to Alameda22
*** FLOP *** [2d 9d Ac]
*** TURN *** [2d 9d Ac] [5s]
*** RIVER *** [2d 9d Ac 5s] [3h]
*** SHOW DOWN ***
Alameda22: shows [Kd Ad] (a pair of Aces)
jumbo10: shows [9h 5h] (two pair, Nines and Fives)
jumbo10 collected $19.35 from pot
*** SUMMARY ***
Total pot $20.35 | Rake $1 
Board [2d 9d Ac 5s 3h]
Seat 1: quickkilllah folded before Flop (didn't bet)
Seat 2: jumbo10 showed [9h 5h] and won ($19.35) with two pair, Nines and Fives
Seat 3: KIDNIC (button) folded before Flop (didn't bet)
Seat 4: mcdougal2 (small blind) folded before Flop
Seat 5: jm_mathurin (big blind) folded before Flop
Seat 6: Stapher folded before Flop (didn't bet)
Seat 7: thing93001 folded before Flop (didn't bet)
Seat 8: brujo120 folded before Flop (didn't bet)
Seat 9: Alameda22 showed [Kd Ad] and lost with a pair of Aces



PokerStars Game #19978089442:  Hold'em No Limit ($0.10/$0.25) - 2008/08/28 - 22:24:30 (ET)
Table 'Vesta III' 9-max Seat #4 is the button
Seat 1: quickkilllah ($21.35 in chips) 
Seat 2: jumbo10 ($19.35 in chips) 
Seat 3: KIDNIC ($8.75 in chips) 
Seat 4: mcdougal2 ($26.70 in chips) 
Seat 5: jm_mathurin ($37.60 in chips) 
Seat 6: Stapher ($25 in chips) 
Seat 7: thing93001 ($29.20 in chips) 
Seat 8: brujo120 ($12.70 in chips) 
Seat 9: Alameda22 ($17.20 in chips) 
jm_mathurin: posts small blind $0.10
Stapher: posts big blind $0.25
*** HOLE CARDS ***
Dealt to Alameda22 [Qh 4c]
thing93001: folds 
brujo120: calls $0.25
Alameda22: folds 
quickkilllah: folds 
jumbo10: calls $0.25
KIDNIC: folds 
KIDNIC is sitting out
mcdougal2: folds 
jm_mathurin: folds 
Stapher: checks 
*** FLOP *** [2c Ts 9s]
Stapher: checks 
brujo120: checks 
jumbo10: bets $0.25
Stapher: calls $0.25
brujo120: calls $0.25
*** TURN *** [2c Ts 9s] [9d]
Stapher: checks 
brujo120: checks 
jumbo10: bets $0.25
Stapher: calls $0.25
brujo120: raises $0.75 to $1
jumbo10: calls $0.75
Stapher: folds 
*** RIVER *** [2c Ts 9s 9d] [6s]
brujo120: bets $1
jumbo10: calls $1
*** SHOW DOWN ***
brujo120: shows [9c Ac] (three of a kind, Nines)
jumbo10: mucks hand 
brujo120 collected $5.60 from pot
*** SUMMARY ***
Total pot $5.85 | Rake $0.25 
Board [2c Ts 9s 9d 6s]
Seat 1: quickkilllah folded before Flop (didn't bet)
Seat 2: jumbo10 mucked [2d Ks]
Seat 3: KIDNIC folded before Flop (didn't bet)
Seat 4: mcdougal2 (button) folded before Flop (didn't bet)
Seat 5: jm_mathurin (small blind) folded before Flop
Seat 6: Stapher (big blind) folded on the Turn
Seat 7: thing93001 folded before Flop (didn't bet)
Seat 8: brujo120 showed [9c Ac] and won ($5.60) with three of a kind, Nines
Seat 9: Alameda22 folded before Flop (didn't bet)



PokerStars Game #19978120633:  Hold'em No Limit ($0.10/$0.25) - 2008/08/28 - 22:25:56 (ET)
Table 'Vesta III' 9-max Seat #5 is the button
Seat 1: quickkilllah ($21.35 in chips) 
Seat 2: jumbo10 ($16.85 in chips) 
Seat 4: mcdougal2 ($26.70 in chips) 
Seat 5: jm_mathurin ($37.50 in chips) 
Seat 6: Stapher ($24.25 in chips) 
Seat 7: thing93001 ($29.20 in chips) 
Seat 8: brujo120 ($15.80 in chips) 
Seat 9: Alameda22 ($25 in chips) 
Stapher: posts small blind $0.10
thing93001: posts big blind $0.25
*** HOLE CARDS ***
Dealt to Alameda22 [2h 9c]
brujo120: folds 
Alameda22: folds 
quickkilllah: folds 
jumbo10: calls $0.25
mcdougal2: folds 
jm_mathurin: raises $1.25 to $1.50
Stapher: folds 
thing93001: calls $1.25
mcdougal2 is sitting out
jumbo10: calls $1.25
*** FLOP *** [4s 3d 4c]
thing93001: checks 
jumbo10: bets $0.25
jm_mathurin: raises $2.50 to $2.75
thing93001: raises $4.25 to $7
jumbo10: folds 
jm_mathurin: folds 
Uncalled bet ($4.25) returned to thing93001
thing93001 collected $9.85 from pot
thing93001: doesn't show hand 
*** SUMMARY ***
Total pot $10.35 | Rake $0.50 
Board [4s 3d 4c]
Seat 1: quickkilllah folded before Flop (didn't bet)
Seat 2: jumbo10 folded on the Flop
Seat 4: mcdougal2 folded before Flop (didn't bet)
Seat 5: jm_mathurin (button) folded on the Flop
Seat 6: Stapher (small blind) folded before Flop
Seat 7: thing93001 (big blind) collected ($9.85)
Seat 8: brujo120 folded before Flop (didn't bet)
Seat 9: Alameda22 folded before Flop (didn't bet)



PokerStars Game #19978147558:  Hold'em No Limit ($0.10/$0.25) - 2008/08/28 - 22:27:12 (ET)
Table 'Vesta III' 9-max Seat #6 is the button
Seat 1: quickkilllah ($21.35 in chips) 
Seat 2: jumbo10 ($15.10 in chips) 
Seat 5: jm_mathurin ($33.25 in chips) 
Seat 6: Stapher ($24.15 in chips) 
Seat 7: thing93001 ($34.80 in chips) 
Seat 8: brujo120 ($15.80 in chips) 
Seat 9: Alameda22 ($25 in chips) 
thing93001: posts small blind $0.10
brujo120: posts big blind $0.25
*** HOLE CARDS ***
Dealt to Alameda22 [7h 2h]
Alameda22: folds 
quickkilllah: folds 
jumbo10: calls $0.25
jm_mathurin: folds 
Stapher: folds 
thing93001: calls $0.15
brujo120: checks 
*** FLOP *** [5c 3d 6c]
thing93001: checks 
brujo120: checks 
jumbo10: bets $1.75
thing93001: folds 
brujo120: folds 
Uncalled bet ($1.75) returned to jumbo10
jumbo10 collected $0.75 from pot
jumbo10: doesn't show hand 
*** SUMMARY ***
Total pot $0.75 | Rake $0 
Board [5c 3d 6c]
Seat 1: quickkilllah folded before Flop (didn't bet)
Seat 2: jumbo10 collected ($0.75)
Seat 5: jm_mathurin folded before Flop (didn't bet)
Seat 6: Stapher (button) folded before Flop (didn't bet)
Seat 7: thing93001 (small blind) folded on the Flop
Seat 8: brujo120 (big blind) folded on the Flop
Seat 9: Alameda22 folded before Flop (didn't bet)



PokerStars Game #19978165150:  Hold'em No Limit ($0.10/$0.25) - 2008/08/28 - 22:28:02 (ET)
Table 'Vesta III' 9-max Seat #7 is the button
Seat 1: quickkilllah ($21.35 in chips) 
Seat 2: jumbo10 ($15.60 in chips) 
Seat 5: jm_mathurin ($33.25 in chips) 
Seat 6: Stapher ($24.15 in chips) 
Seat 7: thing93001 ($34.55 in chips) 
Seat 8: brujo120 ($15.55 in chips) 
Seat 9: Alameda22 ($25 in chips) 
brujo120: posts small blind $0.10
Alameda22: posts big blind $0.25
*** HOLE CARDS ***
Dealt to Alameda22 [Tc Kc]
quickkilllah: folds 
jumbo10: calls $0.25
jm_mathurin: folds 
Stapher: folds 
thing93001: raises $0.75 to $1
brujo120: folds 
Alameda22: folds 
jumbo10: calls $0.75
*** FLOP *** [2h 4c 7h]
jumbo10: bets $0.25
thing93001: folds 
Uncalled bet ($0.25) returned to jumbo10
jumbo10 collected $2.25 from pot
jumbo10: doesn't show hand 
*** SUMMARY ***
Total pot $2.35 | Rake $0.10 
Board [2h 4c 7h]
Seat 1: quickkilllah folded before Flop (didn't bet)
Seat 2: jumbo10 collected ($2.25)
Seat 5: jm_mathurin folded before Flop (didn't bet)
Seat 6: Stapher folded before Flop (didn't bet)
Seat 7: thing93001 (button) folded on the Flop
Seat 8: brujo120 (small blind) folded before Flop
Seat 9: Alameda22 (big blind) folded before Flop



PokerStars Game #19978187821:  Hold'em No Limit ($0.10/$0.25) - 2008/08/28 - 22:29:05 (ET)
Table 'Vesta III' 9-max Seat #8 is the button
Seat 1: quickkilllah ($21.35 in chips) 
Seat 2: jumbo10 ($16.85 in chips) 
Seat 5: jm_mathurin ($33.25 in chips) 
Seat 6: Stapher ($24.15 in chips) 
Seat 7: thing93001 ($33.55 in chips) 
Seat 8: brujo120 ($15.45 in chips) 
Seat 9: Alameda22 ($24.75 in chips) 
Alameda22: posts small blind $0.10
quickkilllah: posts big blind $0.25
*** HOLE CARDS ***
Dealt to Alameda22 [Ah Qc]
jumbo10: raises $0.25 to $0.50
jm_mathurin: folds 
Stapher: calls $0.50
thing93001: folds 
brujo120: folds 
Alameda22: calls $0.40
quickkilllah: calls $0.25
*** FLOP *** [Jc 8h 7d]
Alameda22: checks 
quickkilllah: checks 
jumbo10: bets $0.25
Stapher: raises $0.75 to $1
Alameda22: folds 
quickkilllah: folds 
jumbo10: calls $0.75
*** TURN *** [Jc 8h 7d] [Th]
jumbo10: bets $0.25
Stapher: calls $0.25
*** RIVER *** [Jc 8h 7d Th] [Jd]
jumbo10: bets $0.25
Stapher: calls $0.25
*** SHOW DOWN ***
jumbo10: shows [5h 5d] (two pair, Jacks and Fives)
Stapher: shows [Ad 8d] (two pair, Jacks and Eights)
Stapher collected $4.80 from pot
*** SUMMARY ***
Total pot $5 | Rake $0.20 
Board [Jc 8h 7d Th Jd]
Seat 1: quickkilllah (big blind) folded on the Flop
Seat 2: jumbo10 showed [5h 5d] and lost with two pair, Jacks and Fives
Seat 5: jm_mathurin folded before Flop (didn't bet)
Seat 6: Stapher showed [Ad 8d] and won ($4.80) with two pair, Jacks and Eights
Seat 7: thing93001 folded before Flop (didn't bet)
Seat 8: brujo120 (button) folded before Flop (didn't bet)
Seat 9: Alameda22 (small blind) folded on the Flop



PokerStars Game #19978214050:  Hold'em No Limit ($0.10/$0.25) - 2008/08/28 - 22:30:19 (ET)
Table 'Vesta III' 9-max Seat #9 is the button
Seat 1: quickkilllah ($20.85 in chips) 
Seat 2: jumbo10 ($14.85 in chips) 
Seat 5: jm_mathurin ($33.25 in chips) 
Seat 6: Stapher ($26.95 in chips) 
Seat 7: thing93001 ($33.55 in chips) 
Seat 8: brujo120 ($15.45 in chips) 
Seat 9: Alameda22 ($24.25 in chips) 
quickkilllah: posts small blind $0.10
jumbo10: posts big blind $0.25
*** HOLE CARDS ***
Dealt to Alameda22 [Qh 3h]
jm_mathurin: folds 
Stapher: folds 
thing93001: raises $0.75 to $1
brujo120: folds 
Alameda22: folds 
quickkilllah: folds 
jumbo10: calls $0.75
*** FLOP *** [5s 5d Ks]
mcdougal2 has returned
jumbo10: bets $0.25
thing93001: raises $2 to $2.25
jumbo10: raises $2 to $4.25
thing93001: raises $28.30 to $32.55 and is all-in
jumbo10: calls $9.60 and is all-in
Uncalled bet ($18.70) returned to thing93001
*** TURN *** [5s 5d Ks] [3c]
*** RIVER *** [5s 5d Ks 3c] [Qs]
*** SHOW DOWN ***
jumbo10: shows [Kh Ts] (two pair, Kings and Fives)
thing93001: shows [As Ad] (two pair, Aces and Fives)
thing93001 collected $28.35 from pot
*** SUMMARY ***
Total pot $29.80 | Rake $1.45 
Board [5s 5d Ks 3c Qs]
Seat 1: quickkilllah (small blind) folded before Flop
Seat 2: jumbo10 (big blind) showed [Kh Ts] and lost with two pair, Kings and Fives
Seat 5: jm_mathurin folded before Flop (didn't bet)
Seat 6: Stapher folded before Flop (didn't bet)
Seat 7: thing93001 showed [As Ad] and won ($28.35) with two pair, Aces and Fives
Seat 8: brujo120 folded before Flop (didn't bet)
Seat 9: Alameda22 (button) folded before Flop (didn't bet)



PokerStars Game #19978232900:  Hold'em No Limit ($0.10/$0.25) - 2008/08/28 - 22:31:11 (ET)
Table 'Vesta III' 9-max Seat #1 is the button
Seat 1: quickkilllah ($20.75 in chips) 
Seat 4: mcdougal2 ($26.70 in chips) 
Seat 5: jm_mathurin ($33.25 in chips) 
Seat 6: Stapher ($26.95 in chips) 
Seat 7: thing93001 ($47.05 in chips) 
Seat 8: brujo120 ($15.45 in chips) 
Seat 9: Alameda22 ($24.25 in chips) 
mcdougal2: posts small blind $0.10
jm_mathurin: posts big blind $0.25
*** HOLE CARDS ***
Dealt to Alameda22 [Js 5c]
Stapher: folds 
thing93001: folds 
brujo120: folds 
Alameda22: folds 
quickkilllah: folds 
mcdougal2: calls $0.15
jm_mathurin: checks 
*** FLOP *** [5s Ts Qh]
mcdougal2: checks 
jm_mathurin: bets $0.50
jumbo10 has returned
mcdougal2: folds 
Uncalled bet ($0.50) returned to jm_mathurin
jm_mathurin collected $0.50 from pot
*** SUMMARY ***
Total pot $0.50 | Rake $0 
Board [5s Ts Qh]
Seat 1: quickkilllah (button) folded before Flop (didn't bet)
Seat 4: mcdougal2 (small blind) folded on the Flop
Seat 5: jm_mathurin (big blind) collected ($0.50)
Seat 6: Stapher folded before Flop (didn't bet)
Seat 7: thing93001 folded before Flop (didn't bet)
Seat 8: brujo120 folded before Flop (didn't bet)
Seat 9: Alameda22 folded before Flop (didn't bet)



PokerStars Game #19978247723:  Hold'em No Limit ($0.10/$0.25) - 2008/08/28 - 22:31:49 (ET)
Table 'Vesta III' 9-max Seat #4 is the button
Seat 1: quickkilllah ($20.75 in chips) 
Seat 2: jumbo10 ($10 in chips) 
Seat 4: mcdougal2 ($26.45 in chips) 
Seat 5: jm_mathurin ($33.50 in chips) 
Seat 6: Stapher ($26.95 in chips) 
Seat 7: thing93001 ($47.05 in chips) 
Seat 8: brujo120 ($15.45 in chips) 
Seat 9: Alameda22 ($24.25 in chips) 
jm_mathurin: posts small blind $0.10
Stapher: posts big blind $0.25
jumbo10: posts small blind $0.10
*** HOLE CARDS ***
Dealt to Alameda22 [Qd 6c]
thing93001: folds 
brujo120: folds 
Alameda22: folds 
quickkilllah: folds 
jumbo10: raises $1.25 to $1.50
mcdougal2: folds 
jm_mathurin: folds 
Stapher: folds 
Uncalled bet ($1.25) returned to jumbo10
jumbo10 collected $0.70 from pot
jumbo10: doesn't show hand 
*** SUMMARY ***
Total pot $0.70 | Rake $0 
Seat 1: quickkilllah folded before Flop (didn't bet)
Seat 2: jumbo10 collected ($0.70)
Seat 4: mcdougal2 (button) folded before Flop (didn't bet)
Seat 5: jm_mathurin (small blind) folded before Flop
Seat 6: Stapher (big blind) folded before Flop
Seat 7: thing93001 folded before Flop (didn't bet)
Seat 8: brujo120 folded before Flop (didn't bet)
Seat 9: Alameda22 folded before Flop (didn't bet)



PokerStars Game #19978264473:  Hold'em No Limit ($0.10/$0.25) - 2008/08/28 - 22:32:33 (ET)
Table 'Vesta III' 9-max Seat #5 is the button
Seat 1: quickkilllah ($20.75 in chips) 
Seat 2: jumbo10 ($10.35 in chips) 
Seat 4: mcdougal2 ($26.45 in chips) 
Seat 5: jm_mathurin ($33.40 in chips) 
Seat 6: Stapher ($26.70 in chips) 
Seat 7: thing93001 ($47.05 in chips) 
Seat 8: brujo120 ($15.45 in chips) 
Seat 9: Alameda22 ($24.25 in chips) 
Stapher: posts small blind $0.10
thing93001: posts big blind $0.25
*** HOLE CARDS ***
Dealt to Alameda22 [8d 4d]
brujo120: folds 
Alameda22: folds 
quickkilllah: folds 
jumbo10: calls $0.25
mcdougal2: folds 
jm_mathurin: raises $1 to $1.25
Stapher: folds 
thing93001: folds 
jumbo10: folds 
Uncalled bet ($1) returned to jm_mathurin
jm_mathurin collected $0.85 from pot
*** SUMMARY ***
Total pot $0.85 | Rake $0 
Seat 1: quickkilllah folded before Flop (didn't bet)
Seat 2: jumbo10 folded before Flop
Seat 4: mcdougal2 folded before Flop (didn't bet)
Seat 5: jm_mathurin (button) collected ($0.85)
Seat 6: Stapher (small blind) folded before Flop
Seat 7: thing93001 (big blind) folded before Flop
Seat 8: brujo120 folded before Flop (didn't bet)
Seat 9: Alameda22 folded before Flop (didn't bet)



PokerStars Game #19978281682:  Hold'em No Limit ($0.10/$0.25) - 2008/08/28 - 22:33:19 (ET)
Table 'Vesta III' 9-max Seat #6 is the button
Seat 1: quickkilllah ($20.75 in chips) 
Seat 2: jumbo10 ($10.10 in chips) 
Seat 4: mcdougal2 ($26.45 in chips) 
Seat 5: jm_mathurin ($34 in chips) 
Seat 6: Stapher ($26.60 in chips) 
Seat 7: thing93001 ($46.80 in chips) 
Seat 8: brujo120 ($15.45 in chips) 
Seat 9: Alameda22 ($24.25 in chips) 
thing93001: posts small blind $0.10
brujo120: posts big blind $0.25
*** HOLE CARDS ***
Dealt to Alameda22 [2d 4d]
Alameda22: folds 
quickkilllah: folds 
jumbo10: calls $0.25
mcdougal2: folds 
jm_mathurin: folds 
Stapher: folds 
thing93001: folds 
brujo120: checks 
*** FLOP *** [Jc 3d Ad]
brujo120: checks 
jumbo10: bets $0.25
brujo120: calls $0.25
*** TURN *** [Jc 3d Ad] [Kd]
brujo120: checks 
jumbo10: bets $0.25
brujo120: calls $0.25
*** RIVER *** [Jc 3d Ad Kd] [Js]
brujo120: checks 
jumbo10: bets $9.35 and is all-in
brujo120: folds 
Uncalled bet ($9.35) returned to jumbo10
jumbo10 collected $1.55 from pot
jumbo10: doesn't show hand 
*** SUMMARY ***
Total pot $1.60 | Rake $0.05 
Board [Jc 3d Ad Kd Js]
Seat 1: quickkilllah folded before Flop (didn't bet)
Seat 2: jumbo10 collected ($1.55)
Seat 4: mcdougal2 folded before Flop (didn't bet)
Seat 5: jm_mathurin folded before Flop (didn't bet)
Seat 6: Stapher (button) folded before Flop (didn't bet)
Seat 7: thing93001 (small blind) folded before Flop
Seat 8: brujo120 (big blind) folded on the River
Seat 9: Alameda22 folded before Flop (didn't bet)



PokerStars Game #19978297894:  Hold'em No Limit ($0.10/$0.25) - 2008/08/28 - 22:34:03 (ET)
Table 'Vesta III' 9-max Seat #7 is the button
Seat 1: quickkilllah ($20.75 in chips) 
Seat 2: jumbo10 ($10.90 in chips) 
Seat 4: mcdougal2 ($26.45 in chips) 
Seat 5: jm_mathurin ($34 in chips) 
Seat 6: Stapher ($26.60 in chips) 
Seat 7: thing93001 ($46.70 in chips) 
Seat 8: brujo120 ($14.70 in chips) 
Seat 9: Alameda22 ($24.25 in chips) 
brujo120: posts small blind $0.10
Alameda22: posts big blind $0.25
*** HOLE CARDS ***
Dealt to Alameda22 [8d 8s]
quickkilllah: folds 
jumbo10: calls $0.25
mcdougal2: folds 
jm_mathurin: raises $1.25 to $1.50
Stapher: folds 
thing93001: folds 
brujo120: folds 
Alameda22: calls $1.25
jumbo10: folds 
*** FLOP *** [9h Qc 5s]
Alameda22: checks 
jm_mathurin: bets $2.25
Alameda22: folds 
Uncalled bet ($2.25) returned to jm_mathurin
jm_mathurin collected $3.20 from pot
*** SUMMARY ***
Total pot $3.35 | Rake $0.15 
Board [9h Qc 5s]
Seat 1: quickkilllah folded before Flop (didn't bet)
Seat 2: jumbo10 folded before Flop
Seat 4: mcdougal2 folded before Flop (didn't bet)
Seat 5: jm_mathurin collected ($3.20)
Seat 6: Stapher folded before Flop (didn't bet)
Seat 7: thing93001 (button) folded before Flop (didn't bet)
Seat 8: brujo120 (small blind) folded before Flop
Seat 9: Alameda22 (big blind) folded on the Flop



PokerStars Game #19978318361:  Hold'em No Limit ($0.10/$0.25) - 2008/08/28 - 22:34:58 (ET)
Table 'Vesta III' 9-max Seat #8 is the button
Seat 1: quickkilllah ($20.75 in chips) 
Seat 2: jumbo10 ($10.65 in chips) 
Seat 4: mcdougal2 ($26.45 in chips) 
Seat 5: jm_mathurin ($35.70 in chips) 
Seat 6: Stapher ($26.60 in chips) 
Seat 7: thing93001 ($46.70 in chips) 
Seat 8: brujo120 ($14.60 in chips) 
Seat 9: Alameda22 ($22.75 in chips) 
Alameda22: posts small blind $0.10
quickkilllah: posts big blind $0.25
*** HOLE CARDS ***
Dealt to Alameda22 [9h 4d]
jumbo10: raises $0.25 to $0.50
KIDNIC has returned
mcdougal2: folds 
jm_mathurin: folds 
Stapher: folds 
thing93001: folds 
brujo120: folds 
Alameda22: folds 
quickkilllah: folds 
Uncalled bet ($0.25) returned to jumbo10
jumbo10 collected $0.60 from pot
jumbo10: doesn't show hand 
*** SUMMARY ***
Total pot $0.60 | Rake $0 
Seat 1: quickkilllah (big blind) folded before Flop
Seat 2: jumbo10 collected ($0.60)
Seat 4: mcdougal2 folded before Flop (didn't bet)
Seat 5: jm_mathurin folded before Flop (didn't bet)
Seat 6: Stapher folded before Flop (didn't bet)
Seat 7: thing93001 folded before Flop (didn't bet)
Seat 8: brujo120 (button) folded before Flop (didn't bet)
Seat 9: Alameda22 (small blind) folded before Flop



PokerStars Game #19978329630:  Hold'em No Limit ($0.10/$0.25) - 2008/08/28 - 22:35:28 (ET)
Table 'Vesta III' 9-max Seat #9 is the button
Seat 1: quickkilllah ($20.50 in chips) 
Seat 2: jumbo10 ($11 in chips) 
Seat 3: KIDNIC ($8.75 in chips) 
Seat 4: mcdougal2 ($26.45 in chips) 
Seat 5: jm_mathurin ($35.70 in chips) 
Seat 6: Stapher ($26.60 in chips) 
Seat 7: thing93001 ($46.70 in chips) 
Seat 8: brujo120 ($14.60 in chips) 
Seat 9: Alameda22 ($22.65 in chips) 
quickkilllah: posts small blind $0.10
jumbo10: posts big blind $0.25
KIDNIC: posts small blind $0.10
*** HOLE CARDS ***
Dealt to Alameda22 [Ac 2d]
KIDNIC: folds 
mcdougal2: folds 
jm_mathurin: folds 
Stapher: folds 
thing93001: folds 
brujo120: folds 
jm_mathurin leaves the table
Alameda22: folds 
quickkilllah: folds 
Uncalled bet ($0.15) returned to jumbo10
jumbo10 collected $0.30 from pot
jumbo10: doesn't show hand 
*** SUMMARY ***
Total pot $0.30 | Rake $0 
Seat 1: quickkilllah (small blind) folded before Flop
Seat 2: jumbo10 (big blind) collected ($0.30)
Seat 3: KIDNIC folded before Flop
Seat 4: mcdougal2 folded before Flop (didn't bet)
Seat 5: jm_mathurin folded before Flop (didn't bet)
Seat 6: Stapher folded before Flop (didn't bet)
Seat 7: thing93001 folded before Flop (didn't bet)
Seat 8: brujo120 folded before Flop (didn't bet)
Seat 9: Alameda22 (button) folded before Flop (didn't bet)



PokerStars Game #19978344382:  Hold'em No Limit ($0.10/$0.25) - 2008/08/28 - 22:36:08 (ET)
Table 'Vesta III' 9-max Seat #1 is the button
Seat 1: quickkilllah ($20.40 in chips) 
Seat 2: jumbo10 ($11.20 in chips) 
Seat 3: KIDNIC ($8.65 in chips) 
Seat 4: mcdougal2 ($26.45 in chips) 
Seat 6: Stapher ($26.60 in chips) 
Seat 7: thing93001 ($46.70 in chips) 
Seat 8: brujo120 ($14.60 in chips) 
Seat 9: Alameda22 ($22.65 in chips) 
jumbo10: posts small blind $0.10
KIDNIC: posts big blind $0.25
*** HOLE CARDS ***
Dealt to Alameda22 [8s 7d]
mcdougal2: folds 
Stapher: folds 
Gr33nfield joins the table at seat #5 
thing93001: folds 
brujo120: folds 
Alameda22: folds 
quickkilllah: folds 
jumbo10: raises $0.25 to $0.50
KIDNIC: folds 
Uncalled bet ($0.25) returned to jumbo10
jumbo10 collected $0.50 from pot
jumbo10: doesn't show hand 
*** SUMMARY ***
Total pot $0.50 | Rake $0 
Seat 1: quickkilllah (button) folded before Flop (didn't bet)
Seat 2: jumbo10 (small blind) collected ($0.50)
Seat 3: KIDNIC (big blind) folded before Flop
Seat 4: mcdougal2 folded before Flop (didn't bet)
Seat 6: Stapher folded before Flop (didn't bet)
Seat 7: thing93001 folded before Flop (didn't bet)
Seat 8: brujo120 folded before Flop (didn't bet)
Seat 9: Alameda22 folded before Flop (didn't bet)



PokerStars Game #19978358647:  Hold'em No Limit ($0.10/$0.25) - 2008/08/28 - 22:36:45 (ET)
Table 'Vesta III' 9-max Seat #2 is the button
Seat 1: quickkilllah ($20.40 in chips) 
Seat 2: jumbo10 ($11.45 in chips) 
Seat 3: KIDNIC ($8.40 in chips) 
Seat 4: mcdougal2 ($26.45 in chips) 
Seat 5: Gr33nfield ($25 in chips) 
Seat 6: Stapher ($26.60 in chips) 
Seat 7: thing93001 ($46.70 in chips) 
Seat 8: brujo120 ($14.60 in chips) 
Seat 9: Alameda22 ($22.65 in chips) 
KIDNIC: posts small blind $0.10
mcdougal2: posts big blind $0.25
Gr33nfield: posts big blind $0.25
*** HOLE CARDS ***
Dealt to Alameda22 [Ac 9s]
Gr33nfield: checks 
Stapher: folds 
thing93001: folds 
brujo120: calls $0.25
Alameda22: folds 
quickkilllah: folds 
jumbo10: calls $0.25
KIDNIC: folds 
mcdougal2: checks 
*** FLOP *** [Qd Kh Js]
mcdougal2: checks 
Gr33nfield: bets $0.75
brujo120: calls $0.75
jumbo10: folds 
mcdougal2: folds 
*** TURN *** [Qd Kh Js] [8c]
Gr33nfield: bets $1.75
brujo120: calls $1.75
*** RIVER *** [Qd Kh Js 8c] [Qh]
Gr33nfield: bets $4
brujo120: folds 
Uncalled bet ($4) returned to Gr33nfield
Gr33nfield collected $5.80 from pot
Gr33nfield: doesn't show hand 
*** SUMMARY ***
Total pot $6.10 | Rake $0.30 
Board [Qd Kh Js 8c Qh]
Seat 1: quickkilllah folded before Flop (didn't bet)
Seat 2: jumbo10 (button) folded on the Flop
Seat 3: KIDNIC (small blind) folded before Flop
Seat 4: mcdougal2 (big blind) folded on the Flop
Seat 5: Gr33nfield collected ($5.80)
Seat 6: Stapher folded before Flop (didn't bet)
Seat 7: thing93001 folded before Flop (didn't bet)
Seat 8: brujo120 folded on the River
Seat 9: Alameda22 folded before Flop (didn't bet)



PokerStars Game #19978396960:  Hold'em No Limit ($0.10/$0.25) - 2008/08/28 - 22:38:29 (ET)
Table 'Vesta III' 9-max Seat #3 is the button
Seat 1: quickkilllah ($25 in chips) 
Seat 2: jumbo10 ($11.20 in chips) 
Seat 3: KIDNIC ($8.30 in chips) 
Seat 4: mcdougal2 ($26.20 in chips) 
Seat 5: Gr33nfield ($28.05 in chips) 
Seat 6: Stapher ($26.60 in chips) 
Seat 7: thing93001 ($46.70 in chips) 
Seat 8: brujo120 ($11.85 in chips) 
Seat 9: Alameda22 ($22.65 in chips) 
mcdougal2: posts small blind $0.10
Gr33nfield: posts big blind $0.25
*** HOLE CARDS ***
Dealt to Alameda22 [3s Jd]
Stapher: calls $0.25
thing93001: folds 
brujo120: folds 
Alameda22: folds 
quickkilllah: folds 
jumbo10: folds 
KIDNIC: folds 
mcdougal2: calls $0.15
Gr33nfield: checks 
*** FLOP *** [8c 5h Ad]
mcdougal2: checks 
Gr33nfield: bets $0.25
Stapher: folds 
mcdougal2: calls $0.25
*** TURN *** [8c 5h Ad] [Qs]
mcdougal2: checks 
Stapher leaves the table
Gr33nfield: bets $0.50
mcdougal2: folds 
Uncalled bet ($0.50) returned to Gr33nfield
Gr33nfield collected $1.20 from pot
*** SUMMARY ***
Total pot $1.25 | Rake $0.05 
Board [8c 5h Ad Qs]
Seat 1: quickkilllah folded before Flop (didn't bet)
Seat 2: jumbo10 folded before Flop (didn't bet)
Seat 3: KIDNIC (button) folded before Flop (didn't bet)
Seat 4: mcdougal2 (small blind) folded on the Turn
Seat 5: Gr33nfield (big blind) collected ($1.20)
Seat 6: Stapher folded on the Flop
Seat 7: thing93001 folded before Flop (didn't bet)
Seat 8: brujo120 folded before Flop (didn't bet)
Seat 9: Alameda22 folded before Flop (didn't bet)



PokerStars Game #19978431849:  Hold'em No Limit ($0.10/$0.25) - 2008/08/28 - 22:40:01 (ET)
Table 'Vesta III' 9-max Seat #4 is the button
Seat 1: quickkilllah ($25 in chips) 
Seat 2: jumbo10 ($11.20 in chips) 
Seat 3: KIDNIC ($8.30 in chips) 
Seat 4: mcdougal2 ($25.70 in chips) 
Seat 5: Gr33nfield ($28.75 in chips) 
Seat 7: thing93001 ($46.70 in chips) 
Seat 8: brujo120 ($11.85 in chips) 
Seat 9: Alameda22 ($22.65 in chips) 
Gr33nfield: posts small blind $0.10
thing93001: posts big blind $0.25
*** HOLE CARDS ***
Dealt to Alameda22 [Js 4d]
brujo120: folds 
Alameda22: folds 
quickkilllah: folds 
jumbo10: raises $0.25 to $0.50
KIDNIC: folds 
mcdougal2: folds 
Gr33nfield: raises $0.50 to $1
thing93001: folds 
jumbo10: raises $0.50 to $1.50
Gr33nfield: calls $0.50
*** FLOP *** [2c Qs 5d]
Gr33nfield: checks 
jumbo10: bets $9.70 and is all-in
Gr33nfield: folds 
Uncalled bet ($9.70) returned to jumbo10
jumbo10 collected $3.10 from pot
jumbo10: doesn't show hand 
*** SUMMARY ***
Total pot $3.25 | Rake $0.15 
Board [2c Qs 5d]
Seat 1: quickkilllah folded before Flop (didn't bet)
Seat 2: jumbo10 collected ($3.10)
Seat 3: KIDNIC folded before Flop (didn't bet)
Seat 4: mcdougal2 (button) folded before Flop (didn't bet)
Seat 5: Gr33nfield (small blind) folded on the Flop
Seat 7: thing93001 (big blind) folded before Flop
Seat 8: brujo120 folded before Flop (didn't bet)
Seat 9: Alameda22 folded before Flop (didn't bet)



PokerStars Game #19978453149:  Hold'em No Limit ($0.10/$0.25) - 2008/08/28 - 22:40:58 (ET)
Table 'Vesta III' 9-max Seat #5 is the button
Seat 1: quickkilllah ($25 in chips) 
Seat 2: jumbo10 ($12.80 in chips) 
Seat 3: KIDNIC ($8.30 in chips) 
Seat 4: mcdougal2 ($25.70 in chips) 
Seat 5: Gr33nfield ($27.25 in chips) 
Seat 7: thing93001 ($46.45 in chips) 
Seat 8: brujo120 ($11.85 in chips) 
Seat 9: Alameda22 ($22.65 in chips) 
thing93001: posts small blind $0.10
brujo120: posts big blind $0.25
*** HOLE CARDS ***
Dealt to Alameda22 [Kc 6s]
lbcpa joins the table at seat #6 
Alameda22: folds 
quickkilllah: raises $0.75 to $1
jumbo10: calls $1
KIDNIC: folds 
mcdougal2: folds 
Gr33nfield: folds 
thing93001: folds 
brujo120: folds 
*** FLOP *** [Th 2c 3d]
quickkilllah: bets $1.25
jumbo10: raises $1.25 to $2.50
quickkilllah: calls $1.25
*** TURN *** [Th 2c 3d] [Js]
quickkilllah: checks 
jumbo10: bets $9.30 and is all-in
quickkilllah: calls $9.30
*** RIVER *** [Th 2c 3d Js] [5d]
*** SHOW DOWN ***
quickkilllah: shows [2h 2d] (three of a kind, Deuces)
jumbo10: mucks hand 
quickkilllah collected $24.70 from pot
*** SUMMARY ***
Total pot $25.95 | Rake $1.25 
Board [Th 2c 3d Js 5d]
Seat 1: quickkilllah showed [2h 2d] and won ($24.70) with three of a kind, Deuces
Seat 2: jumbo10 mucked [Ks Td]
Seat 3: KIDNIC folded before Flop (didn't bet)
Seat 4: mcdougal2 folded before Flop (didn't bet)
Seat 5: Gr33nfield (button) folded before Flop (didn't bet)
Seat 7: thing93001 (small blind) folded before Flop
Seat 8: brujo120 (big blind) folded before Flop
Seat 9: Alameda22 folded before Flop (didn't bet)



PokerStars Game #19978482413:  Hold'em No Limit ($0.10/$0.25) - 2008/08/28 - 22:42:17 (ET)
Table 'Vesta III' 9-max Seat #7 is the button
Seat 1: quickkilllah ($36.90 in chips) 
Seat 3: KIDNIC ($8.30 in chips) 
Seat 4: mcdougal2 ($25.70 in chips) 
Seat 5: Gr33nfield ($27.25 in chips) 
Seat 6: lbcpa ($11 in chips) 
Seat 7: thing93001 ($46.35 in chips) 
Seat 8: brujo120 ($11.60 in chips) 
Seat 9: Alameda22 ($22.65 in chips) 
brujo120: posts small blind $0.10
Alameda22: posts big blind $0.25
lbcpa: posts big blind $0.25
*** HOLE CARDS ***
Dealt to Alameda22 [Td Jh]
quickkilllah: raises $0.75 to $1
jumbo10 leaves the table
KIDNIC: folds 
mcdougal2: folds 
Gr33nfield: folds 
lbcpa: folds 
thing93001: folds 
brujo120: folds 
Alameda22: folds 
Uncalled bet ($0.75) returned to quickkilllah
quickkilllah collected $0.85 from pot
quickkilllah: doesn't show hand 
*** SUMMARY ***
Total pot $0.85 | Rake $0 
Seat 1: quickkilllah collected ($0.85)
Seat 3: KIDNIC folded before Flop (didn't bet)
Seat 4: mcdougal2 folded before Flop (didn't bet)
Seat 5: Gr33nfield folded before Flop (didn't bet)
Seat 6: lbcpa folded before Flop
Seat 7: thing93001 (button) folded before Flop (didn't bet)
Seat 8: brujo120 (small blind) folded before Flop
Seat 9: Alameda22 (big blind) folded before Flop



PokerStars Game #19978500172:  Hold'em No Limit ($0.10/$0.25) - 2008/08/28 - 22:43:06 (ET)
Table 'Vesta III' 9-max Seat #8 is the button
Seat 1: quickkilllah ($37.50 in chips) 
Seat 3: KIDNIC ($8.30 in chips) 
Seat 4: mcdougal2 ($25.70 in chips) 
Seat 5: Gr33nfield ($27.25 in chips) 
Seat 6: lbcpa ($10.75 in chips) 
Seat 7: thing93001 ($46.35 in chips) 
Seat 8: brujo120 ($11.50 in chips) 
Seat 9: Alameda22 ($22.40 in chips) 
Alameda22: posts small blind $0.10
quickkilllah: posts big blind $0.25
*** HOLE CARDS ***
Dealt to Alameda22 [Ks 4s]
KIDNIC: calls $0.25
mcdougal2: folds 
Gr33nfield: raises $0.50 to $0.75
lbcpa: calls $0.75
thing93001: folds 
brujo120: folds 
Alameda22: folds 
quickkilllah: folds 
KIDNIC: folds 
*** FLOP *** [7h Jc As]
Gr33nfield: bets $1.50
lbcpa: folds 
Uncalled bet ($1.50) returned to Gr33nfield
Gr33nfield collected $2 from pot
Gr33nfield: doesn't show hand 
*** SUMMARY ***
Total pot $2.10 | Rake $0.10 
Board [7h Jc As]
Seat 1: quickkilllah (big blind) folded before Flop
Seat 3: KIDNIC folded before Flop
Seat 4: mcdougal2 folded before Flop (didn't bet)
Seat 5: Gr33nfield collected ($2)
Seat 6: lbcpa folded on the Flop
Seat 7: thing93001 folded before Flop (didn't bet)
Seat 8: brujo120 (button) folded before Flop (didn't bet)
Seat 9: Alameda22 (small blind) folded before Flop



PokerStars Game #19978519777:  Hold'em No Limit ($0.10/$0.25) - 2008/08/28 - 22:44:00 (ET)
Table 'Vesta III' 9-max Seat #9 is the button
Seat 1: quickkilllah ($37.25 in chips) 
Seat 3: KIDNIC ($8.05 in chips) 
Seat 4: mcdougal2 ($25.70 in chips) 
Seat 5: Gr33nfield ($28.50 in chips) 
Seat 6: lbcpa ($10 in chips) 
Seat 7: thing93001 ($46.35 in chips) 
Seat 8: brujo120 ($11.50 in chips) 
Seat 9: Alameda22 ($22.30 in chips) 
quickkilllah: posts small blind $0.10
KIDNIC: posts big blind $0.25
*** HOLE CARDS ***
Dealt to Alameda22 [2d 9h]
mcdougal2: folds 
Gr33nfield: folds 
lbcpa: calls $0.25
thing93001: folds 
brujo120: folds 
Alameda22: folds 
quickkilllah: calls $0.15
KIDNIC: checks 
*** FLOP *** [Jc Th 5c]
quickkilllah: checks 
KIDNIC: checks 
lbcpa: checks 
*** TURN *** [Jc Th 5c] [Td]
quickkilllah: bets $0.50
KIDNIC: folds 
lbcpa: folds 
Uncalled bet ($0.50) returned to quickkilllah
Skudero joins the table at seat #2 
quickkilllah collected $0.75 from pot
quickkilllah: doesn't show hand 
*** SUMMARY ***
Total pot $0.75 | Rake $0 
Board [Jc Th 5c Td]
Seat 1: quickkilllah (small blind) collected ($0.75)
Seat 3: KIDNIC (big blind) folded on the Turn
Seat 4: mcdougal2 folded before Flop (didn't bet)
Seat 5: Gr33nfield folded before Flop (didn't bet)
Seat 6: lbcpa folded on the Turn
Seat 7: thing93001 folded before Flop (didn't bet)
Seat 8: brujo120 folded before Flop (didn't bet)
Seat 9: Alameda22 (button) folded before Flop (didn't bet)



PokerStars Game #19978544879:  Hold'em No Limit ($0.10/$0.25) - 2008/08/28 - 22:45:10 (ET)
Table 'Vesta III' 9-max Seat #1 is the button
Seat 1: quickkilllah ($37.75 in chips) 
Seat 3: KIDNIC ($17.80 in chips) 
Seat 4: mcdougal2 ($25.70 in chips) 
Seat 5: Gr33nfield ($28.50 in chips) 
Seat 6: lbcpa ($9.75 in chips) 
Seat 7: thing93001 ($46.35 in chips) 
Seat 8: brujo120 ($11.50 in chips) 
Seat 9: Alameda22 ($22.30 in chips) 
Skudero will be allowed to play after the button
KIDNIC: posts small blind $0.10
mcdougal2: posts big blind $0.25
*** HOLE CARDS ***
Dealt to Alameda22 [4s Ah]
Gr33nfield: folds 
lbcpa: folds 
thing93001: folds 
brujo120: folds 
Alameda22: folds 
quickkilllah: raises $0.75 to $1
KIDNIC: folds 
mcdougal2: folds 
Uncalled bet ($0.75) returned to quickkilllah
quickkilllah collected $0.60 from pot
quickkilllah: doesn't show hand 
*** SUMMARY ***
Total pot $0.60 | Rake $0 
Seat 1: quickkilllah (button) collected ($0.60)
Seat 3: KIDNIC (small blind) folded before Flop
Seat 4: mcdougal2 (big blind) folded before Flop
Seat 5: Gr33nfield folded before Flop (didn't bet)
Seat 6: lbcpa folded before Flop (didn't bet)
Seat 7: thing93001 folded before Flop (didn't bet)
Seat 8: brujo120 folded before Flop (didn't bet)
Seat 9: Alameda22 folded before Flop (didn't bet)



PokerStars Game #19978557582:  Hold'em No Limit ($0.10/$0.25) - 2008/08/28 - 22:45:45 (ET)
Table 'Vesta III' 9-max Seat #3 is the button
Seat 1: quickkilllah ($38.10 in chips) 
Seat 3: KIDNIC ($17.70 in chips) 
Seat 4: mcdougal2 ($25.45 in chips) 
Seat 5: Gr33nfield ($28.50 in chips) 
Seat 6: lbcpa ($9.75 in chips) 
Seat 7: thing93001 ($46.35 in chips) 
Seat 8: brujo120 ($11.50 in chips) 
Seat 9: Alameda22 ($22.30 in chips) 
mcdougal2: posts small blind $0.10
Gr33nfield: posts big blind $0.25
Skudero: sits out 
*** HOLE CARDS ***
Dealt to Alameda22 [Js Ah]
lbcpa: calls $0.25
thing93001: folds 
brujo120: folds 
Alameda22: folds 
quickkilllah: folds 
KIDNIC: folds 
mcdougal2: calls $0.15
Gr33nfield: checks 
*** FLOP *** [Kc 8c 3s]
mcdougal2: checks 
Gr33nfield: checks 
lbcpa: bets $0.50
mcdougal2: folds 
Gr33nfield: folds 
Uncalled bet ($0.50) returned to lbcpa
lbcpa collected $0.75 from pot
lbcpa: doesn't show hand 
*** SUMMARY ***
Total pot $0.75 | Rake $0 
Board [Kc 8c 3s]
Seat 1: quickkilllah folded before Flop (didn't bet)
Seat 3: KIDNIC (button) folded before Flop (didn't bet)
Seat 4: mcdougal2 (small blind) folded on the Flop
Seat 5: Gr33nfield (big blind) folded on the Flop
Seat 6: lbcpa collected ($0.75)
Seat 7: thing93001 folded before Flop (didn't bet)
Seat 8: brujo120 folded before Flop (didn't bet)
Seat 9: Alameda22 folded before Flop (didn't bet)



PokerStars Game #19978580313:  Hold'em No Limit ($0.10/$0.25) - 2008/08/28 - 22:46:49 (ET)
Table 'Vesta III' 9-max Seat #4 is the button
Seat 1: quickkilllah ($38.10 in chips) 
Seat 3: KIDNIC ($17.70 in chips) 
Seat 4: mcdougal2 ($25.20 in chips) 
Seat 5: Gr33nfield ($28.25 in chips) 
Seat 6: lbcpa ($10.25 in chips) 
Seat 7: thing93001 ($46.35 in chips) 
Seat 8: brujo120 ($11.50 in chips) 
Seat 9: Alameda22 ($22.30 in chips) 
Gr33nfield: posts small blind $0.10
lbcpa: posts big blind $0.25
Skudero: sits out 
*** HOLE CARDS ***
Dealt to Alameda22 [2d 4c]
thing93001: raises $0.50 to $0.75
brujo120: folds 
Alameda22: folds 
quickkilllah: folds 
brujo120 leaves the table
KIDNIC: folds 
mcdougal2: folds 
Gr33nfield: folds 
lbcpa: folds 
Uncalled bet ($0.50) returned to thing93001
thing93001 collected $0.60 from pot
thing93001: doesn't show hand 
*** SUMMARY ***
Total pot $0.60 | Rake $0 
Seat 1: quickkilllah folded before Flop (didn't bet)
Seat 3: KIDNIC folded before Flop (didn't bet)
Seat 4: mcdougal2 (button) folded before Flop (didn't bet)
Seat 5: Gr33nfield (small blind) folded before Flop
Seat 6: lbcpa (big blind) folded before Flop
Seat 7: thing93001 collected ($0.60)
Seat 8: brujo120 folded before Flop (didn't bet)
Seat 9: Alameda22 folded before Flop (didn't bet)



PokerStars Game #19978594499:  Hold'em No Limit ($0.10/$0.25) - 2008/08/28 - 22:47:29 (ET)
Table 'Vesta III' 9-max Seat #5 is the button
Seat 1: quickkilllah ($38.10 in chips) 
Seat 3: KIDNIC ($17.70 in chips) 
Seat 4: mcdougal2 ($25.20 in chips) 
Seat 5: Gr33nfield ($28.15 in chips) 
Seat 6: lbcpa ($10 in chips) 
Seat 7: thing93001 ($46.70 in chips) 
Seat 9: Alameda22 ($22.30 in chips) 
lbcpa: posts small blind $0.10
thing93001: posts big blind $0.25
Skudero: sits out 
*** HOLE CARDS ***
Dealt to Alameda22 [8c Qh]
Dooley2005 joins the table at seat #8 
Alameda22: folds 
quickkilllah: folds 
KIDNIC: folds 
mcdougal2: calls $0.25
Gr33nfield: folds 
lbcpa: raises $0.50 to $0.75
thing93001: folds 
mcdougal2: calls $0.50
*** FLOP *** [4d Js Td]
lbcpa: bets $0.50
mcdougal2: folds 
Uncalled bet ($0.50) returned to lbcpa
lbcpa collected $1.70 from pot
lbcpa: doesn't show hand 
*** SUMMARY ***
Total pot $1.75 | Rake $0.05 
Board [4d Js Td]
Seat 1: quickkilllah folded before Flop (didn't bet)
Seat 3: KIDNIC folded before Flop (didn't bet)
Seat 4: mcdougal2 folded on the Flop
Seat 5: Gr33nfield (button) folded before Flop (didn't bet)
Seat 6: lbcpa (small blind) collected ($1.70)
Seat 7: thing93001 (big blind) folded before Flop
Seat 9: Alameda22 folded before Flop (didn't bet)



PokerStars Game #19978614196:  Hold'em No Limit ($0.10/$0.25) - 2008/08/28 - 22:48:25 (ET)
Table 'Vesta III' 9-max Seat #6 is the button
Seat 1: quickkilllah ($38.10 in chips) 
Seat 3: KIDNIC ($17.70 in chips) 
Seat 4: mcdougal2 ($24.45 in chips) 
Seat 5: Gr33nfield ($28.15 in chips) 
Seat 6: lbcpa ($10.95 in chips) 
Seat 7: thing93001 ($46.45 in chips) 
Seat 8: Dooley2005 ($25 in chips) 
Seat 9: Alameda22 ($22.30 in chips) 
thing93001: posts small blind $0.10
Dooley2005: posts big blind $0.25
Skudero: sits out 
*** HOLE CARDS ***
Dealt to Alameda22 [5d 2c]
Alameda22: folds 
quickkilllah: folds 
KIDNIC: folds 
mcdougal2: folds 
Gr33nfield: folds 
lbcpa: raises $0.25 to $0.50
thing93001: folds 
Dooley2005: folds 
Uncalled bet ($0.25) returned to lbcpa
lbcpa collected $0.60 from pot
lbcpa is sitting out
lbcpa: doesn't show hand 
*** SUMMARY ***
Total pot $0.60 | Rake $0 
Seat 1: quickkilllah folded before Flop (didn't bet)
Seat 3: KIDNIC folded before Flop (didn't bet)
Seat 4: mcdougal2 folded before Flop (didn't bet)
Seat 5: Gr33nfield folded before Flop (didn't bet)
Seat 6: lbcpa (button) collected ($0.60)
Seat 7: thing93001 (small blind) folded before Flop
Seat 8: Dooley2005 (big blind) folded before Flop
Seat 9: Alameda22 folded before Flop (didn't bet)



PokerStars Game #19978636002:  Hold'em No Limit ($0.10/$0.25) - 2008/08/28 - 22:49:26 (ET)
Table 'Vesta III' 9-max Seat #7 is the button
Seat 1: quickkilllah ($38.10 in chips) 
Seat 3: KIDNIC ($17.70 in chips) 
Seat 4: mcdougal2 ($24.45 in chips) 
Seat 5: Gr33nfield ($28.15 in chips) 
Seat 7: thing93001 ($46.35 in chips) 
Seat 8: Dooley2005 ($24.75 in chips) 
Seat 9: Alameda22 ($22.30 in chips) 
Dooley2005: posts small blind $0.10
Alameda22: posts big blind $0.25
Skudero: sits out 
*** HOLE CARDS ***
Dealt to Alameda22 [Ks 5h]
lbcpa leaves the table
quickkilllah: folds 
KIDNIC: folds 
mcdougal2: folds 
Gr33nfield: raises $0.50 to $0.75
thing93001: folds 
Dooley2005: raises $2.25 to $3
Alameda22: folds 
Gr33nfield: raises $2.25 to $5.25
Dooley2005: folds 
Uncalled bet ($2.25) returned to Gr33nfield
Gr33nfield collected $6.25 from pot
*** SUMMARY ***
Total pot $6.25 | Rake $0 
Seat 1: quickkilllah folded before Flop (didn't bet)
Seat 3: KIDNIC folded before Flop (didn't bet)
Seat 4: mcdougal2 folded before Flop (didn't bet)
Seat 5: Gr33nfield collected ($6.25)
Seat 7: thing93001 (button) folded before Flop (didn't bet)
Seat 8: Dooley2005 (small blind) folded before Flop
Seat 9: Alameda22 (big blind) folded before Flop



PokerStars Game #19978655316:  Hold'em No Limit ($0.10/$0.25) - 2008/08/28 - 22:50:19 (ET)
Table 'Vesta III' 9-max Seat #8 is the button
Seat 1: quickkilllah ($38.10 in chips) 
Seat 3: KIDNIC ($17.70 in chips) 
Seat 4: mcdougal2 ($24.45 in chips) 
Seat 5: Gr33nfield ($31.40 in chips) 
Seat 7: thing93001 ($46.35 in chips) 
Seat 8: Dooley2005 ($21.75 in chips) 
Seat 9: Alameda22 ($22.05 in chips) 
Alameda22: posts small blind $0.10
quickkilllah: posts big blind $0.25
Skudero: sits out 
*** HOLE CARDS ***
Dealt to Alameda22 [6c 2c]
KIDNIC: folds 
mcdougal2: folds 
Gr33nfield: raises $0.50 to $0.75
thing93001: calls $0.75
Dooley2005: folds 
Alameda22: folds 
quickkilllah: folds 
*** FLOP *** [Qh Ks Ad]
Gr33nfield: checks 
thing93001: bets $1.50
Gr33nfield said, "i guess thats about the worst flop for jj"
Gr33nfield: folds 
Uncalled bet ($1.50) returned to thing93001
thing93001 collected $1.80 from pot
thing93001: doesn't show hand 
*** SUMMARY ***
Total pot $1.85 | Rake $0.05 
Board [Qh Ks Ad]
Seat 1: quickkilllah (big blind) folded before Flop
Seat 3: KIDNIC folded before Flop (didn't bet)
Seat 4: mcdougal2 folded before Flop (didn't bet)
Seat 5: Gr33nfield folded on the Flop
Seat 7: thing93001 collected ($1.80)
Seat 8: Dooley2005 (button) folded before Flop (didn't bet)
Seat 9: Alameda22 (small blind) folded before Flop



PokerStars Game #19978679963:  Hold'em No Limit ($0.10/$0.25) - 2008/08/28 - 22:51:29 (ET)
Table 'Vesta III' 9-max Seat #9 is the button
Seat 1: quickkilllah ($37.85 in chips) 
Seat 2: Skudero ($25 in chips) 
Seat 3: KIDNIC ($17.70 in chips) 
Seat 4: mcdougal2 ($24.45 in chips) 
Seat 5: Gr33nfield ($30.65 in chips) 
Seat 7: thing93001 ($47.40 in chips) 
Seat 8: Dooley2005 ($21.75 in chips) 
Seat 9: Alameda22 ($21.95 in chips) 
quickkilllah: posts small blind $0.10
Skudero: posts big blind $0.25
*** HOLE CARDS ***
Dealt to Alameda22 [3s 2h]
KIDNIC: calls $0.25
mcdougal2: folds 
Gr33nfield said, "lets try this again"
LionDream joins the table at seat #6 
Gr33nfield: raises $0.50 to $0.75
thing93001: folds 
Dooley2005: folds 
Alameda22: folds 
quickkilllah: folds 
Skudero: folds 
KIDNIC: folds 
Uncalled bet ($0.50) returned to Gr33nfield
Gr33nfield collected $0.85 from pot
*** SUMMARY ***
Total pot $0.85 | Rake $0 
Seat 1: quickkilllah (small blind) folded before Flop
Seat 2: Skudero (big blind) folded before Flop
Seat 3: KIDNIC folded before Flop
Seat 4: mcdougal2 folded before Flop (didn't bet)
Seat 5: Gr33nfield collected ($0.85)
Seat 7: thing93001 folded before Flop (didn't bet)
Seat 8: Dooley2005 folded before Flop (didn't bet)
Seat 9: Alameda22 (button) folded before Flop (didn't bet)



PokerStars Game #19978699266:  Hold'em No Limit ($0.10/$0.25) - 2008/08/28 - 22:52:21 (ET)
Table 'Vesta III' 9-max Seat #1 is the button
Seat 1: quickkilllah ($37.75 in chips) 
Seat 2: Skudero ($24.75 in chips) 
Seat 3: KIDNIC ($17.45 in chips) 
Seat 4: mcdougal2 ($24.45 in chips) 
Seat 5: Gr33nfield ($31.25 in chips) 
Seat 6: LionDream ($15 in chips) 
Seat 7: thing93001 ($47.40 in chips) 
Seat 8: Dooley2005 ($21.75 in chips) 
Seat 9: Alameda22 ($21.95 in chips) 
Skudero: posts small blind $0.10
KIDNIC: posts big blind $0.25
LionDream: posts big blind $0.25
*** HOLE CARDS ***
Dealt to Alameda22 [4c Tc]
mcdougal2: folds 
Gr33nfield: folds 
LionDream: checks 
thing93001: raises $0.50 to $0.75
Dooley2005: folds 
Alameda22: folds 
quickkilllah: folds 
Skudero: calls $0.65
KIDNIC: folds 
LionDream: folds 
*** FLOP *** [8h Ac 5d]
Skudero: checks 
thing93001: bets $1.25
Skudero: calls $1.25
*** TURN *** [8h Ac 5d] [9h]
Skudero: checks 
thing93001: checks 
*** RIVER *** [8h Ac 5d 9h] [Kc]
Skudero: bets $4
thing93001: calls $4
*** SHOW DOWN ***
Skudero: shows [8s 8c] (three of a kind, Eights)
thing93001: mucks hand 
Skudero collected $11.90 from pot
*** SUMMARY ***
Total pot $12.50 | Rake $0.60 
Board [8h Ac 5d 9h Kc]
Seat 1: quickkilllah (button) folded before Flop (didn't bet)
Seat 2: Skudero (small blind) showed [8s 8c] and won ($11.90) with three of a kind, Eights
Seat 3: KIDNIC (big blind) folded before Flop
Seat 4: mcdougal2 folded before Flop (didn't bet)
Seat 5: Gr33nfield folded before Flop (didn't bet)
Seat 6: LionDream folded before Flop
Seat 7: thing93001 mucked [As Qh]
Seat 8: Dooley2005 folded before Flop (didn't bet)
Seat 9: Alameda22 folded before Flop (didn't bet)



PokerStars Game #19978724861:  Hold'em No Limit ($0.10/$0.25) - 2008/08/28 - 22:53:34 (ET)
Table 'Vesta III' 9-max Seat #2 is the button
Seat 1: quickkilllah ($37.75 in chips) 
Seat 2: Skudero ($30.65 in chips) 
Seat 3: KIDNIC ($17.20 in chips) 
Seat 4: mcdougal2 ($24.45 in chips) 
Seat 5: Gr33nfield ($31.25 in chips) 
Seat 6: LionDream ($14.75 in chips) 
Seat 7: thing93001 ($41.40 in chips) 
Seat 8: Dooley2005 ($21.75 in chips) 
Seat 9: Alameda22 ($21.95 in chips) 
KIDNIC: posts small blind $0.10
mcdougal2: posts big blind $0.25
*** HOLE CARDS ***
Dealt to Alameda22 [Ac 2h]
Gr33nfield: folds 
LionDream: raises $0.25 to $0.50
thing93001: folds 
Dooley2005: folds 
Alameda22: folds 
quickkilllah: folds 
Skudero: folds 
KIDNIC: calls $0.40
mcdougal2: folds 
*** FLOP *** [Kh Kc Js]
KIDNIC: checks 
LionDream: bets $1.25
KIDNIC: calls $1.25
*** TURN *** [Kh Kc Js] [Td]
KIDNIC: checks 
LionDream: checks 
*** RIVER *** [Kh Kc Js Td] [5c]
KIDNIC: bets $2.75
LionDream: calls $2.75
*** SHOW DOWN ***
KIDNIC: shows [Kd Ah] (three of a kind, Kings)
LionDream: mucks hand 
KIDNIC collected $8.80 from pot
*** SUMMARY ***
Total pot $9.25 | Rake $0.45 
Board [Kh Kc Js Td 5c]
Seat 1: quickkilllah folded before Flop (didn't bet)
Seat 2: Skudero (button) folded before Flop (didn't bet)
Seat 3: KIDNIC (small blind) showed [Kd Ah] and won ($8.80) with three of a kind, Kings
Seat 4: mcdougal2 (big blind) folded before Flop
Seat 5: Gr33nfield folded before Flop (didn't bet)
Seat 6: LionDream mucked [Ad 5d]
Seat 7: thing93001 folded before Flop (didn't bet)
Seat 8: Dooley2005 folded before Flop (didn't bet)
Seat 9: Alameda22 folded before Flop (didn't bet)



PokerStars Game #19978755855:  Hold'em No Limit ($0.10/$0.25) - 2008/08/28 - 22:55:01 (ET)
Table 'Vesta III' 9-max Seat #3 is the button
Seat 1: quickkilllah ($37.75 in chips) 
Seat 2: Skudero ($30.65 in chips) 
Seat 3: KIDNIC ($21.50 in chips) 
Seat 4: mcdougal2 ($24.20 in chips) 
Seat 5: Gr33nfield ($31.25 in chips) 
Seat 6: LionDream ($10.25 in chips) 
Seat 7: thing93001 ($41.40 in chips) 
Seat 8: Dooley2005 ($25 in chips) 
Seat 9: Alameda22 ($21.95 in chips) 
mcdougal2: posts small blind $0.10
Gr33nfield: posts big blind $0.25
*** HOLE CARDS ***
Dealt to Alameda22 [9c Js]
LionDream: calls $0.25
thing93001: folds 
Dooley2005: folds 
Alameda22: folds 
quickkilllah: folds 
Skudero: folds 
KIDNIC: folds 
mcdougal2: calls $0.15
Gr33nfield: checks 
*** FLOP *** [5c 3h Kc]
mcdougal2: bets $0.25
Gr33nfield: raises $0.25 to $0.50
LionDream: folds 
mcdougal2: calls $0.25
*** TURN *** [5c 3h Kc] [Jd]
mcdougal2: checks 
Gr33nfield: bets $0.75
mcdougal2: calls $0.75
*** RIVER *** [5c 3h Kc Jd] [6s]
mcdougal2: checks 
Gr33nfield: bets $0.75
mcdougal2: folds 
Uncalled bet ($0.75) returned to Gr33nfield
Gr33nfield collected $3.10 from pot
*** SUMMARY ***
Total pot $3.25 | Rake $0.15 
Board [5c 3h Kc Jd 6s]
Seat 1: quickkilllah folded before Flop (didn't bet)
Seat 2: Skudero folded before Flop (didn't bet)
Seat 3: KIDNIC (button) folded before Flop (didn't bet)
Seat 4: mcdougal2 (small blind) folded on the River
Seat 5: Gr33nfield (big blind) collected ($3.10)
Seat 6: LionDream folded on the Flop
Seat 7: thing93001 folded before Flop (didn't bet)
Seat 8: Dooley2005 folded before Flop (didn't bet)
Seat 9: Alameda22 folded before Flop (didn't bet)



PokerStars Game #19978787357:  Hold'em No Limit ($0.10/$0.25) - 2008/08/28 - 22:56:31 (ET)
Table 'Vesta III' 9-max Seat #4 is the button
Seat 1: quickkilllah ($37.75 in chips) 
Seat 2: Skudero ($30.65 in chips) 
Seat 3: KIDNIC ($21.50 in chips) 
Seat 4: mcdougal2 ($22.70 in chips) 
Seat 5: Gr33nfield ($32.85 in chips) 
Seat 6: LionDream ($10 in chips) 
Seat 7: thing93001 ($41.40 in chips) 
Seat 8: Dooley2005 ($25 in chips) 
Seat 9: Alameda22 ($21.95 in chips) 
Gr33nfield: posts small blind $0.10
LionDream: posts big blind $0.25
*** HOLE CARDS ***
Dealt to Alameda22 [Ks 7h]
thing93001: folds 
Dooley2005: folds 
Alameda22: folds 
quickkilllah: calls $0.25
Skudero: folds 
KIDNIC: folds 
mcdougal2: folds 
Gr33nfield: calls $0.15
LionDream: checks 
*** FLOP *** [6c 2h Qd]
Gr33nfield: checks 
LionDream: bets $0.25
quickkilllah: folds 
Gr33nfield: folds 
Uncalled bet ($0.25) returned to LionDream
LionDream collected $0.75 from pot
*** SUMMARY ***
Total pot $0.75 | Rake $0 
Board [6c 2h Qd]
Seat 1: quickkilllah folded on the Flop
Seat 2: Skudero folded before Flop (didn't bet)
Seat 3: KIDNIC folded before Flop (didn't bet)
Seat 4: mcdougal2 (button) folded before Flop (didn't bet)
Seat 5: Gr33nfield (small blind) folded on the Flop
Seat 6: LionDream (big blind) collected ($0.75)
Seat 7: thing93001 folded before Flop (didn't bet)
Seat 8: Dooley2005 folded before Flop (didn't bet)
Seat 9: Alameda22 folded before Flop (didn't bet)



PokerStars Game #19978807540:  Hold'em No Limit ($0.10/$0.25) - 2008/08/28 - 22:57:28 (ET)
Table 'Vesta III' 9-max Seat #5 is the button
Seat 1: quickkilllah ($37.50 in chips) 
Seat 2: Skudero ($30.65 in chips) 
Seat 3: KIDNIC ($21.50 in chips) 
Seat 4: mcdougal2 ($22.70 in chips) 
Seat 5: Gr33nfield ($32.60 in chips) 
Seat 6: LionDream ($10.50 in chips) 
Seat 7: thing93001 ($41.40 in chips) 
Seat 8: Dooley2005 ($25 in chips) 
Seat 9: Alameda22 ($21.95 in chips) 
LionDream: posts small blind $0.10
thing93001: posts big blind $0.25
*** HOLE CARDS ***
Dealt to Alameda22 [8d 6c]
Dooley2005: folds 
Alameda22: folds 
quickkilllah: folds 
Skudero: folds 
KIDNIC: folds 
mcdougal2: folds 
Gr33nfield: folds 
LionDream: calls $0.15
thing93001: checks 
*** FLOP *** [Tc 7c 6h]
LionDream: bets $0.25
thing93001: folds 
Uncalled bet ($0.25) returned to LionDream
LionDream collected $0.50 from pot
*** SUMMARY ***
Total pot $0.50 | Rake $0 
Board [Tc 7c 6h]
Seat 1: quickkilllah folded before Flop (didn't bet)
Seat 2: Skudero folded before Flop (didn't bet)
Seat 3: KIDNIC folded before Flop (didn't bet)
Seat 4: mcdougal2 folded before Flop (didn't bet)
Seat 5: Gr33nfield (button) folded before Flop (didn't bet)
Seat 6: LionDream (small blind) collected ($0.50)
Seat 7: thing93001 (big blind) folded on the Flop
Seat 8: Dooley2005 folded before Flop (didn't bet)
Seat 9: Alameda22 folded before Flop (didn't bet)



PokerStars Game #19978829003:  Hold'em No Limit ($0.10/$0.25) - 2008/08/28 - 22:58:31 (ET)
Table 'Vesta III' 9-max Seat #6 is the button
Seat 1: quickkilllah ($37.50 in chips) 
Seat 2: Skudero ($30.65 in chips) 
Seat 3: KIDNIC ($21.50 in chips) 
Seat 4: mcdougal2 ($22.70 in chips) 
Seat 5: Gr33nfield ($32.60 in chips) 
Seat 6: LionDream ($10.75 in chips) 
Seat 7: thing93001 ($41.15 in chips) 
Seat 8: Dooley2005 ($25 in chips) 
Seat 9: Alameda22 ($21.95 in chips) 
thing93001: posts small blind $0.10
Dooley2005: posts big blind $0.25
*** HOLE CARDS ***
Dealt to Alameda22 [Jc Jh]
Alameda22: raises $0.50 to $0.75
quickkilllah: folds 
Skudero: folds 
KIDNIC: folds 
mcdougal2: folds 
Gr33nfield: folds 
LionDream: folds 
thing93001: folds 
Dooley2005: folds 
Uncalled bet ($0.50) returned to Alameda22
Alameda22 collected $0.60 from pot
Alameda22: doesn't show hand 
*** SUMMARY ***
Total pot $0.60 | Rake $0 
Seat 1: quickkilllah folded before Flop (didn't bet)
Seat 2: Skudero folded before Flop (didn't bet)
Seat 3: KIDNIC folded before Flop (didn't bet)
Seat 4: mcdougal2 folded before Flop (didn't bet)
Seat 5: Gr33nfield folded before Flop (didn't bet)
Seat 6: LionDream (button) folded before Flop (didn't bet)
Seat 7: thing93001 (small blind) folded before Flop
Seat 8: Dooley2005 (big blind) folded before Flop
Seat 9: Alameda22 collected ($0.60)



PokerStars Game #19978843037:  Hold'em No Limit ($0.10/$0.25) - 2008/08/28 - 22:59:11 (ET)
Table 'Vesta III' 9-max Seat #7 is the button
Seat 1: quickkilllah ($37.50 in chips) 
Seat 2: Skudero ($30.65 in chips) 
Seat 3: KIDNIC ($21.50 in chips) 
Seat 4: mcdougal2 ($22.70 in chips) 
Seat 5: Gr33nfield ($32.60 in chips) 
Seat 6: LionDream ($10.75 in chips) 
Seat 7: thing93001 ($41.05 in chips) 
Seat 8: Dooley2005 ($24.75 in chips) 
Seat 9: Alameda22 ($22.30 in chips) 
Dooley2005: posts small blind $0.10
Alameda22: posts big blind $0.25
*** HOLE CARDS ***
Dealt to Alameda22 [9d 8s]
quickkilllah: folds 
Skudero: calls $0.25
KIDNIC: folds 
mcdougal2: folds 
Gr33nfield: raises $0.75 to $1
LionDream: folds 
thing93001: folds 
Dooley2005: calls $0.90
Alameda22: folds 
Skudero: calls $0.75
*** FLOP *** [Qd 8d 8c]
Dooley2005: checks 
Skudero: checks 
Gr33nfield: bets $0.25
Dooley2005: folds 
Skudero: calls $0.25
*** TURN *** [Qd 8d 8c] [7s]
Skudero: checks 
Gr33nfield: bets $2.25
Skudero: calls $2.25
*** RIVER *** [Qd 8d 8c 7s] [5c]
Skudero: checks 
Gr33nfield: bets $2
Skudero: raises $3 to $5
Gr33nfield: folds 
Uncalled bet ($3) returned to Skudero
Skudero collected $11.70 from pot
Skudero: doesn't show hand 
*** SUMMARY ***
Total pot $12.25 | Rake $0.55 
Board [Qd 8d 8c 7s 5c]
Seat 1: quickkilllah folded before Flop (didn't bet)
Seat 2: Skudero collected ($11.70)
Seat 3: KIDNIC folded before Flop (didn't bet)
Seat 4: mcdougal2 folded before Flop (didn't bet)
Seat 5: Gr33nfield folded on the River
Seat 6: LionDream folded before Flop (didn't bet)
Seat 7: thing93001 (button) folded before Flop (didn't bet)
Seat 8: Dooley2005 (small blind) folded on the Flop
Seat 9: Alameda22 (big blind) folded before Flop



PokerStars Game #19978881963:  Hold'em No Limit ($0.10/$0.25) - 2008/08/28 - 23:01:05 (ET)
Table 'Vesta III' 9-max Seat #8 is the button
Seat 2: Skudero ($36.85 in chips) 
Seat 3: KIDNIC ($21.50 in chips) 
Seat 4: mcdougal2 ($22.70 in chips) 
Seat 5: Gr33nfield ($27.10 in chips) 
Seat 6: LionDream ($10.75 in chips) 
Seat 7: thing93001 ($41.05 in chips) 
Seat 8: Dooley2005 ($23.75 in chips) 
Seat 9: Alameda22 ($22.05 in chips) 
Alameda22: posts small blind $0.10
quickkilllah: is sitting out 
Skudero: posts big blind $0.25
*** HOLE CARDS ***
Dealt to Alameda22 [9d Kc]
quickkilllah leaves the table
KIDNIC: folds 
mcdougal2: folds 
Gr33nfield: folds 
LionDream: folds 
thing93001: raises $0.50 to $0.75
Dooley2005: folds 
Alameda22: folds 
Skudero: folds 
Uncalled bet ($0.50) returned to thing93001
thing93001 collected $0.60 from pot
thing93001: doesn't show hand 
*** SUMMARY ***
Total pot $0.60 | Rake $0 
Seat 2: Skudero (big blind) folded before Flop
Seat 3: KIDNIC folded before Flop (didn't bet)
Seat 4: mcdougal2 folded before Flop (didn't bet)
Seat 5: Gr33nfield folded before Flop (didn't bet)
Seat 6: LionDream folded before Flop (didn't bet)
Seat 7: thing93001 collected ($0.60)
Seat 8: Dooley2005 (button) folded before Flop (didn't bet)
Seat 9: Alameda22 (small blind) folded before Flop



PokerStars Game #19978897283:  Hold'em No Limit ($0.10/$0.25) - 2008/08/28 - 23:01:49 (ET)
Table 'Vesta III' 9-max Seat #9 is the button
Seat 2: Skudero ($36.60 in chips) 
Seat 3: KIDNIC ($21.50 in chips) 
Seat 4: mcdougal2 ($22.70 in chips) 
Seat 5: Gr33nfield ($27.10 in chips) 
Seat 6: LionDream ($10.75 in chips) 
Seat 7: thing93001 ($41.40 in chips) 
Seat 8: Dooley2005 ($23.75 in chips) 
Seat 9: Alameda22 ($21.95 in chips) 
Skudero: posts small blind $0.10
KIDNIC: posts big blind $0.25
*** HOLE CARDS ***
Dealt to Alameda22 [6c 5s]
mcdougal2: folds 
Gr33nfield: folds 
LionDream: raises $0.25 to $0.50
thing93001: calls $0.50
Dooley2005: folds 
Alameda22: folds 
Skudero: calls $0.40
KIDNIC: folds 
*** FLOP *** [7h 7c 3h]
Skudero: bets $1
LionDream: folds 
thing93001: raises $2 to $3
Skudero: calls $2
*** TURN *** [7h 7c 3h] [8s]
Skudero: checks 
thing93001: bets $7.50
Skudero: folds 
Uncalled bet ($7.50) returned to thing93001
thing93001 collected $7.40 from pot
thing93001: doesn't show hand 
*** SUMMARY ***
Total pot $7.75 | Rake $0.35 
Board [7h 7c 3h 8s]
Seat 2: Skudero (small blind) folded on the Turn
Seat 3: KIDNIC (big blind) folded before Flop
Seat 4: mcdougal2 folded before Flop (didn't bet)
Seat 5: Gr33nfield folded before Flop (didn't bet)
Seat 6: LionDream folded on the Flop
Seat 7: thing93001 collected ($7.40)
Seat 8: Dooley2005 folded before Flop (didn't bet)
Seat 9: Alameda22 (button) folded before Flop (didn't bet)



PokerStars Game #19978939261:  Hold'em No Limit ($0.10/$0.25) - 2008/08/28 - 23:03:52 (ET)
Table 'Vesta III' 9-max Seat #2 is the button
Seat 2: Skudero ($33.10 in chips) 
Seat 3: KIDNIC ($21.25 in chips) 
Seat 4: mcdougal2 ($22.70 in chips) 
Seat 5: Gr33nfield ($27.10 in chips) 
Seat 6: LionDream ($10.25 in chips) 
Seat 7: thing93001 ($45.30 in chips) 
Seat 8: Dooley2005 ($23.75 in chips) 
Seat 9: Alameda22 ($21.95 in chips) 
KIDNIC: posts small blind $0.10
mcdougal2: posts big blind $0.25
*** HOLE CARDS ***
Dealt to Alameda22 [7h 6h]
Gr33nfield: folds 
LionDream: raises $0.25 to $0.50
thing93001: folds 
thing93001 is sitting out
Dooley2005: folds 
Alameda22: folds 
Skudero: folds 
KIDNIC: calls $0.40
mcdougal2: calls $0.25
*** FLOP *** [6c 2s 5s]
KIDNIC: bets $0.50
mcdougal2: folds 
LionDream: calls $0.50
*** TURN *** [6c 2s 5s] [4c]
KIDNIC: bets $0.50
LionDream: calls $0.50
*** RIVER *** [6c 2s 5s 4c] [Qc]
KIDNIC: checks 
LionDream: bets $1
KIDNIC: folds 
Uncalled bet ($1) returned to LionDream
LionDream collected $3.35 from pot
*** SUMMARY ***
Total pot $3.50 | Rake $0.15 
Board [6c 2s 5s 4c Qc]
Seat 2: Skudero (button) folded before Flop (didn't bet)
Seat 3: KIDNIC (small blind) folded on the River
Seat 4: mcdougal2 (big blind) folded on the Flop
Seat 5: Gr33nfield folded before Flop (didn't bet)
Seat 6: LionDream collected ($3.35)
Seat 7: thing93001 folded before Flop (didn't bet)
Seat 8: Dooley2005 folded before Flop (didn't bet)
Seat 9: Alameda22 folded before Flop (didn't bet)



PokerStars Game #19978972621:  Hold'em No Limit ($0.10/$0.25) - 2008/08/28 - 23:05:31 (ET)
Table 'Vesta III' 9-max Seat #3 is the button
Seat 2: Skudero ($33.10 in chips) 
Seat 3: KIDNIC ($19.75 in chips) 
Seat 4: mcdougal2 ($22.20 in chips) 
Seat 5: Gr33nfield ($27.10 in chips) 
Seat 6: LionDream ($12.10 in chips) 
Seat 8: Dooley2005 ($23.75 in chips) 
Seat 9: Alameda22 ($21.95 in chips) 
mcdougal2: posts small blind $0.10
Gr33nfield: posts big blind $0.25
*** HOLE CARDS ***
Dealt to Alameda22 [2d 5h]
thing93001 leaves the table
LionDream: folds 
Dooley2005: folds 
Alameda22: folds 
Skudero: folds 
KIDNIC: folds 
mcdougal2: calls $0.15
Gr33nfield: raises $0.75 to $1
mcdougal2: folds 
Uncalled bet ($0.75) returned to Gr33nfield
Gr33nfield collected $0.50 from pot
*** SUMMARY ***
Total pot $0.50 | Rake $0 
Seat 2: Skudero folded before Flop (didn't bet)
Seat 3: KIDNIC (button) folded before Flop (didn't bet)
Seat 4: mcdougal2 (small blind) folded before Flop
Seat 5: Gr33nfield (big blind) collected ($0.50)
Seat 6: LionDream folded before Flop (didn't bet)
Seat 8: Dooley2005 folded before Flop (didn't bet)
Seat 9: Alameda22 folded before Flop (didn't bet)



PokerStars Game #19978984629:  Hold'em No Limit ($0.10/$0.25) - 2008/08/28 - 23:06:06 (ET)
Table 'Vesta III' 9-max Seat #4 is the button
Seat 2: Skudero ($33.10 in chips) 
Seat 3: KIDNIC ($19.75 in chips) 
Seat 4: mcdougal2 ($21.95 in chips) 
Seat 5: Gr33nfield ($27.35 in chips) 
Seat 6: LionDream ($12.10 in chips) 
Seat 8: Dooley2005 ($24.45 in chips) 
Seat 9: Alameda22 ($21.95 in chips) 
Gr33nfield: posts small blind $0.10
LionDream: posts big blind $0.25
*** HOLE CARDS ***
Dealt to Alameda22 [Kh 4h]
Dooley2005: folds 
Alameda22: folds 
Skudero: folds 
KIDNIC: folds 
mcdougal2: folds 
Gr33nfield: calls $0.15
LionDream: checks 
*** FLOP *** [3h 8c Qh]
Gr33nfield: bets $0.25
LionDream: folds 
Uncalled bet ($0.25) returned to Gr33nfield
Gr33nfield collected $0.50 from pot
*** SUMMARY ***
Total pot $0.50 | Rake $0 
Board [3h 8c Qh]
Seat 2: Skudero folded before Flop (didn't bet)
Seat 3: KIDNIC folded before Flop (didn't bet)
Seat 4: mcdougal2 (button) folded before Flop (didn't bet)
Seat 5: Gr33nfield (small blind) collected ($0.50)
Seat 6: LionDream (big blind) folded on the Flop
Seat 8: Dooley2005 folded before Flop (didn't bet)
Seat 9: Alameda22 folded before Flop (didn't bet)



PokerStars Game #19978998086:  Hold'em No Limit ($0.10/$0.25) - 2008/08/28 - 23:06:46 (ET)
Table 'Vesta III' 9-max Seat #5 is the button
Seat 2: Skudero ($33.10 in chips) 
Seat 3: KIDNIC ($19.75 in chips) 
Seat 4: mcdougal2 ($21.95 in chips) 
Seat 5: Gr33nfield ($27.60 in chips) 
Seat 6: LionDream ($11.85 in chips) 
Seat 8: Dooley2005 ($24.45 in chips) 
Seat 9: Alameda22 ($21.95 in chips) 
LionDream: posts small blind $0.10
Dooley2005: posts big blind $0.25
*** HOLE CARDS ***
Dealt to Alameda22 [5d Ah]
Alameda22: folds 
Skudero: folds 
KIDNIC: raises $0.50 to $0.75
mcdougal2: folds 
Gr33nfield: folds 
LionDream: folds 
Dooley2005: folds 
Uncalled bet ($0.50) returned to KIDNIC
KIDNIC collected $0.60 from pot
KIDNIC: doesn't show hand 
*** SUMMARY ***
Total pot $0.60 | Rake $0 
Seat 2: Skudero folded before Flop (didn't bet)
Seat 3: KIDNIC collected ($0.60)
Seat 4: mcdougal2 folded before Flop (didn't bet)
Seat 5: Gr33nfield (button) folded before Flop (didn't bet)
Seat 6: LionDream (small blind) folded before Flop
Seat 8: Dooley2005 (big blind) folded before Flop
Seat 9: Alameda22 folded before Flop (didn't bet)



PokerStars Game #19979014225:  Hold'em No Limit ($0.10/$0.25) - 2008/08/28 - 23:07:34 (ET)
Table 'Vesta III' 9-max Seat #6 is the button
Seat 2: Skudero ($33.10 in chips) 
Seat 3: KIDNIC ($20.10 in chips) 
Seat 4: mcdougal2 ($21.95 in chips) 
Seat 5: Gr33nfield ($27.60 in chips) 
Seat 6: LionDream ($11.75 in chips) 
Seat 8: Dooley2005 ($24.20 in chips) 
Seat 9: Alameda22 ($21.95 in chips) 
Dooley2005: posts small blind $0.10
Alameda22: posts big blind $0.25
*** HOLE CARDS ***
Dealt to Alameda22 [Th 3c]
Skudero: folds 
KIDNIC: folds 
mcdougal2: calls $0.25
Gr33nfield: folds 
LionDream: raises $0.25 to $0.50
Dooley2005: folds 
Alameda22: folds 
mcdougal2: calls $0.25
*** FLOP *** [Jd 8s 8c]
mcdougal2: checks 
LionDream: bets $0.75
mcdougal2: calls $0.75
*** TURN *** [Jd 8s 8c] [2d]
mcdougal2: checks 
LionDream: bets $2
mcdougal2: calls $2
*** RIVER *** [Jd 8s 8c 2d] [4d]
mcdougal2: checks 
LionDream: bets $3.50
mcdougal2: folds 
Uncalled bet ($3.50) returned to LionDream
LionDream collected $6.55 from pot
LionDream: shows [Ah 8h] (three of a kind, Eights)
*** SUMMARY ***
Total pot $6.85 | Rake $0.30 
Board [Jd 8s 8c 2d 4d]
Seat 2: Skudero folded before Flop (didn't bet)
Seat 3: KIDNIC folded before Flop (didn't bet)
Seat 4: mcdougal2 folded on the River
Seat 5: Gr33nfield folded before Flop (didn't bet)
Seat 6: LionDream (button) collected ($6.55)
Seat 8: Dooley2005 (small blind) folded before Flop
Seat 9: Alameda22 (big blind) folded before Flop



PokerStars Game #19979042758:  Hold'em No Limit ($0.10/$0.25) - 2008/08/28 - 23:08:58 (ET)
Table 'Vesta III' 9-max Seat #8 is the button
Seat 2: Skudero ($33.10 in chips) 
Seat 3: KIDNIC ($20.10 in chips) 
Seat 4: mcdougal2 ($25 in chips) 
Seat 5: Gr33nfield ($27.60 in chips) 
Seat 6: LionDream ($15.05 in chips) 
Seat 8: Dooley2005 ($24.10 in chips) 
Seat 9: Alameda22 ($21.70 in chips) 
Alameda22: posts small blind $0.10
Skudero: posts big blind $0.25
*** HOLE CARDS ***
Dealt to Alameda22 [6s Kc]
KIDNIC: folds 
mcdougal2: folds 
Gr33nfield: calls $0.25
LionDream: calls $0.25
Dooley2005: folds 
Alameda22: folds 
Skudero: checks 
*** FLOP *** [Kh 3c Ad]
Skudero: checks 
Gr33nfield: checks 
LionDream: checks 
*** TURN *** [Kh 3c Ad] [9s]
Skudero: checks 
Gr33nfield: checks 
LionDream: checks 
*** RIVER *** [Kh 3c Ad 9s] [3h]
Skudero: checks 
Gr33nfield: checks 
LionDream: bets $1.75
Skudero: folds 
Gr33nfield: folds 
Uncalled bet ($1.75) returned to LionDream
LionDream collected $0.85 from pot
LionDream: shows [Qs 3s] (three of a kind, Threes)
*** SUMMARY ***
Total pot $0.85 | Rake $0 
Board [Kh 3c Ad 9s 3h]
Seat 2: Skudero (big blind) folded on the River
Seat 3: KIDNIC folded before Flop (didn't bet)
Seat 4: mcdougal2 folded before Flop (didn't bet)
Seat 5: Gr33nfield folded on the River
Seat 6: LionDream collected ($0.85)
Seat 8: Dooley2005 (button) folded before Flop (didn't bet)
Seat 9: Alameda22 (small blind) folded before Flop



PokerStars Game #19979071747:  Hold'em No Limit ($0.10/$0.25) - 2008/08/28 - 23:10:25 (ET)
Table 'Vesta III' 9-max Seat #9 is the button
Seat 2: Skudero ($32.85 in chips) 
Seat 3: KIDNIC ($20.10 in chips) 
Seat 4: mcdougal2 ($25 in chips) 
Seat 5: Gr33nfield ($27.35 in chips) 
Seat 6: LionDream ($15.65 in chips) 
Seat 8: Dooley2005 ($24.10 in chips) 
Seat 9: Alameda22 ($21.60 in chips) 
Skudero: posts small blind $0.10
KIDNIC: posts big blind $0.25
*** HOLE CARDS ***
Dealt to Alameda22 [4s 8d]
mcdougal2: folds 
Gr33nfield: calls $0.25
LionDream: raises $0.25 to $0.50
Dooley2005: folds 
Alameda22: folds 
Skudero: folds 
KIDNIC: folds 
Gr33nfield: calls $0.25
*** FLOP *** [4d Ad 2s]
Gr33nfield: checks 
LionDream: bets $1
Gr33nfield: folds 
Uncalled bet ($1) returned to LionDream
LionDream collected $1.30 from pot
LionDream: shows [Jc Ah] (a pair of Aces)
*** SUMMARY ***
Total pot $1.35 | Rake $0.05 
Board [4d Ad 2s]
Seat 2: Skudero (small blind) folded before Flop
Seat 3: KIDNIC (big blind) folded before Flop
Seat 4: mcdougal2 folded before Flop (didn't bet)
Seat 5: Gr33nfield folded on the Flop
Seat 6: LionDream collected ($1.30)
Seat 8: Dooley2005 folded before Flop (didn't bet)
Seat 9: Alameda22 (button) folded before Flop (didn't bet)



PokerStars Game #19979088886:  Hold'em No Limit ($0.10/$0.25) - 2008/08/28 - 23:11:16 (ET)
Table 'Vesta III' 9-max Seat #2 is the button
Seat 2: Skudero ($32.75 in chips) 
Seat 3: KIDNIC ($19.85 in chips) 
Seat 4: mcdougal2 ($25 in chips) 
Seat 5: Gr33nfield ($26.85 in chips) 
Seat 6: LionDream ($16.45 in chips) 
Seat 8: Dooley2005 ($24.10 in chips) 
Seat 9: Alameda22 ($21.60 in chips) 
KIDNIC: posts small blind $0.10
mcdougal2: posts big blind $0.25
*** HOLE CARDS ***
Dealt to Alameda22 [Jd 5c]
Gr33nfield: folds 
LionDream: calls $0.25
Dooley2005: folds 
Alameda22: folds 
Skudero: calls $0.25
KIDNIC: calls $0.15
mcdougal2: checks 
*** FLOP *** [8h 2s Qd]
KIDNIC: checks 
mcdougal2: checks 
LionDream: checks 
Skudero: bets $0.75
KIDNIC: folds 
mcdougal2: folds 
LionDream: folds 
Uncalled bet ($0.75) returned to Skudero
Skudero collected $0.95 from pot
Skudero: doesn't show hand 
jew1jaw joins the table at seat #1 
*** SUMMARY ***
Total pot $1 | Rake $0.05 
Board [8h 2s Qd]
Seat 2: Skudero (button) collected ($0.95)
Seat 3: KIDNIC (small blind) folded on the Flop
Seat 4: mcdougal2 (big blind) folded on the Flop
Seat 5: Gr33nfield folded before Flop (didn't bet)
Seat 6: LionDream folded on the Flop
Seat 8: Dooley2005 folded before Flop (didn't bet)
Seat 9: Alameda22 folded before Flop (didn't bet)



PokerStars Game #19979114488:  Hold'em No Limit ($0.10/$0.25) - 2008/08/28 - 23:12:33 (ET)
Table 'Vesta III' 9-max Seat #3 is the button
Seat 1: jew1jaw ($10 in chips) 
Seat 2: Skudero ($33.45 in chips) 
Seat 3: KIDNIC ($19.60 in chips) 
Seat 4: mcdougal2 ($24.75 in chips) 
Seat 5: Gr33nfield ($26.85 in chips) 
Seat 6: LionDream ($16.20 in chips) 
Seat 8: Dooley2005 ($24.10 in chips) 
Seat 9: Alameda22 ($21.60 in chips) 
mcdougal2: posts small blind $0.10
Gr33nfield: posts big blind $0.25
jew1jaw: posts big blind $0.25
*** HOLE CARDS ***
Dealt to Alameda22 [Jh Th]
LionDream: calls $0.25
Dooley2005: folds 
Alameda22: calls $0.25
SpielerABC joins the table at seat #7 
jew1jaw: raises $0.25 to $0.50
Skudero: folds 
KIDNIC: folds 
mcdougal2: calls $0.40
Gr33nfield: folds 
LionDream: calls $0.25
Alameda22: calls $0.25
*** FLOP *** [4h 2h 8d]
mcdougal2: checks 
LionDream: checks 
Alameda22: bets $1.50
jew1jaw: calls $1.50
mcdougal2: folds 
LionDream: folds 
*** TURN *** [4h 2h 8d] [7h]
Alameda22: bets $3.25
jew1jaw: calls $3.25
*** RIVER *** [4h 2h 8d 7h] [9h]
Alameda22: bets $5
jew1jaw: folds 
Uncalled bet ($5) returned to Alameda22
Alameda22 collected $11.20 from pot
Alameda22: doesn't show hand 
*** SUMMARY ***
Total pot $11.75 | Rake $0.55 
Board [4h 2h 8d 7h 9h]
Seat 1: jew1jaw folded on the River
Seat 2: Skudero folded before Flop (didn't bet)
Seat 3: KIDNIC (button) folded before Flop (didn't bet)
Seat 4: mcdougal2 (small blind) folded on the Flop
Seat 5: Gr33nfield (big blind) folded before Flop
Seat 6: LionDream folded on the Flop
Seat 8: Dooley2005 folded before Flop (didn't bet)
Seat 9: Alameda22 collected ($11.20)



PokerStars Game #19979151581:  Hold'em No Limit ($0.10/$0.25) - 2008/08/28 - 23:14:25 (ET)
Table 'Vesta III' 9-max Seat #4 is the button
Seat 1: jew1jaw ($4.75 in chips) 
Seat 2: Skudero ($33.45 in chips) 
Seat 3: KIDNIC ($19.60 in chips) 
Seat 4: mcdougal2 ($24.25 in chips) 
Seat 5: Gr33nfield ($26.60 in chips) 
Seat 6: LionDream ($15.70 in chips) 
Seat 8: Dooley2005 ($24.10 in chips) 
Seat 9: Alameda22 ($27.55 in chips) 
Gr33nfield: posts small blind $0.10
LionDream: posts big blind $0.25
SpielerABC: sits out 
*** HOLE CARDS ***
Dealt to Alameda22 [As 6d]
Dooley2005: folds 
Alameda22: folds 
jew1jaw: folds 
Skudero: raises $1 to $1.25
KIDNIC: folds 
mcdougal2: folds 
Gr33nfield: calls $1.15
LionDream: folds 
*** FLOP *** [5c 2d Kd]
Gr33nfield: checks 
Skudero: bets $1.75
Gr33nfield: raises $3.25 to $5
Skudero: folds 
Uncalled bet ($3.25) returned to Gr33nfield
Gr33nfield collected $5.95 from pot
Gr33nfield: doesn't show hand 
*** SUMMARY ***
Total pot $6.25 | Rake $0.30 
Board [5c 2d Kd]
Seat 1: jew1jaw folded before Flop (didn't bet)
Seat 2: Skudero folded on the Flop
Seat 3: KIDNIC folded before Flop (didn't bet)
Seat 4: mcdougal2 (button) folded before Flop (didn't bet)
Seat 5: Gr33nfield (small blind) collected ($5.95)
Seat 6: LionDream (big blind) folded before Flop
Seat 8: Dooley2005 folded before Flop (didn't bet)
Seat 9: Alameda22 folded before Flop (didn't bet)



PokerStars Game #19979179558:  Hold'em No Limit ($0.10/$0.25) - 2008/08/28 - 23:15:50 (ET)
Table 'Vesta III' 9-max Seat #5 is the button
Seat 1: jew1jaw ($4.75 in chips) 
Seat 2: Skudero ($30.45 in chips) 
Seat 3: KIDNIC ($19.60 in chips) 
Seat 4: mcdougal2 ($24.25 in chips) 
Seat 5: Gr33nfield ($29.55 in chips) 
Seat 6: LionDream ($15.45 in chips) 
Seat 7: SpielerABC ($25 in chips) 
Seat 8: Dooley2005 ($24.10 in chips) 
Seat 9: Alameda22 ($27.55 in chips) 
LionDream: posts small blind $0.10
SpielerABC: posts big blind $0.25
*** HOLE CARDS ***
Dealt to Alameda22 [4s Ks]
Dooley2005: folds 
Alameda22: folds 
jew1jaw: folds 
Skudero: folds 
KIDNIC: folds 
mcdougal2: folds 
Gr33nfield: folds 
LionDream: calls $0.15
SpielerABC: checks 
*** FLOP *** [7h 5d 9d]
LionDream: bets $0.25
SpielerABC: folds 
Uncalled bet ($0.25) returned to LionDream
LionDream collected $0.50 from pot
*** SUMMARY ***
Total pot $0.50 | Rake $0 
Board [7h 5d 9d]
Seat 1: jew1jaw folded before Flop (didn't bet)
Seat 2: Skudero folded before Flop (didn't bet)
Seat 3: KIDNIC folded before Flop (didn't bet)
Seat 4: mcdougal2 folded before Flop (didn't bet)
Seat 5: Gr33nfield (button) folded before Flop (didn't bet)
Seat 6: LionDream (small blind) collected ($0.50)
Seat 7: SpielerABC (big blind) folded on the Flop
Seat 8: Dooley2005 folded before Flop (didn't bet)
Seat 9: Alameda22 folded before Flop (didn't bet)



PokerStars Game #19979209909:  Hold'em No Limit ($0.10/$0.25) - 2008/08/28 - 23:17:21 (ET)
Table 'Vesta III' 9-max Seat #6 is the button
Seat 1: jew1jaw ($4.75 in chips) 
Seat 2: Skudero ($30.45 in chips) 
Seat 3: KIDNIC ($19.60 in chips) 
Seat 4: mcdougal2 ($24.25 in chips) 
Seat 5: Gr33nfield ($29.55 in chips) 
Seat 6: LionDream ($15.70 in chips) 
Seat 7: SpielerABC ($24.75 in chips) 
Seat 8: Dooley2005 ($24.10 in chips) 
Seat 9: Alameda22 ($27.55 in chips) 
SpielerABC: posts small blind $0.10
Dooley2005: posts big blind $0.25
*** HOLE CARDS ***
Dealt to Alameda22 [Kh 2d]
Alameda22: folds 
jew1jaw: calls $0.25
Skudero: raises $1 to $1.25
KIDNIC: folds 
mcdougal2: folds 
Gr33nfield: folds 
LionDream: folds 
LionDream leaves the table
SpielerABC: folds 
Dooley2005: folds 
jew1jaw: calls $1
*** FLOP *** [9h Qd 8c]
jew1jaw: checks 
Skudero: bets $4
jew1jaw: calls $3.50 and is all-in
Uncalled bet ($0.50) returned to Skudero
*** TURN *** [9h Qd 8c] [7c]
*** RIVER *** [9h Qd 8c 7c] [3d]
*** SHOW DOWN ***
jew1jaw: shows [Js Ks] (high card King)
Skudero: shows [Kc Kd] (a pair of Kings)
Skudero collected $9.40 from pot
*** SUMMARY ***
Total pot $9.85 | Rake $0.45 
Board [9h Qd 8c 7c 3d]
Seat 1: jew1jaw showed [Js Ks] and lost with high card King
Seat 2: Skudero showed [Kc Kd] and won ($9.40) with a pair of Kings
Seat 3: KIDNIC folded before Flop (didn't bet)
Seat 4: mcdougal2 folded before Flop (didn't bet)
Seat 5: Gr33nfield folded before Flop (didn't bet)
Seat 6: LionDream (button) folded before Flop (didn't bet)
Seat 7: SpielerABC (small blind) folded before Flop
Seat 8: Dooley2005 (big blind) folded before Flop
Seat 9: Alameda22 folded before Flop (didn't bet)



PokerStars Game #19979242152:  Hold'em No Limit ($0.10/$0.25) - 2008/08/28 - 23:19:00 (ET)
Table 'Vesta III' 9-max Seat #7 is the button
Seat 2: Skudero ($35.10 in chips) 
Seat 3: KIDNIC ($19.60 in chips) 
Seat 4: mcdougal2 ($24.25 in chips) 
Seat 5: Gr33nfield ($29.55 in chips) 
Seat 7: SpielerABC ($24.65 in chips) 
Seat 8: Dooley2005 ($23.85 in chips) 
Seat 9: Alameda22 ($27.55 in chips) 
Dooley2005: posts small blind $0.10
Alameda22: posts big blind $0.25
*** HOLE CARDS ***
Dealt to Alameda22 [Jh 4s]
Skudero: raises $0.75 to $1
KIDNIC: folds 
mcdougal2: folds 
jew1jaw has returned
Gr33nfield: folds 
SpielerABC: calls $1
Dooley2005: folds 
Alameda22: folds 
*** FLOP *** [3s 4d 2h]
Skudero: bets $1.25
SpielerABC: calls $1.25
*** TURN *** [3s 4d 2h] [4c]
Skudero: bets $2.25
SpielerABC: calls $2.25
*** RIVER *** [3s 4d 2h 4c] [Qd]
Tuwei168 joins the table at seat #6 
Skudero: bets $4
SpielerABC: folds 
Uncalled bet ($4) returned to Skudero
Skudero collected $8.90 from pot
Skudero: doesn't show hand 
*** SUMMARY ***
Total pot $9.35 | Rake $0.45 
Board [3s 4d 2h 4c Qd]
Seat 2: Skudero collected ($8.90)
Seat 3: KIDNIC folded before Flop (didn't bet)
Seat 4: mcdougal2 folded before Flop (didn't bet)
Seat 5: Gr33nfield folded before Flop (didn't bet)
Seat 7: SpielerABC (button) folded on the River
Seat 8: Dooley2005 (small blind) folded before Flop
Seat 9: Alameda22 (big blind) folded before Flop



PokerStars Game #19979280864:  Hold'em No Limit ($0.10/$0.25) - 2008/08/28 - 23:21:00 (ET)
Table 'Vesta III' 9-max Seat #8 is the button
Seat 1: jew1jaw ($5 in chips) 
Seat 2: Skudero ($39.50 in chips) 
Seat 3: KIDNIC ($19.60 in chips) 
Seat 4: mcdougal2 ($24.25 in chips) 
Seat 5: Gr33nfield ($29.55 in chips) 
Seat 7: SpielerABC ($25 in chips) 
Seat 8: Dooley2005 ($23.75 in chips) 
Seat 9: Alameda22 ($27.30 in chips) 
Alameda22: posts small blind $0.10
jew1jaw: posts big blind $0.25
Tuwei168: sits out 
*** HOLE CARDS ***
Dealt to Alameda22 [Kh Tc]
Skudero: folds 
KIDNIC: folds 
mcdougal2: folds 
Gr33nfield: folds 
SpielerABC: raises $0.50 to $0.75
Dooley2005: folds 
Alameda22: folds 
jew1jaw: folds 
Uncalled bet ($0.50) returned to SpielerABC
SpielerABC collected $0.60 from pot
SpielerABC: doesn't show hand 
*** SUMMARY ***
Total pot $0.60 | Rake $0 
Seat 1: jew1jaw (big blind) folded before Flop
Seat 2: Skudero folded before Flop (didn't bet)
Seat 3: KIDNIC folded before Flop (didn't bet)
Seat 4: mcdougal2 folded before Flop (didn't bet)
Seat 5: Gr33nfield folded before Flop (didn't bet)
Seat 7: SpielerABC collected ($0.60)
Seat 8: Dooley2005 (button) folded before Flop (didn't bet)
Seat 9: Alameda22 (small blind) folded before Flop



PokerStars Game #19979299637:  Hold'em No Limit ($0.10/$0.25) - 2008/08/28 - 23:21:58 (ET)
Table 'Vesta III' 9-max Seat #9 is the button
Seat 1: jew1jaw ($4.75 in chips) 
Seat 2: Skudero ($39.50 in chips) 
Seat 3: KIDNIC ($19.60 in chips) 
Seat 4: mcdougal2 ($24.25 in chips) 
Seat 5: Gr33nfield ($29.55 in chips) 
Seat 7: SpielerABC ($25.35 in chips) 
Seat 8: Dooley2005 ($23.75 in chips) 
Seat 9: Alameda22 ($27.20 in chips) 
jew1jaw: posts small blind $0.10
Skudero: posts big blind $0.25
Tuwei168: sits out 
*** HOLE CARDS ***
Dealt to Alameda22 [Qh 8s]
KIDNIC: calls $0.25
mcdougal2: folds 
mcdougal2 leaves the table
Gr33nfield: folds 
SpielerABC: folds 
Dooley2005: folds 
buzgt2008 joins the table at seat #4 
Alameda22: folds 
jew1jaw: calls $0.15
Skudero: checks 
*** FLOP *** [Tc Ks 2s]
jew1jaw: checks 
Skudero: checks 
KIDNIC: bets $0.75
jew1jaw: folds 
Skudero: folds 
Uncalled bet ($0.75) returned to KIDNIC
KIDNIC collected $0.75 from pot
*** SUMMARY ***
Total pot $0.75 | Rake $0 
Board [Tc Ks 2s]
Seat 1: jew1jaw (small blind) folded on the Flop
Seat 2: Skudero (big blind) folded on the Flop
Seat 3: KIDNIC collected ($0.75)
Seat 4: mcdougal2 folded before Flop (didn't bet)
Seat 5: Gr33nfield folded before Flop (didn't bet)
Seat 7: SpielerABC folded before Flop (didn't bet)
Seat 8: Dooley2005 folded before Flop (didn't bet)
Seat 9: Alameda22 (button) folded before Flop (didn't bet)



PokerStars Game #19979323568:  Hold'em No Limit ($0.10/$0.25) - 2008/08/28 - 23:23:13 (ET)
Table 'Vesta III' 9-max Seat #1 is the button
Seat 1: jew1jaw ($4.50 in chips) 
Seat 2: Skudero ($39.25 in chips) 
Seat 3: KIDNIC ($20.10 in chips) 
Seat 5: Gr33nfield ($29.55 in chips) 
Seat 7: SpielerABC ($25.35 in chips) 
Seat 8: Dooley2005 ($23.75 in chips) 
Seat 9: Alameda22 ($27.20 in chips) 
Skudero: posts small blind $0.10
KIDNIC: posts big blind $0.25
buzgt2008: sits out 
Tuwei168: sits out 
*** HOLE CARDS ***
Dealt to Alameda22 [2s Jc]
Gr33nfield: raises $0.50 to $0.75
SpielerABC: folds 
Dooley2005: folds 
Alameda22: folds 
jew1jaw: folds 
Skudero: folds 
KIDNIC: folds 
Uncalled bet ($0.50) returned to Gr33nfield
Gr33nfield collected $0.60 from pot
Gr33nfield: doesn't show hand 
*** SUMMARY ***
Total pot $0.60 | Rake $0 
Seat 1: jew1jaw (button) folded before Flop (didn't bet)
Seat 2: Skudero (small blind) folded before Flop
Seat 3: KIDNIC (big blind) folded before Flop
Seat 5: Gr33nfield collected ($0.60)
Seat 7: SpielerABC folded before Flop (didn't bet)
Seat 8: Dooley2005 folded before Flop (didn't bet)
Seat 9: Alameda22 folded before Flop (didn't bet)



PokerStars Game #19979341407:  Hold'em No Limit ($0.10/$0.25) - 2008/08/28 - 23:24:09 (ET)
Table 'Vesta III' 9-max Seat #2 is the button
Seat 1: jew1jaw ($4.50 in chips) 
Seat 2: Skudero ($39.15 in chips) 
Seat 3: KIDNIC ($19.85 in chips) 
Seat 4: buzgt2008 ($15 in chips) 
Seat 5: Gr33nfield ($29.90 in chips) 
Seat 7: SpielerABC ($25.35 in chips) 
Seat 8: Dooley2005 ($23.75 in chips) 
Seat 9: Alameda22 ($27.20 in chips) 
KIDNIC: posts small blind $0.10
buzgt2008: posts big blind $0.25
Tuwei168: sits out 
*** HOLE CARDS ***
Dealt to Alameda22 [Kc Js]
Gr33nfield: raises $0.75 to $1
SpielerABC: folds 
SpielerABC leaves the table
Dooley2005: folds 
Alameda22: folds 
jew1jaw: calls $1
Skudero: folds 
KIDNIC: folds 
buzgt2008: calls $0.75
*** FLOP *** [As 5s 4s]
buzgt2008: bets $1.25
Gr33nfield: raises $2.75 to $4
jew1jaw: calls $3.50 and is all-in
buzgt2008: folds 
Uncalled bet ($0.50) returned to Gr33nfield
*** TURN *** [As 5s 4s] [4h]
*** RIVER *** [As 5s 4s 4h] [9s]
*** SHOW DOWN ***
Gr33nfield: shows [Ad Kd] (two pair, Aces and Fours)
jew1jaw: shows [Ks Tc] (a flush, Ace high)
jew1jaw collected $10.80 from pot
Gr33nfield said, "FUUUUUUUUUUUUUUUUUUUUUUUUUUUUUUUUUUUUUUUUUUUUUUUUUUUUUUUUUUUUUG"
*** SUMMARY ***
Total pot $11.35 | Rake $0.55 
Board [As 5s 4s 4h 9s]
Seat 1: jew1jaw showed [Ks Tc] and won ($10.80) with a flush, Ace high
Seat 2: Skudero (button) folded before Flop (didn't bet)
Seat 3: KIDNIC (small blind) folded before Flop
Seat 4: buzgt2008 (big blind) folded on the Flop
Seat 5: Gr33nfield showed [Ad Kd] and lost with two pair, Aces and Fours
Seat 7: SpielerABC folded before Flop (didn't bet)
Seat 8: Dooley2005 folded before Flop (didn't bet)
Seat 9: Alameda22 folded before Flop (didn't bet)



PokerStars Game #19979366590:  Hold'em No Limit ($0.10/$0.25) - 2008/08/28 - 23:25:27 (ET)
Table 'Vesta III' 9-max Seat #3 is the button
Seat 1: jew1jaw ($10.80 in chips) 
Seat 2: Skudero ($39.15 in chips) 
Seat 3: KIDNIC ($19.75 in chips) 
Seat 4: buzgt2008 ($12.75 in chips) 
Seat 5: Gr33nfield ($25.40 in chips) 
Seat 8: Dooley2005 ($23.75 in chips) 
Seat 9: Alameda22 ($27.20 in chips) 
buzgt2008: posts small blind $0.10
Gr33nfield: posts big blind $0.25
Gr33nfield said, "AGAIN"
Tuwei168: sits out 
*** HOLE CARDS ***
Dealt to Alameda22 [8c 4c]
Dooley2005: folds 
Alameda22: folds 
jew1jaw: folds 
Skudero: folds 
buzgt2008 said, "i had AQ suited"
KIDNIC: folds 
buzgt2008: calls $0.15
Gr33nfield: checks 
*** FLOP *** [Jc 6c 3s]
buzgt2008: checks 
Gr33nfield said, "suck out city on me last 30 min"
Gr33nfield: bets $0.25
buzgt2008: folds 
Uncalled bet ($0.25) returned to Gr33nfield
Gr33nfield collected $0.50 from pot
Gr33nfield: doesn't show hand 
*** SUMMARY ***
Total pot $0.50 | Rake $0 
Board [Jc 6c 3s]
Seat 1: jew1jaw folded before Flop (didn't bet)
Seat 2: Skudero folded before Flop (didn't bet)
Seat 3: KIDNIC (button) folded before Flop (didn't bet)
Seat 4: buzgt2008 (small blind) folded on the Flop
Seat 5: Gr33nfield (big blind) collected ($0.50)
Seat 8: Dooley2005 folded before Flop (didn't bet)
Seat 9: Alameda22 folded before Flop (didn't bet)



PokerStars Game #19979382185:  Hold'em No Limit ($0.10/$0.25) - 2008/08/28 - 23:26:16 (ET)
Table 'Vesta III' 9-max Seat #4 is the button
Seat 1: jew1jaw ($10.80 in chips) 
Seat 2: Skudero ($39.15 in chips) 
Seat 3: KIDNIC ($19.75 in chips) 
Seat 4: buzgt2008 ($12.50 in chips) 
Seat 5: Gr33nfield ($25.65 in chips) 
Seat 6: Tuwei168 ($25 in chips) 
Seat 8: Dooley2005 ($25 in chips) 
Seat 9: Alameda22 ($27.20 in chips) 
Gr33nfield: posts small blind $0.10
Tuwei168: posts big blind $0.25
*** HOLE CARDS ***
Dealt to Alameda22 [Ks 7d]
Dooley2005: folds 
Alameda22: folds 
jew1jaw: folds 
Skudero: folds 
KIDNIC: folds 
buzgt2008: folds 
Gr33nfield: raises $0.75 to $1
Tuwei168: calls $0.75
*** FLOP *** [8s 6c 2c]
Gr33nfield: bets $1
Tuwei168: calls $1
*** TURN *** [8s 6c 2c] [8h]
Gr33nfield: checks 
Tuwei168: bets $1
Gr33nfield: calls $1
*** RIVER *** [8s 6c 2c 8h] [3d]
Gr33nfield: bets $3
Tuwei168: calls $3
*** SHOW DOWN ***
Gr33nfield: shows [Tc 9c] (a pair of Eights)
Tuwei168: shows [4h 4s] (two pair, Eights and Fours)
Tuwei168 collected $11.45 from pot
*** SUMMARY ***
Total pot $12 | Rake $0.55 
Board [8s 6c 2c 8h 3d]
Seat 1: jew1jaw folded before Flop (didn't bet)
Seat 2: Skudero folded before Flop (didn't bet)
Seat 3: KIDNIC folded before Flop (didn't bet)
Seat 4: buzgt2008 (button) folded before Flop (didn't bet)
Seat 5: Gr33nfield (small blind) showed [Tc 9c] and lost with a pair of Eights
Seat 6: Tuwei168 (big blind) showed [4h 4s] and won ($11.45) with two pair, Eights and Fours
Seat 8: Dooley2005 folded before Flop (didn't bet)
Seat 9: Alameda22 folded before Flop (didn't bet)



PokerStars Game #19979403263:  Hold'em No Limit ($0.10/$0.25) - 2008/08/28 - 23:27:23 (ET)
Table 'Vesta III' 9-max Seat #5 is the button
Seat 1: jew1jaw ($10.80 in chips) 
Seat 2: Skudero ($39.15 in chips) 
Seat 3: KIDNIC ($19.75 in chips) 
Seat 4: buzgt2008 ($12.50 in chips) 
Seat 5: Gr33nfield ($25 in chips) 
Seat 6: Tuwei168 ($30.45 in chips) 
Seat 8: Dooley2005 ($25 in chips) 
Seat 9: Alameda22 ($27.20 in chips) 
Tuwei168: posts small blind $0.10
Dooley2005: posts big blind $0.25
*** HOLE CARDS ***
Dealt to Alameda22 [4d 9d]
Alameda22: folds 
jew1jaw: folds 
Skudero: folds 
KIDNIC: folds 
pmags88 joins the table at seat #7 
buzgt2008: calls $0.25
Gr33nfield: folds 
Tuwei168: calls $0.15
Dooley2005: checks 
*** FLOP *** [2s Ts 6h]
Tuwei168: checks 
Dooley2005: checks 
buzgt2008: checks 
*** TURN *** [2s Ts 6h] [Ah]
Tuwei168: checks 
Dooley2005: bets $0.70
buzgt2008: folds 
Tuwei168: folds 
Uncalled bet ($0.70) returned to Dooley2005
Dooley2005 collected $0.75 from pot
Dooley2005: doesn't show hand 
*** SUMMARY ***
Total pot $0.75 | Rake $0 
Board [2s Ts 6h Ah]
Seat 1: jew1jaw folded before Flop (didn't bet)
Seat 2: Skudero folded before Flop (didn't bet)
Seat 3: KIDNIC folded before Flop (didn't bet)
Seat 4: buzgt2008 folded on the Turn
Seat 5: Gr33nfield (button) folded before Flop (didn't bet)
Seat 6: Tuwei168 (small blind) folded on the Turn
Seat 8: Dooley2005 (big blind) collected ($0.75)
Seat 9: Alameda22 folded before Flop (didn't bet)



PokerStars Game #19979421931:  Hold'em No Limit ($0.10/$0.25) - 2008/08/28 - 23:28:23 (ET)
Table 'Vesta III' 9-max Seat #6 is the button
Seat 1: jew1jaw ($10.80 in chips) 
Seat 2: Skudero ($39.15 in chips) 
Seat 3: KIDNIC ($19.75 in chips) 
Seat 4: buzgt2008 ($12.25 in chips) 
Seat 5: Gr33nfield ($25 in chips) 
Seat 6: Tuwei168 ($30.20 in chips) 
Seat 8: Dooley2005 ($25.50 in chips) 
Seat 9: Alameda22 ($27.20 in chips) 
pmags88 will be allowed to play after the button
Dooley2005: posts small blind $0.10
Alameda22: posts big blind $0.25
*** HOLE CARDS ***
Dealt to Alameda22 [Qd Tc]
jew1jaw: calls $0.25
Skudero: calls $0.25
KIDNIC: calls $0.25
buzgt2008: calls $0.25
Gr33nfield: folds 
Tuwei168: folds 
Dooley2005: folds 
Alameda22: checks 
*** FLOP *** [8h 9c 8s]
Alameda22: checks 
jew1jaw: checks 
Skudero: checks 
KIDNIC: checks 
buzgt2008: checks 
*** TURN *** [8h 9c 8s] [5s]
Alameda22: checks 
jew1jaw: checks 
Skudero: bets $0.75
KIDNIC: folds 
buzgt2008: folds 
Alameda22: folds 
jew1jaw: folds 
Uncalled bet ($0.75) returned to Skudero
Skudero collected $1.30 from pot
Skudero: doesn't show hand 
*** SUMMARY ***
Total pot $1.35 | Rake $0.05 
Board [8h 9c 8s 5s]
Seat 1: jew1jaw folded on the Turn
Seat 2: Skudero collected ($1.30)
Seat 3: KIDNIC folded on the Turn
Seat 4: buzgt2008 folded on the Turn
Seat 5: Gr33nfield folded before Flop (didn't bet)
Seat 6: Tuwei168 (button) folded before Flop (didn't bet)
Seat 8: Dooley2005 (small blind) folded before Flop
Seat 9: Alameda22 (big blind) folded on the Turn



PokerStars Game #19979453399:  Hold'em No Limit ($0.10/$0.25) - 2008/08/28 - 23:30:03 (ET)
Table 'Vesta III' 9-max Seat #8 is the button
Seat 1: jew1jaw ($10.55 in chips) 
Seat 2: Skudero ($40.20 in chips) 
Seat 3: KIDNIC ($19.50 in chips) 
Seat 4: buzgt2008 ($12 in chips) 
Seat 5: Gr33nfield ($25 in chips) 
Seat 6: Tuwei168 ($30.20 in chips) 
Seat 8: Dooley2005 ($25.40 in chips) 
Seat 9: Alameda22 ($26.95 in chips) 
Alameda22: posts small blind $0.10
jew1jaw: posts big blind $0.25
pmags88: sits out 
*** HOLE CARDS ***
Dealt to Alameda22 [7s 3d]
Skudero: folds 
KIDNIC: folds 
buzgt2008: folds 
Gr33nfield: raises $0.50 to $0.75
Tuwei168: folds 
Dooley2005: folds 
Alameda22: folds 
jew1jaw: calls $0.50
*** FLOP *** [Kd Jd Qs]
jew1jaw: checks 
Gr33nfield: bets $1
jew1jaw: calls $1
*** TURN *** [Kd Jd Qs] [2s]
jew1jaw: checks 
Gr33nfield: bets $2
jew1jaw: calls $2
*** RIVER *** [Kd Jd Qs 2s] [3c]
jew1jaw: bets $6.80 and is all-in
Gr33nfield: folds 
Uncalled bet ($6.80) returned to jew1jaw
jew1jaw collected $7.25 from pot
*** SUMMARY ***
Total pot $7.60 | Rake $0.35 
Board [Kd Jd Qs 2s 3c]
Seat 1: jew1jaw (big blind) collected ($7.25)
Seat 2: Skudero folded before Flop (didn't bet)
Seat 3: KIDNIC folded before Flop (didn't bet)
Seat 4: buzgt2008 folded before Flop (didn't bet)
Seat 5: Gr33nfield folded on the River
Seat 6: Tuwei168 folded before Flop (didn't bet)
Seat 8: Dooley2005 (button) folded before Flop (didn't bet)
Seat 9: Alameda22 (small blind) folded before Flop



PokerStars Game #19979485858:  Hold'em No Limit ($0.10/$0.25) - 2008/08/28 - 23:31:44 (ET)
Table 'Vesta III' 9-max Seat #9 is the button
Seat 1: jew1jaw ($14.05 in chips) 
Seat 2: Skudero ($40.20 in chips) 
Seat 3: KIDNIC ($19.50 in chips) 
Seat 4: buzgt2008 ($12 in chips) 
Seat 5: Gr33nfield ($25 in chips) 
Seat 6: Tuwei168 ($30.20 in chips) 
Seat 8: Dooley2005 ($25.40 in chips) 
Seat 9: Alameda22 ($26.85 in chips) 
jew1jaw: posts small blind $0.10
Skudero: posts big blind $0.25
pmags88: sits out 
*** HOLE CARDS ***
Dealt to Alameda22 [Td 7s]
KIDNIC: folds 
buzgt2008: folds 
Gr33nfield: folds 
Tuwei168: folds 
Dooley2005: raises $0.75 to $1
Alameda22: folds 
jew1jaw: folds 
Skudero: folds 
Uncalled bet ($0.75) returned to Dooley2005
Dooley2005 collected $0.60 from pot
Dooley2005: doesn't show hand 
*** SUMMARY ***
Total pot $0.60 | Rake $0 
Seat 1: jew1jaw (small blind) folded before Flop
Seat 2: Skudero (big blind) folded before Flop
Seat 3: KIDNIC folded before Flop (didn't bet)
Seat 4: buzgt2008 folded before Flop (didn't bet)
Seat 5: Gr33nfield folded before Flop (didn't bet)
Seat 6: Tuwei168 folded before Flop (didn't bet)
Seat 8: Dooley2005 collected ($0.60)
Seat 9: Alameda22 (button) folded before Flop (didn't bet)



PokerStars Game #19979501983:  Hold'em No Limit ($0.10/$0.25) - 2008/08/28 - 23:32:34 (ET)
Table 'Vesta III' 9-max Seat #1 is the button
Seat 1: jew1jaw ($13.95 in chips) 
Seat 2: Skudero ($39.95 in chips) 
Seat 3: KIDNIC ($19.50 in chips) 
Seat 4: buzgt2008 ($12 in chips) 
Seat 5: Gr33nfield ($25 in chips) 
Seat 6: Tuwei168 ($30.20 in chips) 
Seat 8: Dooley2005 ($25.75 in chips) 
Seat 9: Alameda22 ($26.85 in chips) 
Skudero: posts small blind $0.10
KIDNIC: posts big blind $0.25
pmags88: sits out 
*** HOLE CARDS ***
Dealt to Alameda22 [Ks 3d]
buzgt2008: folds 
Gr33nfield: raises $0.50 to $0.75
Tuwei168: folds 
Dooley2005: folds 
Alameda22: folds 
jew1jaw: folds 
Skudero: folds 
KIDNIC: folds 
Uncalled bet ($0.50) returned to Gr33nfield
Gr33nfield collected $0.60 from pot
*** SUMMARY ***
Total pot $0.60 | Rake $0 
Seat 1: jew1jaw (button) folded before Flop (didn't bet)
Seat 2: Skudero (small blind) folded before Flop
Seat 3: KIDNIC (big blind) folded before Flop
Seat 4: buzgt2008 folded before Flop (didn't bet)
Seat 5: Gr33nfield collected ($0.60)
Seat 6: Tuwei168 folded before Flop (didn't bet)
Seat 8: Dooley2005 folded before Flop (didn't bet)
Seat 9: Alameda22 folded before Flop (didn't bet)



PokerStars Game #19979514412:  Hold'em No Limit ($0.10/$0.25) - 2008/08/28 - 23:33:13 (ET)
Table 'Vesta III' 9-max Seat #2 is the button
Seat 1: jew1jaw ($13.95 in chips) 
Seat 2: Skudero ($39.85 in chips) 
Seat 3: KIDNIC ($19.25 in chips) 
Seat 4: buzgt2008 ($12 in chips) 
Seat 5: Gr33nfield ($25.35 in chips) 
Seat 6: Tuwei168 ($30.20 in chips) 
Seat 8: Dooley2005 ($25.75 in chips) 
Seat 9: Alameda22 ($26.85 in chips) 
KIDNIC: posts small blind $0.10
buzgt2008: posts big blind $0.25
pmags88: sits out 
*** HOLE CARDS ***
Dealt to Alameda22 [2h 2c]
Gr33nfield: calls $0.25
Tuwei168: folds 
Dooley2005: folds 
Alameda22: folds 
jew1jaw: folds 
Skudero: folds 
KIDNIC: folds 
buzgt2008: checks 
*** FLOP *** [6s 3s Qc]
buzgt2008: checks 
Gr33nfield: bets $0.50
buzgt2008: folds 
Uncalled bet ($0.50) returned to Gr33nfield
Gr33nfield collected $0.60 from pot
Gr33nfield: doesn't show hand 
*** SUMMARY ***
Total pot $0.60 | Rake $0 
Board [6s 3s Qc]
Seat 1: jew1jaw folded before Flop (didn't bet)
Seat 2: Skudero (button) folded before Flop (didn't bet)
Seat 3: KIDNIC (small blind) folded before Flop
Seat 4: buzgt2008 (big blind) folded on the Flop
Seat 5: Gr33nfield collected ($0.60)
Seat 6: Tuwei168 folded before Flop (didn't bet)
Seat 8: Dooley2005 folded before Flop (didn't bet)
Seat 9: Alameda22 folded before Flop (didn't bet)



PokerStars Game #19979532450:  Hold'em No Limit ($0.10/$0.25) - 2008/08/28 - 23:34:10 (ET)
Table 'Vesta III' 9-max Seat #3 is the button
Seat 1: jew1jaw ($13.95 in chips) 
Seat 2: Skudero ($39.85 in chips) 
Seat 3: KIDNIC ($19.15 in chips) 
Seat 4: buzgt2008 ($11.75 in chips) 
Seat 5: Gr33nfield ($25.70 in chips) 
Seat 6: Tuwei168 ($30.20 in chips) 
Seat 8: Dooley2005 ($25.75 in chips) 
Seat 9: Alameda22 ($26.85 in chips) 
buzgt2008: posts small blind $0.10
Gr33nfield: posts big blind $0.25
pmags88: sits out 
*** HOLE CARDS ***
Dealt to Alameda22 [Kc Kd]
Tuwei168: folds 
Dooley2005: raises $0.75 to $1
Alameda22: raises $2 to $3
jew1jaw: folds 
Skudero: folds 
KIDNIC: folds 
buzgt2008: folds 
Gr33nfield: folds 
Dooley2005: folds 
Uncalled bet ($2) returned to Alameda22
Alameda22 collected $2.35 from pot
Alameda22: doesn't show hand 
*** SUMMARY ***
Total pot $2.35 | Rake $0 
Seat 1: jew1jaw folded before Flop (didn't bet)
Seat 2: Skudero folded before Flop (didn't bet)
Seat 3: KIDNIC (button) folded before Flop (didn't bet)
Seat 4: buzgt2008 (small blind) folded before Flop
Seat 5: Gr33nfield (big blind) folded before Flop
Seat 6: Tuwei168 folded before Flop (didn't bet)
Seat 8: Dooley2005 folded before Flop
Seat 9: Alameda22 collected ($2.35)



PokerStars Game #19979550815:  Hold'em No Limit ($0.10/$0.25) - 2008/08/28 - 23:35:07 (ET)
Table 'Vesta III' 9-max Seat #4 is the button
Seat 1: jew1jaw ($13.95 in chips) 
Seat 2: Skudero ($39.85 in chips) 
Seat 3: KIDNIC ($19.15 in chips) 
Seat 4: buzgt2008 ($11.65 in chips) 
Seat 5: Gr33nfield ($25.45 in chips) 
Seat 6: Tuwei168 ($30.20 in chips) 
Seat 8: Dooley2005 ($24.75 in chips) 
Seat 9: Alameda22 ($28.20 in chips) 
Gr33nfield: posts small blind $0.10
Tuwei168: posts big blind $0.25
pmags88: sits out 
*** HOLE CARDS ***
Dealt to Alameda22 [8s Ah]
Dooley2005: folds 
Alameda22: folds 
jew1jaw: folds 
Skudero: folds 
KIDNIC: folds 
buzgt2008: folds 
Gr33nfield: raises $0.75 to $1
Tuwei168: folds 
Uncalled bet ($0.75) returned to Gr33nfield
Gr33nfield collected $0.50 from pot
*** SUMMARY ***
Total pot $0.50 | Rake $0 
Seat 1: jew1jaw folded before Flop (didn't bet)
Seat 2: Skudero folded before Flop (didn't bet)
Seat 3: KIDNIC folded before Flop (didn't bet)
Seat 4: buzgt2008 (button) folded before Flop (didn't bet)
Seat 5: Gr33nfield (small blind) collected ($0.50)
Seat 6: Tuwei168 (big blind) folded before Flop
Seat 8: Dooley2005 folded before Flop (didn't bet)
Seat 9: Alameda22 folded before Flop (didn't bet)



PokerStars Game #19979564770:  Hold'em No Limit ($0.10/$0.25) - 2008/08/28 - 23:35:51 (ET)
Table 'Vesta III' 9-max Seat #5 is the button
Seat 1: jew1jaw ($13.95 in chips) 
Seat 2: Skudero ($39.85 in chips) 
Seat 3: KIDNIC ($19.15 in chips) 
Seat 4: buzgt2008 ($11.65 in chips) 
Seat 5: Gr33nfield ($25.70 in chips) 
Seat 6: Tuwei168 ($29.95 in chips) 
Seat 7: pmags88 ($25 in chips) 
Seat 8: Dooley2005 ($24.75 in chips) 
Seat 9: Alameda22 ($28.20 in chips) 
Tuwei168: posts small blind $0.10
pmags88: posts big blind $0.25
*** HOLE CARDS ***
Dealt to Alameda22 [3s 6d]
Dooley2005: folds 
Alameda22: folds 
jew1jaw: calls $0.25
Skudero: folds 
KIDNIC: folds 
buzgt2008: folds 
Gr33nfield: folds 
Tuwei168: calls $0.15
pmags88: checks 
*** FLOP *** [3c 2d 9s]
Tuwei168: checks 
pmags88: checks 
jew1jaw: bets $0.25
Tuwei168: folds 
pmags88: folds 
Uncalled bet ($0.25) returned to jew1jaw
jew1jaw collected $0.75 from pot
*** SUMMARY ***
Total pot $0.75 | Rake $0 
Board [3c 2d 9s]
Seat 1: jew1jaw collected ($0.75)
Seat 2: Skudero folded before Flop (didn't bet)
Seat 3: KIDNIC folded before Flop (didn't bet)
Seat 4: buzgt2008 folded before Flop (didn't bet)
Seat 5: Gr33nfield (button) folded before Flop (didn't bet)
Seat 6: Tuwei168 (small blind) folded on the Flop
Seat 7: pmags88 (big blind) folded on the Flop
Seat 8: Dooley2005 folded before Flop (didn't bet)
Seat 9: Alameda22 folded before Flop (didn't bet)



PokerStars Game #19979578344:  Hold'em No Limit ($0.10/$0.25) - 2008/08/28 - 23:36:34 (ET)
Table 'Vesta III' 9-max Seat #6 is the button
Seat 1: jew1jaw ($14.45 in chips) 
Seat 2: Skudero ($39.85 in chips) 
Seat 3: KIDNIC ($19.15 in chips) 
Seat 4: buzgt2008 ($11.65 in chips) 
Seat 5: Gr33nfield ($25.70 in chips) 
Seat 6: Tuwei168 ($29.70 in chips) 
Seat 7: pmags88 ($24.75 in chips) 
Seat 8: Dooley2005 ($24.75 in chips) 
Seat 9: Alameda22 ($28.20 in chips) 
pmags88: posts small blind $0.10
Dooley2005: posts big blind $0.25
*** HOLE CARDS ***
Dealt to Alameda22 [Kh 8c]
Alameda22: folds 
jew1jaw: calls $0.25
Skudero: folds 
KIDNIC: folds 
buzgt2008: folds 
Gr33nfield: folds 
Tuwei168: folds 
pmags88: folds 
Dooley2005: checks 
*** FLOP *** [Qc 6s 6d]
Dooley2005: checks 
jew1jaw: bets $0.25
Dooley2005: folds 
Uncalled bet ($0.25) returned to jew1jaw
jew1jaw collected $0.60 from pot
*** SUMMARY ***
Total pot $0.60 | Rake $0 
Board [Qc 6s 6d]
Seat 1: jew1jaw collected ($0.60)
Seat 2: Skudero folded before Flop (didn't bet)
Seat 3: KIDNIC folded before Flop (didn't bet)
Seat 4: buzgt2008 folded before Flop (didn't bet)
Seat 5: Gr33nfield folded before Flop (didn't bet)
Seat 6: Tuwei168 (button) folded before Flop (didn't bet)
Seat 7: pmags88 (small blind) folded before Flop
Seat 8: Dooley2005 (big blind) folded on the Flop
Seat 9: Alameda22 folded before Flop (didn't bet)



PokerStars Game #19979600666:  Hold'em No Limit ($0.10/$0.25) - 2008/08/28 - 23:37:45 (ET)
Table 'Vesta III' 9-max Seat #7 is the button
Seat 1: jew1jaw ($14.80 in chips) 
Seat 2: Skudero ($39.85 in chips) 
Seat 3: KIDNIC ($19.15 in chips) 
Seat 4: buzgt2008 ($11.65 in chips) 
Seat 5: Gr33nfield ($25.70 in chips) 
Seat 6: Tuwei168 ($29.70 in chips) 
Seat 7: pmags88 ($24.65 in chips) 
Seat 8: Dooley2005 ($24.50 in chips) 
Seat 9: Alameda22 ($28.20 in chips) 
Dooley2005: posts small blind $0.10
Alameda22: posts big blind $0.25
*** HOLE CARDS ***
Dealt to Alameda22 [Qc 8d]
jew1jaw: calls $0.25
Skudero: folds 
KIDNIC: raises $0.50 to $0.75
buzgt2008: folds 
Gr33nfield: folds 
Tuwei168: folds 
pmags88: folds 
Dooley2005: folds 
Alameda22: folds 
jew1jaw: calls $0.50
*** FLOP *** [7d 3h 3s]
jew1jaw: checks 
KIDNIC: bets $0.75
jew1jaw: calls $0.75
*** TURN *** [7d 3h 3s] [6c]
jew1jaw: checks 
KIDNIC: bets $0.75
jew1jaw: calls $0.75
*** RIVER *** [7d 3h 3s 6c] [Qd]
jew1jaw: checks 
KIDNIC: bets $2.25
jew1jaw: calls $2.25
*** SHOW DOWN ***
KIDNIC: shows [As Qh] (two pair, Queens and Threes)
jew1jaw: mucks hand 
KIDNIC collected $8.90 from pot
*** SUMMARY ***
Total pot $9.35 | Rake $0.45 
Board [7d 3h 3s 6c Qd]
Seat 1: jew1jaw mucked [Th Td]
Seat 2: Skudero folded before Flop (didn't bet)
Seat 3: KIDNIC showed [As Qh] and won ($8.90) with two pair, Queens and Threes
Seat 4: buzgt2008 folded before Flop (didn't bet)
Seat 5: Gr33nfield folded before Flop (didn't bet)
Seat 6: Tuwei168 folded before Flop (didn't bet)
Seat 7: pmags88 (button) folded before Flop (didn't bet)
Seat 8: Dooley2005 (small blind) folded before Flop
Seat 9: Alameda22 (big blind) folded before Flop



PokerStars Game #19979623278:  Hold'em No Limit ($0.10/$0.25) - 2008/08/28 - 23:38:55 (ET)
Table 'Vesta III' 9-max Seat #8 is the button
Seat 1: jew1jaw ($10.30 in chips) 
Seat 2: Skudero ($39.85 in chips) 
Seat 3: KIDNIC ($23.55 in chips) 
Seat 4: buzgt2008 ($11.65 in chips) 
Seat 5: Gr33nfield ($25.70 in chips) 
Seat 6: Tuwei168 ($29.70 in chips) 
Seat 7: pmags88 ($24.65 in chips) 
Seat 8: Dooley2005 ($24.40 in chips) 
Seat 9: Alameda22 ($27.95 in chips) 
Alameda22: posts small blind $0.10
jew1jaw: posts big blind $0.25
*** HOLE CARDS ***
Dealt to Alameda22 [7h 2d]
Skudero: folds 
KIDNIC: folds 
buzgt2008: folds 
Gr33nfield: folds 
Tuwei168: folds 
pmags88: folds 
Dooley2005: raises $0.75 to $1
Alameda22: folds 
jew1jaw: folds 
Uncalled bet ($0.75) returned to Dooley2005
Dooley2005 collected $0.60 from pot
*** SUMMARY ***
Total pot $0.60 | Rake $0 
Seat 1: jew1jaw (big blind) folded before Flop
Seat 2: Skudero folded before Flop (didn't bet)
Seat 3: KIDNIC folded before Flop (didn't bet)
Seat 4: buzgt2008 folded before Flop (didn't bet)
Seat 5: Gr33nfield folded before Flop (didn't bet)
Seat 6: Tuwei168 folded before Flop (didn't bet)
Seat 7: pmags88 folded before Flop (didn't bet)
Seat 8: Dooley2005 (button) collected ($0.60)
Seat 9: Alameda22 (small blind) folded before Flop



PokerStars Game #19979637288:  Hold'em No Limit ($0.10/$0.25) - 2008/08/28 - 23:39:40 (ET)
Table 'Vesta III' 9-max Seat #9 is the button
Seat 1: jew1jaw ($10.05 in chips) 
Seat 2: Skudero ($39.85 in chips) 
Seat 3: KIDNIC ($23.55 in chips) 
Seat 4: buzgt2008 ($11.65 in chips) 
Seat 5: Gr33nfield ($25.70 in chips) 
Seat 6: Tuwei168 ($29.70 in chips) 
Seat 7: pmags88 ($24.65 in chips) 
Seat 8: Dooley2005 ($24.75 in chips) 
Seat 9: Alameda22 ($27.85 in chips) 
jew1jaw: posts small blind $0.10
Skudero: posts big blind $0.25
*** HOLE CARDS ***
Dealt to Alameda22 [9h 2d]
KIDNIC: folds 
buzgt2008: folds 
Gr33nfield: folds 
Tuwei168: folds 
pmags88: folds 
Dooley2005: folds 
Alameda22: folds 
jew1jaw: calls $0.15
Skudero: checks 
*** FLOP *** [Jd 2s Ts]
jew1jaw: bets $0.25
Skudero: folds 
Uncalled bet ($0.25) returned to jew1jaw
jew1jaw collected $0.50 from pot
*** SUMMARY ***
Total pot $0.50 | Rake $0 
Board [Jd 2s Ts]
Seat 1: jew1jaw (small blind) collected ($0.50)
Seat 2: Skudero (big blind) folded on the Flop
Seat 3: KIDNIC folded before Flop (didn't bet)
Seat 4: buzgt2008 folded before Flop (didn't bet)
Seat 5: Gr33nfield folded before Flop (didn't bet)
Seat 6: Tuwei168 folded before Flop (didn't bet)
Seat 7: pmags88 folded before Flop (didn't bet)
Seat 8: Dooley2005 folded before Flop (didn't bet)
Seat 9: Alameda22 (button) folded before Flop (didn't bet)



PokerStars Game #19979650457:  Hold'em No Limit ($0.10/$0.25) - 2008/08/28 - 23:40:21 (ET)
Table 'Vesta III' 9-max Seat #1 is the button
Seat 1: jew1jaw ($10.30 in chips) 
Seat 2: Skudero ($39.60 in chips) 
Seat 3: KIDNIC ($23.55 in chips) 
Seat 4: buzgt2008 ($11.65 in chips) 
Seat 5: Gr33nfield ($25.70 in chips) 
Seat 6: Tuwei168 ($29.70 in chips) 
Seat 7: pmags88 ($24.65 in chips) 
Seat 8: Dooley2005 ($24.75 in chips) 
Seat 9: Alameda22 ($27.85 in chips) 
Skudero: posts small blind $0.10
KIDNIC: posts big blind $0.25
*** HOLE CARDS ***
Dealt to Alameda22 [5s Qd]
buzgt2008: folds 
Gr33nfield: folds 
Tuwei168: folds 
pmags88: folds 
Dooley2005: raises $0.75 to $1
Alameda22: folds 
jew1jaw: folds 
Skudero: folds 
KIDNIC: calls $0.75
*** FLOP *** [6c 5d 4s]
KIDNIC: bets $1
Dooley2005: calls $1
*** TURN *** [6c 5d 4s] [5c]
KIDNIC: bets $1
Dooley2005: calls $1
*** RIVER *** [6c 5d 4s 5c] [3s]
KIDNIC: bets $1
Dooley2005: calls $1
*** SHOW DOWN ***
KIDNIC: shows [Qs Qh] (two pair, Queens and Fives)
Dooley2005: mucks hand 
KIDNIC collected $7.75 from pot
*** SUMMARY ***
Total pot $8.10 | Rake $0.35 
Board [6c 5d 4s 5c 3s]
Seat 1: jew1jaw (button) folded before Flop (didn't bet)
Seat 2: Skudero (small blind) folded before Flop
Seat 3: KIDNIC (big blind) showed [Qs Qh] and won ($7.75) with two pair, Queens and Fives
Seat 4: buzgt2008 folded before Flop (didn't bet)
Seat 5: Gr33nfield folded before Flop (didn't bet)
Seat 6: Tuwei168 folded before Flop (didn't bet)
Seat 7: pmags88 folded before Flop (didn't bet)
Seat 8: Dooley2005 mucked [Tc Ts]
Seat 9: Alameda22 folded before Flop (didn't bet)



PokerStars Game #19979670091:  Hold'em No Limit ($0.10/$0.25) - 2008/08/28 - 23:41:23 (ET)
Table 'Vesta III' 9-max Seat #2 is the button
Seat 1: jew1jaw ($10.30 in chips) 
Seat 2: Skudero ($39.50 in chips) 
Seat 3: KIDNIC ($27.30 in chips) 
Seat 4: buzgt2008 ($11.65 in chips) 
Seat 5: Gr33nfield ($25.70 in chips) 
Seat 6: Tuwei168 ($29.70 in chips) 
Seat 7: pmags88 ($24.65 in chips) 
Seat 8: Dooley2005 ($20.75 in chips) 
Seat 9: Alameda22 ($27.85 in chips) 
KIDNIC: posts small blind $0.10
buzgt2008: posts big blind $0.25
*** HOLE CARDS ***
Dealt to Alameda22 [As Js]
Gr33nfield: folds 
Tuwei168: folds 
pmags88: folds 
Dooley2005: folds 
Alameda22: raises $0.50 to $0.75
jew1jaw: folds 
Skudero: folds 
KIDNIC said, "iolive 10's"
KIDNIC: folds 
buzgt2008: folds 
Uncalled bet ($0.50) returned to Alameda22
Alameda22 collected $0.60 from pot
Alameda22: doesn't show hand 
Dooley2005 said, "thank god u suck"
*** SUMMARY ***
Total pot $0.60 | Rake $0 
Seat 1: jew1jaw folded before Flop (didn't bet)
Seat 2: Skudero (button) folded before Flop (didn't bet)
Seat 3: KIDNIC (small blind) folded before Flop
Seat 4: buzgt2008 (big blind) folded before Flop
Seat 5: Gr33nfield folded before Flop (didn't bet)
Seat 6: Tuwei168 folded before Flop (didn't bet)
Seat 7: pmags88 folded before Flop (didn't bet)
Seat 8: Dooley2005 folded before Flop (didn't bet)
Seat 9: Alameda22 collected ($0.60)



PokerStars Game #19979684761:  Hold'em No Limit ($0.10/$0.25) - 2008/08/28 - 23:42:09 (ET)
Table 'Vesta III' 9-max Seat #3 is the button
Seat 1: jew1jaw ($10.30 in chips) 
Seat 2: Skudero ($39.50 in chips) 
Seat 3: KIDNIC ($27.20 in chips) 
Seat 4: buzgt2008 ($11.40 in chips) 
Seat 5: Gr33nfield ($25.70 in chips) 
Seat 6: Tuwei168 ($29.70 in chips) 
Seat 7: pmags88 ($24.65 in chips) 
Seat 8: Dooley2005 ($25 in chips) 
Seat 9: Alameda22 ($28.20 in chips) 
buzgt2008: posts small blind $0.10
Gr33nfield: posts big blind $0.25
*** HOLE CARDS ***
Dealt to Alameda22 [7d 5c]
Tuwei168: folds 
pmags88: folds 
Dooley2005: folds 
Alameda22: folds 
jew1jaw: folds 
Skudero: folds 
KIDNIC: folds 
KIDNIC said, "suck i may, but never would i put my mouth on you..."
buzgt2008: calls $0.15
Gr33nfield: checks 
*** FLOP *** [2c Jh Ks]
buzgt2008: checks 
Gr33nfield: checks 
*** TURN *** [2c Jh Ks] [Qh]
buzgt2008: bets $0.25
Gr33nfield: calls $0.25
*** RIVER *** [2c Jh Ks Qh] [4s]
buzgt2008: bets $1
Gr33nfield: folds 
Uncalled bet ($1) returned to buzgt2008
buzgt2008 collected $0.95 from pot
buzgt2008: doesn't show hand 
*** SUMMARY ***
Total pot $1 | Rake $0.05 
Board [2c Jh Ks Qh 4s]
Seat 1: jew1jaw folded before Flop (didn't bet)
Seat 2: Skudero folded before Flop (didn't bet)
Seat 3: KIDNIC (button) folded before Flop (didn't bet)
Seat 4: buzgt2008 (small blind) collected ($0.95)
Seat 5: Gr33nfield (big blind) folded on the River
Seat 6: Tuwei168 folded before Flop (didn't bet)
Seat 7: pmags88 folded before Flop (didn't bet)
Seat 8: Dooley2005 folded before Flop (didn't bet)
Seat 9: Alameda22 folded before Flop (didn't bet)



PokerStars Game #19979717462:  Hold'em No Limit ($0.10/$0.25) - 2008/08/28 - 23:43:52 (ET)
Table 'Vesta III' 9-max Seat #4 is the button
Seat 1: jew1jaw ($10.30 in chips) 
Seat 2: Skudero ($39.50 in chips) 
Seat 3: KIDNIC ($27.20 in chips) 
Seat 4: buzgt2008 ($11.85 in chips) 
Seat 5: Gr33nfield ($25.20 in chips) 
Seat 6: Tuwei168 ($29.70 in chips) 
Seat 7: pmags88 ($24.65 in chips) 
Seat 8: Dooley2005 ($25 in chips) 
Seat 9: Alameda22 ($28.20 in chips) 
Gr33nfield: posts small blind $0.10
Tuwei168: posts big blind $0.25
*** HOLE CARDS ***
Dealt to Alameda22 [5h Js]
pmags88: folds 
Dooley2005: folds 
Alameda22: folds 
jew1jaw: folds 
Skudero: calls $0.25
KIDNIC: folds 
buzgt2008: folds 
Gr33nfield: calls $0.15
Tuwei168: checks 
*** FLOP *** [2c Kc Kh]
Gr33nfield: checks 
Tuwei168: checks 
Skudero: bets $0.50
Gr33nfield: calls $0.50
Tuwei168: calls $0.50
*** TURN *** [2c Kc Kh] [7h]
Gr33nfield: checks 
Tuwei168: checks 
Skudero: checks 
*** RIVER *** [2c Kc Kh 7h] [7s]
Gr33nfield: checks 
Tuwei168: checks 
Skudero: checks 
*** SHOW DOWN ***
Gr33nfield: shows [6s 6c] (two pair, Kings and Sevens)
Tuwei168: shows [Jh Jd] (two pair, Kings and Jacks)
Skudero: mucks hand 
Tuwei168 collected $2.15 from pot
*** SUMMARY ***
Total pot $2.25 | Rake $0.10 
Board [2c Kc Kh 7h 7s]
Seat 1: jew1jaw folded before Flop (didn't bet)
Seat 2: Skudero mucked [4h Ah]
Seat 3: KIDNIC folded before Flop (didn't bet)
Seat 4: buzgt2008 (button) folded before Flop (didn't bet)
Seat 5: Gr33nfield (small blind) showed [6s 6c] and lost with two pair, Kings and Sevens
Seat 6: Tuwei168 (big blind) showed [Jh Jd] and won ($2.15) with two pair, Kings and Jacks
Seat 7: pmags88 folded before Flop (didn't bet)
Seat 8: Dooley2005 folded before Flop (didn't bet)
Seat 9: Alameda22 folded before Flop (didn't bet)



PokerStars Game #19979739743:  Hold'em No Limit ($0.10/$0.25) - 2008/08/28 - 23:45:03 (ET)
Table 'Vesta III' 9-max Seat #5 is the button
Seat 1: jew1jaw ($10.30 in chips) 
Seat 2: Skudero ($38.75 in chips) 
Seat 3: KIDNIC ($27.20 in chips) 
Seat 4: buzgt2008 ($11.85 in chips) 
Seat 5: Gr33nfield ($24.45 in chips) 
Seat 6: Tuwei168 ($31.10 in chips) 
Seat 7: pmags88 ($24.65 in chips) 
Seat 8: Dooley2005 ($25 in chips) 
Seat 9: Alameda22 ($28.20 in chips) 
Tuwei168: posts small blind $0.10
pmags88: posts big blind $0.25
*** HOLE CARDS ***
Dealt to Alameda22 [Td 4s]
Dooley2005: folds 
Alameda22: folds 
jew1jaw: calls $0.25
Skudero: folds 
KIDNIC: folds 
buzgt2008: folds 
Gr33nfield: raises $0.75 to $1
Tuwei168: folds 
pmags88: folds 
jew1jaw: calls $0.75
*** FLOP *** [3d Qs Kd]
jew1jaw: checks 
Gr33nfield: checks 
*** TURN *** [3d Qs Kd] [9h]
jew1jaw: checks 
Gr33nfield: checks 
*** RIVER *** [3d Qs Kd 9h] [Jc]
jew1jaw: checks 
Gr33nfield: bets $2
jew1jaw: folds 
Uncalled bet ($2) returned to Gr33nfield
Gr33nfield collected $2.25 from pot
*** SUMMARY ***
Total pot $2.35 | Rake $0.10 
Board [3d Qs Kd 9h Jc]
Seat 1: jew1jaw folded on the River
Seat 2: Skudero folded before Flop (didn't bet)
Seat 3: KIDNIC folded before Flop (didn't bet)
Seat 4: buzgt2008 folded before Flop (didn't bet)
Seat 5: Gr33nfield (button) collected ($2.25)
Seat 6: Tuwei168 (small blind) folded before Flop
Seat 7: pmags88 (big blind) folded before Flop
Seat 8: Dooley2005 folded before Flop (didn't bet)
Seat 9: Alameda22 folded before Flop (didn't bet)



PokerStars Game #19979760175:  Hold'em No Limit ($0.10/$0.25) - 2008/08/28 - 23:46:08 (ET)
Table 'Vesta III' 9-max Seat #6 is the button
Seat 1: jew1jaw ($9.30 in chips) 
Seat 2: Skudero ($38.75 in chips) 
Seat 3: KIDNIC ($27.20 in chips) 
Seat 4: buzgt2008 ($11.85 in chips) 
Seat 5: Gr33nfield ($25.70 in chips) 
Seat 6: Tuwei168 ($31 in chips) 
Seat 7: pmags88 ($24.40 in chips) 
Seat 8: Dooley2005 ($25 in chips) 
Seat 9: Alameda22 ($28.20 in chips) 
pmags88: posts small blind $0.10
Dooley2005: posts big blind $0.25
*** HOLE CARDS ***
Dealt to Alameda22 [Kh 4d]
Alameda22: folds 
jew1jaw: calls $0.25
Skudero: folds 
KIDNIC: calls $0.25
buzgt2008: folds 
Gr33nfield: raises $0.75 to $1
Tuwei168: folds 
pmags88: folds 
Dooley2005: folds 
jew1jaw: folds 
KIDNIC: folds 
Uncalled bet ($0.75) returned to Gr33nfield
Gr33nfield collected $1.10 from pot
*** SUMMARY ***
Total pot $1.10 | Rake $0 
Seat 1: jew1jaw folded before Flop
Seat 2: Skudero folded before Flop (didn't bet)
Seat 3: KIDNIC folded before Flop
Seat 4: buzgt2008 folded before Flop (didn't bet)
Seat 5: Gr33nfield collected ($1.10)
Seat 6: Tuwei168 (button) folded before Flop (didn't bet)
Seat 7: pmags88 (small blind) folded before Flop
Seat 8: Dooley2005 (big blind) folded before Flop
Seat 9: Alameda22 folded before Flop (didn't bet)



PokerStars Game #19979775207:  Hold'em No Limit ($0.10/$0.25) - 2008/08/28 - 23:46:56 (ET)
Table 'Vesta III' 9-max Seat #7 is the button
Seat 1: jew1jaw ($9.05 in chips) 
Seat 2: Skudero ($38.75 in chips) 
Seat 3: KIDNIC ($26.95 in chips) 
Seat 4: buzgt2008 ($11.85 in chips) 
Seat 5: Gr33nfield ($26.55 in chips) 
Seat 6: Tuwei168 ($31 in chips) 
Seat 7: pmags88 ($24.30 in chips) 
Seat 8: Dooley2005 ($24.75 in chips) 
Seat 9: Alameda22 ($28.20 in chips) 
Dooley2005: posts small blind $0.10
Alameda22: posts big blind $0.25
*** HOLE CARDS ***
Dealt to Alameda22 [9d 4s]
jew1jaw: folds 
Skudero: calls $0.25
KIDNIC: raises $0.75 to $1
buzgt2008: folds 
Gr33nfield: folds 
Tuwei168: folds 
pmags88: folds 
Dooley2005: calls $0.90
Alameda22: folds 
Skudero: calls $0.75
*** FLOP *** [9c 2c Kc]
Dooley2005: checks 
Skudero: checks 
KIDNIC: bets $1
Dooley2005: folds 
Skudero: calls $1
*** TURN *** [9c 2c Kc] [3h]
Skudero: checks 
KIDNIC: bets $1
Skudero: calls $1
*** RIVER *** [9c 2c Kc 3h] [Jc]
Skudero: checks 
KIDNIC: checks 
*** SHOW DOWN ***
Skudero: shows [Ks Js] (two pair, Kings and Jacks)
KIDNIC: mucks hand 
Skudero collected $6.90 from pot
*** SUMMARY ***
Total pot $7.25 | Rake $0.35 
Board [9c 2c Kc 3h Jc]
Seat 1: jew1jaw folded before Flop (didn't bet)
Seat 2: Skudero showed [Ks Js] and won ($6.90) with two pair, Kings and Jacks
Seat 3: KIDNIC mucked [Ts Th]
Seat 4: buzgt2008 folded before Flop (didn't bet)
Seat 5: Gr33nfield folded before Flop (didn't bet)
Seat 6: Tuwei168 folded before Flop (didn't bet)
Seat 7: pmags88 (button) folded before Flop (didn't bet)
Seat 8: Dooley2005 (small blind) folded on the Flop
Seat 9: Alameda22 (big blind) folded before Flop



PokerStars Game #19979808678:  Hold'em No Limit ($0.10/$0.25) - 2008/08/28 - 23:48:44 (ET)
Table 'Vesta III' 9-max Seat #8 is the button
Seat 1: jew1jaw ($9.05 in chips) 
Seat 2: Skudero ($42.65 in chips) 
Seat 3: KIDNIC ($23.95 in chips) 
Seat 4: buzgt2008 ($11.85 in chips) 
Seat 5: Gr33nfield ($26.55 in chips) 
Seat 6: Tuwei168 ($31 in chips) 
Seat 7: pmags88 ($24.30 in chips) 
Seat 8: Dooley2005 ($23.75 in chips) 
Seat 9: Alameda22 ($27.95 in chips) 
Alameda22: posts small blind $0.10
jew1jaw: posts big blind $0.25
*** HOLE CARDS ***
Dealt to Alameda22 [6h 7d]
Skudero: folds 
KIDNIC: folds 
buzgt2008: calls $0.25
Gr33nfield: folds 
Tuwei168: calls $0.25
pmags88: folds 
Dooley2005: calls $0.25
Alameda22: folds 
jew1jaw: raises $0.25 to $0.50
buzgt2008: calls $0.25
Tuwei168: calls $0.25
Dooley2005: calls $0.25
*** FLOP *** [3c Td Tc]
jew1jaw: bets $0.25
buzgt2008: folds 
Tuwei168: calls $0.25
Dooley2005: folds 
*** TURN *** [3c Td Tc] [8s]
jew1jaw: bets $0.25
Tuwei168: calls $0.25
*** RIVER *** [3c Td Tc 8s] [Ac]
jew1jaw: bets $2.75
Tuwei168: folds 
Uncalled bet ($2.75) returned to jew1jaw
jew1jaw collected $2.95 from pot
*** SUMMARY ***
Total pot $3.10 | Rake $0.15 
Board [3c Td Tc 8s Ac]
Seat 1: jew1jaw (big blind) collected ($2.95)
Seat 2: Skudero folded before Flop (didn't bet)
Seat 3: KIDNIC folded before Flop (didn't bet)
Seat 4: buzgt2008 folded on the Flop
Seat 5: Gr33nfield folded before Flop (didn't bet)
Seat 6: Tuwei168 folded on the River
Seat 7: pmags88 folded before Flop (didn't bet)
Seat 8: Dooley2005 (button) folded on the Flop
Seat 9: Alameda22 (small blind) folded before Flop



PokerStars Game #19979840668:  Hold'em No Limit ($0.10/$0.25) - 2008/08/28 - 23:50:29 (ET)
Table 'Vesta III' 9-max Seat #9 is the button
Seat 1: jew1jaw ($11 in chips) 
Seat 2: Skudero ($42.65 in chips) 
Seat 3: KIDNIC ($23.95 in chips) 
Seat 4: buzgt2008 ($11.35 in chips) 
Seat 5: Gr33nfield ($26.55 in chips) 
Seat 6: Tuwei168 ($30 in chips) 
Seat 7: pmags88 ($24.30 in chips) 
Seat 8: Dooley2005 ($23.25 in chips) 
Seat 9: Alameda22 ($27.85 in chips) 
jew1jaw: posts small blind $0.10
Skudero: posts big blind $0.25
*** HOLE CARDS ***
Dealt to Alameda22 [9c 4h]
KIDNIC: folds 
buzgt2008: folds 
Gr33nfield: raises $0.75 to $1
Tuwei168: folds 
pmags88: folds 
Dooley2005: folds 
Alameda22: folds 
jew1jaw: calls $0.90
Skudero: folds 
*** FLOP *** [7c Ks 3d]
jew1jaw: checks 
Gr33nfield: checks 
*** TURN *** [7c Ks 3d] [Qs]
jew1jaw: bets $0.25
Gr33nfield: folds 
Uncalled bet ($0.25) returned to jew1jaw
jew1jaw collected $2.15 from pot
*** SUMMARY ***
Total pot $2.25 | Rake $0.10 
Board [7c Ks 3d Qs]
Seat 1: jew1jaw (small blind) collected ($2.15)
Seat 2: Skudero (big blind) folded before Flop
Seat 3: KIDNIC folded before Flop (didn't bet)
Seat 4: buzgt2008 folded before Flop (didn't bet)
Seat 5: Gr33nfield folded on the Turn
Seat 6: Tuwei168 folded before Flop (didn't bet)
Seat 7: pmags88 folded before Flop (didn't bet)
Seat 8: Dooley2005 folded before Flop (didn't bet)
Seat 9: Alameda22 (button) folded before Flop (didn't bet)



PokerStars Game #19979858928:  Hold'em No Limit ($0.10/$0.25) - 2008/08/28 - 23:51:28 (ET)
Table 'Vesta III' 9-max Seat #1 is the button
Seat 1: jew1jaw ($12.15 in chips) 
Seat 2: Skudero ($42.40 in chips) 
Seat 3: KIDNIC ($23.95 in chips) 
Seat 4: buzgt2008 ($11.35 in chips) 
Seat 5: Gr33nfield ($25.55 in chips) 
Seat 6: Tuwei168 ($30 in chips) 
Seat 7: pmags88 ($24.30 in chips) 
Seat 8: Dooley2005 ($23.25 in chips) 
Seat 9: Alameda22 ($27.85 in chips) 
Skudero: posts small blind $0.10
KIDNIC: posts big blind $0.25
*** HOLE CARDS ***
Dealt to Alameda22 [Td 4s]
buzgt2008: folds 
Gr33nfield: calls $0.25
Tuwei168: folds 
pmags88: folds 
Dooley2005: folds 
Alameda22: folds 
jew1jaw: calls $0.25
Skudero: calls $0.15
KIDNIC: checks 
*** FLOP *** [Ks 6h 8h]
Skudero: checks 
KIDNIC: checks 
Gr33nfield: bets $1
jew1jaw: calls $1
Skudero: calls $1
KIDNIC: folds 
*** TURN *** [Ks 6h 8h] [2c]
Skudero: checks 
Gr33nfield: checks 
jew1jaw: bets $1.50
Skudero: folds 
Gr33nfield: folds 
Uncalled bet ($1.50) returned to jew1jaw
jew1jaw collected $3.85 from pot
*** SUMMARY ***
Total pot $4 | Rake $0.15 
Board [Ks 6h 8h 2c]
Seat 1: jew1jaw (button) collected ($3.85)
Seat 2: Skudero (small blind) folded on the Turn
Seat 3: KIDNIC (big blind) folded on the Flop
Seat 4: buzgt2008 folded before Flop (didn't bet)
Seat 5: Gr33nfield folded on the Turn
Seat 6: Tuwei168 folded before Flop (didn't bet)
Seat 7: pmags88 folded before Flop (didn't bet)
Seat 8: Dooley2005 folded before Flop (didn't bet)
Seat 9: Alameda22 folded before Flop (didn't bet)



PokerStars Game #19979888042:  Hold'em No Limit ($0.10/$0.25) - 2008/08/28 - 23:53:02 (ET)
Table 'Vesta III' 9-max Seat #2 is the button
Seat 1: jew1jaw ($14.75 in chips) 
Seat 2: Skudero ($41.15 in chips) 
Seat 3: KIDNIC ($23.70 in chips) 
Seat 4: buzgt2008 ($11.35 in chips) 
Seat 5: Gr33nfield ($24.30 in chips) 
Seat 6: Tuwei168 ($30 in chips) 
Seat 7: pmags88 ($24.30 in chips) 
Seat 8: Dooley2005 ($23.25 in chips) 
Seat 9: Alameda22 ($27.85 in chips) 
KIDNIC: posts small blind $0.10
buzgt2008: posts big blind $0.25
*** HOLE CARDS ***
Dealt to Alameda22 [Ad 7d]
Gr33nfield: folds 
Tuwei168: folds 
pmags88: folds 
Dooley2005: folds 
Alameda22: folds 
jew1jaw: calls $0.25
Skudero: folds 
KIDNIC: raises $0.25 to $0.50
buzgt2008: folds 
jew1jaw: calls $0.25
*** FLOP *** [8c 2c Jc]
KIDNIC: bets $0.50
jew1jaw: calls $0.50
*** TURN *** [8c 2c Jc] [Kd]
KIDNIC: bets $1.25
jew1jaw: calls $1.25
*** RIVER *** [8c 2c Jc Kd] [4s]
KIDNIC: bets $3
jew1jaw: folds 
Uncalled bet ($3) returned to KIDNIC
KIDNIC collected $4.55 from pot
KIDNIC: doesn't show hand 
*** SUMMARY ***
Total pot $4.75 | Rake $0.20 
Board [8c 2c Jc Kd 4s]
Seat 1: jew1jaw folded on the River
Seat 2: Skudero (button) folded before Flop (didn't bet)
Seat 3: KIDNIC (small blind) collected ($4.55)
Seat 4: buzgt2008 (big blind) folded before Flop
Seat 5: Gr33nfield folded before Flop (didn't bet)
Seat 6: Tuwei168 folded before Flop (didn't bet)
Seat 7: pmags88 folded before Flop (didn't bet)
Seat 8: Dooley2005 folded before Flop (didn't bet)
Seat 9: Alameda22 folded before Flop (didn't bet)



PokerStars Game #19979909306:  Hold'em No Limit ($0.10/$0.25) - 2008/08/28 - 23:54:12 (ET)
Table 'Vesta III' 9-max Seat #3 is the button
Seat 1: jew1jaw ($12.50 in chips) 
Seat 2: Skudero ($41.15 in chips) 
Seat 3: KIDNIC ($26 in chips) 
Seat 4: buzgt2008 ($11.10 in chips) 
Seat 6: Tuwei168 ($30 in chips) 
Seat 7: pmags88 ($24.30 in chips) 
Seat 8: Dooley2005 ($23.25 in chips) 
Seat 9: Alameda22 ($27.85 in chips) 
buzgt2008: posts small blind $0.10
Gr33nfield: is sitting out 
Gr33nfield leaves the table
Tuwei168: posts big blind $0.25
*** HOLE CARDS ***
Dealt to Alameda22 [3h 6h]
pmags88: folds 
Dooley2005: folds 
Alameda22: folds 
jew1jaw: folds 
Skudero: raises $1 to $1.25
KIDNIC: folds 
buzgt2008: folds 
Tuwei168: folds 
Uncalled bet ($1) returned to Skudero
Skudero collected $0.60 from pot
Skudero: doesn't show hand 
*** SUMMARY ***
Total pot $0.60 | Rake $0 
Seat 1: jew1jaw folded before Flop (didn't bet)
Seat 2: Skudero collected ($0.60)
Seat 3: KIDNIC (button) folded before Flop (didn't bet)
Seat 4: buzgt2008 (small blind) folded before Flop
Seat 6: Tuwei168 (big blind) folded before Flop
Seat 7: pmags88 folded before Flop (didn't bet)
Seat 8: Dooley2005 folded before Flop (didn't bet)
Seat 9: Alameda22 folded before Flop (didn't bet)



PokerStars Game #19979925741:  Hold'em No Limit ($0.10/$0.25) - 2008/08/28 - 23:55:07 (ET)
Table 'Vesta III' 9-max Seat #4 is the button
Seat 1: jew1jaw ($12.50 in chips) 
Seat 2: Skudero ($41.50 in chips) 
Seat 3: KIDNIC ($26 in chips) 
Seat 4: buzgt2008 ($15 in chips) 
Seat 6: Tuwei168 ($29.75 in chips) 
Seat 7: pmags88 ($24.30 in chips) 
Seat 8: Dooley2005 ($23.25 in chips) 
Seat 9: Alameda22 ($27.85 in chips) 
Tuwei168: posts small blind $0.10
pmags88: posts big blind $0.25
*** HOLE CARDS ***
Dealt to Alameda22 [As 3h]
Dooley2005: folds 
Alameda22: folds 
jew1jaw: calls $0.25
Skudero: folds 
KIDNIC: folds 
buzgt2008: folds 
Tuwei168: calls $0.15
pmags88: checks 
*** FLOP *** [6h 5s 7d]
Tuwei168: checks 
pmags88: checks 
jew1jaw: checks 
*** TURN *** [6h 5s 7d] [3c]
Tuwei168: checks 
pmags88: checks 
jew1jaw: checks 
*** RIVER *** [6h 5s 7d 3c] [Qc]
Tuwei168: checks 
pmags88: checks 
jew1jaw: checks 
*** SHOW DOWN ***
Tuwei168: shows [5c 6d] (two pair, Sixes and Fives)
pmags88: mucks hand 
jew1jaw: mucks hand 
Tuwei168 collected $0.75 from pot
*** SUMMARY ***
Total pot $0.75 | Rake $0 
Board [6h 5s 7d 3c Qc]
Seat 1: jew1jaw mucked [Ks 9s]
Seat 2: Skudero folded before Flop (didn't bet)
Seat 3: KIDNIC folded before Flop (didn't bet)
Seat 4: buzgt2008 (button) folded before Flop (didn't bet)
Seat 6: Tuwei168 (small blind) showed [5c 6d] and won ($0.75) with two pair, Sixes and Fives
Seat 7: pmags88 (big blind) mucked [Kd 8h]
Seat 8: Dooley2005 folded before Flop (didn't bet)
Seat 9: Alameda22 folded before Flop (didn't bet)



PokerStars Game #19979945694:  Hold'em No Limit ($0.10/$0.25) - 2008/08/28 - 23:56:12 (ET)
Table 'Vesta III' 9-max Seat #6 is the button
Seat 1: jew1jaw ($12.25 in chips) 
Seat 2: Skudero ($41.50 in chips) 
Seat 3: KIDNIC ($26 in chips) 
Seat 4: buzgt2008 ($15 in chips) 
Seat 6: Tuwei168 ($30.25 in chips) 
Seat 7: pmags88 ($24.05 in chips) 
Seat 8: Dooley2005 ($25 in chips) 
Seat 9: Alameda22 ($27.85 in chips) 
pmags88: posts small blind $0.10
Dooley2005: posts big blind $0.25
*** HOLE CARDS ***
Dealt to Alameda22 [5c Th]
Alameda22: folds 
jew1jaw: folds 
Skudero: calls $0.25
KIDNIC: folds 
buzgt2008: folds 
Tuwei168: folds 
pmags88: folds 
Dooley2005: checks 
*** FLOP *** [3h 7h 7c]
Dooley2005: bets $0.50
Skudero: folds 
Uncalled bet ($0.50) returned to Dooley2005
Dooley2005 collected $0.60 from pot
*** SUMMARY ***
Total pot $0.60 | Rake $0 
Board [3h 7h 7c]
Seat 1: jew1jaw folded before Flop (didn't bet)
Seat 2: Skudero folded on the Flop
Seat 3: KIDNIC folded before Flop (didn't bet)
Seat 4: buzgt2008 folded before Flop (didn't bet)
Seat 6: Tuwei168 (button) folded before Flop (didn't bet)
Seat 7: pmags88 (small blind) folded before Flop
Seat 8: Dooley2005 (big blind) collected ($0.60)
Seat 9: Alameda22 folded before Flop (didn't bet)



PokerStars Game #19979962064:  Hold'em No Limit ($0.10/$0.25) - 2008/08/28 - 23:57:06 (ET)
Table 'Vesta III' 9-max Seat #7 is the button
Seat 1: jew1jaw ($12.25 in chips) 
Seat 2: Skudero ($41.25 in chips) 
Seat 3: KIDNIC ($26 in chips) 
Seat 4: buzgt2008 ($15 in chips) 
Seat 6: Tuwei168 ($30.25 in chips) 
Seat 7: pmags88 ($23.95 in chips) 
Seat 8: Dooley2005 ($25.35 in chips) 
Seat 9: Alameda22 ($27.85 in chips) 
Dooley2005: posts small blind $0.10
Alameda22: posts big blind $0.25
*** HOLE CARDS ***
Dealt to Alameda22 [Qh 2s]
jew1jaw: folds 
Skudero: raises $0.75 to $1
KIDNIC: folds 
buzgt2008: folds 
Tuwei168: folds 
pmags88: folds 
Dooley2005: folds 
Alameda22: folds 
Uncalled bet ($0.75) returned to Skudero
Skudero collected $0.60 from pot
Skudero: doesn't show hand 
*** SUMMARY ***
Total pot $0.60 | Rake $0 
Seat 1: jew1jaw folded before Flop (didn't bet)
Seat 2: Skudero collected ($0.60)
Seat 3: KIDNIC folded before Flop (didn't bet)
Seat 4: buzgt2008 folded before Flop (didn't bet)
Seat 6: Tuwei168 folded before Flop (didn't bet)
Seat 7: pmags88 (button) folded before Flop (didn't bet)
Seat 8: Dooley2005 (small blind) folded before Flop
Seat 9: Alameda22 (big blind) folded before Flop



PokerStars Game #19979972937:  Hold'em No Limit ($0.10/$0.25) - 2008/08/28 - 23:57:42 (ET)
Table 'Vesta III' 9-max Seat #8 is the button
Seat 1: jew1jaw ($12.25 in chips) 
Seat 2: Skudero ($41.60 in chips) 
Seat 3: KIDNIC ($26 in chips) 
Seat 4: buzgt2008 ($15 in chips) 
Seat 6: Tuwei168 ($30.25 in chips) 
Seat 7: pmags88 ($23.95 in chips) 
Seat 8: Dooley2005 ($25.25 in chips) 
Seat 9: Alameda22 ($27.60 in chips) 
Alameda22: posts small blind $0.10
jew1jaw: posts big blind $0.25
*** HOLE CARDS ***
Dealt to Alameda22 [4d Js]
Skudero: folds 
KIDNIC: folds 
buzgt2008: folds 
Tuwei168: folds 
pmags88: folds 
Dooley2005: raises $0.75 to $1
Alameda22: folds 
jew1jaw: folds 
Uncalled bet ($0.75) returned to Dooley2005
Dooley2005 collected $0.60 from pot
Dooley2005: doesn't show hand 
*** SUMMARY ***
Total pot $0.60 | Rake $0 
Seat 1: jew1jaw (big blind) folded before Flop
Seat 2: Skudero folded before Flop (didn't bet)
Seat 3: KIDNIC folded before Flop (didn't bet)
Seat 4: buzgt2008 folded before Flop (didn't bet)
Seat 6: Tuwei168 folded before Flop (didn't bet)
Seat 7: pmags88 folded before Flop (didn't bet)
Seat 8: Dooley2005 (button) collected ($0.60)
Seat 9: Alameda22 (small blind) folded before Flop



PokerStars Game #19979984974:  Hold'em No Limit ($0.10/$0.25) - 2008/08/28 - 23:58:22 (ET)
Table 'Vesta III' 9-max Seat #9 is the button
Seat 1: jew1jaw ($12 in chips) 
Seat 2: Skudero ($41.60 in chips) 
Seat 3: KIDNIC ($26 in chips) 
Seat 4: buzgt2008 ($15 in chips) 
Seat 6: Tuwei168 ($30.25 in chips) 
Seat 7: pmags88 ($23.95 in chips) 
Seat 8: Dooley2005 ($25.60 in chips) 
Seat 9: Alameda22 ($27.50 in chips) 
jew1jaw: posts small blind $0.10
Skudero: posts big blind $0.25
*** HOLE CARDS ***
Dealt to Alameda22 [7c 5c]
KIDNIC: calls $0.25
buzgt2008: calls $0.25
Tuwei168: folds 
pmags88: folds 
Dooley2005: folds 
Alameda22: folds 
jew1jaw: calls $0.15
Skudero: checks 
*** FLOP *** [2s 8s 6h]
jew1jaw: bets $0.25
Skudero: folds 
KIDNIC: calls $0.25
buzgt2008: folds 
*** TURN *** [2s 8s 6h] [Qd]
jew1jaw: bets $0.25
KIDNIC: calls $0.25
*** RIVER *** [2s 8s 6h Qd] [Ks]
jew1jaw: checks 
KIDNIC: checks 
*** SHOW DOWN ***
jew1jaw: shows [9h 9d] (a pair of Nines)
KIDNIC: mucks hand 
jew1jaw collected $1.95 from pot
*** SUMMARY ***
Total pot $2 | Rake $0.05 
Board [2s 8s 6h Qd Ks]
Seat 1: jew1jaw (small blind) showed [9h 9d] and won ($1.95) with a pair of Nines
Seat 2: Skudero (big blind) folded on the Flop
Seat 3: KIDNIC mucked [Jd Ts]
Seat 4: buzgt2008 folded on the Flop
Seat 6: Tuwei168 folded before Flop (didn't bet)
Seat 7: pmags88 folded before Flop (didn't bet)
Seat 8: Dooley2005 folded before Flop (didn't bet)
Seat 9: Alameda22 (button) folded before Flop (didn't bet)



PokerStars Game #19980012862:  Hold'em No Limit ($0.10/$0.25) - 2008/08/28 - 23:59:54 (ET)
Table 'Vesta III' 9-max Seat #1 is the button
Seat 1: jew1jaw ($13.20 in chips) 
Seat 2: Skudero ($41.35 in chips) 
Seat 3: KIDNIC ($25.25 in chips) 
Seat 4: buzgt2008 ($14.75 in chips) 
Seat 6: Tuwei168 ($30.25 in chips) 
Seat 7: pmags88 ($23.95 in chips) 
Seat 8: Dooley2005 ($25.60 in chips) 
Seat 9: Alameda22 ($27.50 in chips) 
Skudero: posts small blind $0.10
KIDNIC: posts big blind $0.25
*** HOLE CARDS ***
Dealt to Alameda22 [3c Th]
buzgt2008: folds 
Tuwei168: folds 
pmags88: folds 
Dooley2005: folds 
Alameda22: folds 
jew1jaw: calls $0.25
Skudero: folds 
KIDNIC: checks 
*** FLOP *** [8d 4h 6h]
KIDNIC: checks 
jew1jaw: bets $0.25
KIDNIC: folds 
Uncalled bet ($0.25) returned to jew1jaw
jew1jaw collected $0.60 from pot
*** SUMMARY ***
Total pot $0.60 | Rake $0 
Board [8d 4h 6h]
Seat 1: jew1jaw (button) collected ($0.60)
Seat 2: Skudero (small blind) folded before Flop
Seat 3: KIDNIC (big blind) folded on the Flop
Seat 4: buzgt2008 folded before Flop (didn't bet)
Seat 6: Tuwei168 folded before Flop (didn't bet)
Seat 7: pmags88 folded before Flop (didn't bet)
Seat 8: Dooley2005 folded before Flop (didn't bet)
Seat 9: Alameda22 folded before Flop (didn't bet)



