PokerStars Game #20094946732:  Hold'em No Limit ($0.10/$0.25) - 2008/09/02 14:57:10 ET
Table 'Varsavia' 9-max Seat #7 is the button
Seat 1: AtrY ($29.90 in chips) 
Seat 3: bigtiger4 ($40.70 in chips) 
Seat 4: Weegolo ($10 in chips) 
Seat 6: AKl3gi0n ($7.05 in chips) 
Seat 7: bohry ($21.85 in chips) 
Seat 8: deputy2002 ($10.50 in chips) 
Seat 9: Alameda22 ($25 in chips) 
deputy2002: posts small blind $0.10
Alameda22: posts big blind $0.25
Headpro76: sits out 
Weegolo: posts big blind $0.25
Hitdark: sits out 
AKl3gi0n: posts small & big blinds $0.35
*** HOLE CARDS ***
Dealt to Alameda22 [Kc Qs]
AtrY: folds 
bigtiger4: calls $0.25
Weegolo: checks 
AKl3gi0n: checks 
bohry: folds 
deputy2002: calls $0.15
Alameda22: checks 
*** FLOP *** [Ad Kh 9h]
deputy2002: checks 
Alameda22: checks 
bigtiger4: checks 
Weegolo: bets $0.25
AKl3gi0n: folds 
deputy2002: calls $0.25
Alameda22: folds 
bigtiger4: folds 
*** TURN *** [Ad Kh 9h] [8s]
deputy2002: checks 
Weegolo: checks 
*** RIVER *** [Ad Kh 9h 8s] [4h]
deputy2002: bets $1.25
Weegolo: folds 
Uncalled bet ($1.25) returned to deputy2002
deputy2002 collected $1.80 from pot
deputy2002: doesn't show hand 
*** SUMMARY ***
Total pot $1.85 | Rake $0.05 
Board [Ad Kh 9h 8s 4h]
Seat 1: AtrY folded before Flop (didn't bet)
Seat 3: bigtiger4 folded on the Flop
Seat 4: Weegolo folded on the River
Seat 6: AKl3gi0n folded on the Flop
Seat 7: bohry (button) folded before Flop (didn't bet)
Seat 8: deputy2002 (small blind) collected ($1.80)
Seat 9: Alameda22 (big blind) folded on the Flop



PokerStars Game #20094976394:  Hold'em No Limit ($0.10/$0.25) - 2008/09/02 14:58:23 ET
Table 'Varsavia' 9-max Seat #8 is the button
Seat 1: AtrY ($29.90 in chips) 
Seat 3: bigtiger4 ($40.45 in chips) 
Seat 4: Weegolo ($9.50 in chips) 
Seat 6: AKl3gi0n ($6.70 in chips) 
Seat 7: bohry ($21.85 in chips) 
Seat 8: deputy2002 ($11.80 in chips) 
Seat 9: Alameda22 ($24.75 in chips) 
Alameda22: posts small blind $0.10
AtrY: posts big blind $0.25
Headpro76: sits out 
Hitdark: sits out 
*** HOLE CARDS ***
Dealt to Alameda22 [6d 3h]
bigtiger4: folds 
Weegolo: calls $0.25
AKl3gi0n: calls $0.25
bohry has timed out
bohry: folds 
bohry is sitting out
deputy2002: folds 
Alameda22: folds 
AtrY: raises $1.25 to $1.50
Weegolo: folds 
AKl3gi0n: folds 
Uncalled bet ($1.25) returned to AtrY
AtrY collected $0.85 from pot
AtrY: doesn't show hand 
*** SUMMARY ***
Total pot $0.85 | Rake $0 
Seat 1: AtrY (big blind) collected ($0.85)
Seat 3: bigtiger4 folded before Flop (didn't bet)
Seat 4: Weegolo folded before Flop
Seat 6: AKl3gi0n folded before Flop
Seat 7: bohry folded before Flop (didn't bet)
Seat 8: deputy2002 (button) folded before Flop (didn't bet)
Seat 9: Alameda22 (small blind) folded before Flop



PokerStars Game #20095013440:  Hold'em No Limit ($0.10/$0.25) - 2008/09/02 14:59:56 ET
Table 'Varsavia' 9-max Seat #9 is the button
Seat 1: AtrY ($30.50 in chips) 
Seat 2: Headpro76 ($25 in chips) 
Seat 3: bigtiger4 ($40.45 in chips) 
Seat 4: Weegolo ($9.25 in chips) 
Seat 6: AKl3gi0n ($6.45 in chips) 
Seat 8: deputy2002 ($11.80 in chips) 
Seat 9: Alameda22 ($24.65 in chips) 
AtrY: posts small blind $0.10
Headpro76: posts big blind $0.25
Hitdark: sits out 
*** HOLE CARDS ***
Dealt to Alameda22 [Ac 5c]
bigtiger4: calls $0.25
Weegolo: folds 
AKl3gi0n: folds 
deputy2002: calls $0.25
Alameda22: folds 
AtrY: folds 
Headpro76: checks 
*** FLOP *** [5h 2c 6h]
Headpro76: checks 
bigtiger4: bets $0.50
deputy2002: calls $0.50
Headpro76: folds 
*** TURN *** [5h 2c 6h] [Js]
bigtiger4: bets $1
deputy2002: calls $1
*** RIVER *** [5h 2c 6h Js] [Kh]
bigtiger4: bets $5
deputy2002: raises $5 to $10
bigtiger4: folds 
Uncalled bet ($5) returned to deputy2002
deputy2002 collected $13.20 from pot
deputy2002: doesn't show hand 
*** SUMMARY ***
Total pot $13.85 | Rake $0.65 
Board [5h 2c 6h Js Kh]
Seat 1: AtrY (small blind) folded before Flop
Seat 2: Headpro76 (big blind) folded on the Flop
Seat 3: bigtiger4 folded on the River
Seat 4: Weegolo folded before Flop (didn't bet)
Seat 6: AKl3gi0n folded before Flop (didn't bet)
Seat 8: deputy2002 collected ($13.20)
Seat 9: Alameda22 (button) folded before Flop (didn't bet)



PokerStars Game #20095062294:  Hold'em No Limit ($0.10/$0.25) - 2008/09/02 15:01:49 ET
Table 'Varsavia' 9-max Seat #1 is the button
Seat 1: AtrY ($30.40 in chips) 
Seat 2: Headpro76 ($24.75 in chips) 
Seat 3: bigtiger4 ($33.70 in chips) 
Seat 4: Weegolo ($9.25 in chips) 
Seat 6: AKl3gi0n ($6.45 in chips) 
Seat 8: deputy2002 ($18.25 in chips) 
Seat 9: Alameda22 ($24.65 in chips) 
Headpro76: posts small blind $0.10
bigtiger4: posts big blind $0.25
Hitdark: sits out 
*** HOLE CARDS ***
Dealt to Alameda22 [7d Th]
Weegolo: folds 
AKl3gi0n: folds 
deputy2002: folds 
bohry is disconnected 
Alameda22: folds 
Hitdark is sitting out
AtrY: folds 
Headpro76: folds 
Uncalled bet ($0.15) returned to bigtiger4
bigtiger4 collected $0.20 from pot
bigtiger4: doesn't show hand 
*** SUMMARY ***
Total pot $0.20 | Rake $0 
Seat 1: AtrY (button) folded before Flop (didn't bet)
Seat 2: Headpro76 (small blind) folded before Flop
Seat 3: bigtiger4 (big blind) collected ($0.20)
Seat 4: Weegolo folded before Flop (didn't bet)
Seat 6: AKl3gi0n folded before Flop (didn't bet)
Seat 8: deputy2002 folded before Flop (didn't bet)
Seat 9: Alameda22 folded before Flop (didn't bet)



PokerStars Game #20095076021:  Hold'em No Limit ($0.10/$0.25) - 2008/09/02 15:02:22 ET
Table 'Varsavia' 9-max Seat #2 is the button
Seat 1: AtrY ($30.40 in chips) 
Seat 2: Headpro76 ($24.65 in chips) 
Seat 3: bigtiger4 ($33.80 in chips) 
Seat 4: Weegolo ($9.25 in chips) 
Seat 6: AKl3gi0n ($6.45 in chips) 
Seat 8: deputy2002 ($18.25 in chips) 
Seat 9: Alameda22 ($24.65 in chips) 
bigtiger4: posts small blind $0.10
Weegolo: posts big blind $0.25
*** HOLE CARDS ***
Dealt to Alameda22 [Kh 7d]
AKl3gi0n: folds 
deputy2002: folds 
Alameda22: folds 
AtrY: raises $0.75 to $1
Headpro76: calls $1
bigtiger4: folds 
Weegolo: folds 
*** FLOP *** [2d Th 6s]
AtrY: bets $1.50
Headpro76: folds 
Uncalled bet ($1.50) returned to AtrY
AtrY collected $2.25 from pot
AtrY: doesn't show hand 
*** SUMMARY ***
Total pot $2.35 | Rake $0.10 
Board [2d Th 6s]
Seat 1: AtrY collected ($2.25)
Seat 2: Headpro76 (button) folded on the Flop
Seat 3: bigtiger4 (small blind) folded before Flop
Seat 4: Weegolo (big blind) folded before Flop
Seat 6: AKl3gi0n folded before Flop (didn't bet)
Seat 8: deputy2002 folded before Flop (didn't bet)
Seat 9: Alameda22 folded before Flop (didn't bet)



PokerStars Game #20095100266:  Hold'em No Limit ($0.10/$0.25) - 2008/09/02 15:03:19 ET
Table 'Varsavia' 9-max Seat #3 is the button
Seat 1: AtrY ($31.65 in chips) 
Seat 2: Headpro76 ($23.65 in chips) 
Seat 3: bigtiger4 ($33.70 in chips) 
Seat 4: Weegolo ($9 in chips) 
Seat 6: AKl3gi0n ($6.45 in chips) 
Seat 8: deputy2002 ($18.25 in chips) 
Seat 9: Alameda22 ($24.65 in chips) 
Weegolo: posts small blind $0.10
AKl3gi0n: posts big blind $0.25
*** HOLE CARDS ***
Dealt to Alameda22 [Jh Jc]
deputy2002: raises $0.50 to $0.75
Alameda22: calls $0.75
AtrY: folds 
Headpro76: folds 
bigtiger4: calls $0.75
Weegolo: folds 
AKl3gi0n: folds 
*** FLOP *** [Kh 3d 2c]
deputy2002: checks 
Alameda22: checks 
bigtiger4: checks 
*** TURN *** [Kh 3d 2c] [Tc]
deputy2002: bets $0.25
Alameda22: calls $0.25
bigtiger4: calls $0.25
*** RIVER *** [Kh 3d 2c Tc] [7d]
deputy2002: checks 
Alameda22: checks 
bigtiger4: checks 
*** SHOW DOWN ***
deputy2002: shows [Qc Ad] (high card Ace)
Alameda22: shows [Jh Jc] (a pair of Jacks)
bigtiger4: mucks hand 
Alameda22 collected $3.20 from pot
*** SUMMARY ***
Total pot $3.35 | Rake $0.15 
Board [Kh 3d 2c Tc 7d]
Seat 1: AtrY folded before Flop (didn't bet)
Seat 2: Headpro76 folded before Flop (didn't bet)
Seat 3: bigtiger4 (button) mucked [Td Qh]
Seat 4: Weegolo (small blind) folded before Flop
Seat 6: AKl3gi0n (big blind) folded before Flop
Seat 8: deputy2002 showed [Qc Ad] and lost with high card Ace
Seat 9: Alameda22 showed [Jh Jc] and won ($3.20) with a pair of Jacks



PokerStars Game #20095128872:  Hold'em No Limit ($0.10/$0.25) - 2008/09/02 15:04:25 ET
Table 'Varsavia' 9-max Seat #4 is the button
Seat 1: AtrY ($31.65 in chips) 
Seat 2: Headpro76 ($23.65 in chips) 
Seat 3: bigtiger4 ($32.70 in chips) 
Seat 4: Weegolo ($8.90 in chips) 
Seat 8: deputy2002 ($17.25 in chips) 
Seat 9: Alameda22 ($26.85 in chips) 
AKl3gi0n has timed out
AKl3gi0n: is sitting out 
deputy2002: posts small blind $0.10
Alameda22: posts big blind $0.25
*** HOLE CARDS ***
Dealt to Alameda22 [6d 2h]
AtrY: folds 
AKl3gi0n has returned
Headpro76: folds 
bigtiger4: calls $0.25
Weegolo: calls $0.25
deputy2002: calls $0.15
Alameda22: checks 
*** FLOP *** [Td 6h 9h]
deputy2002: bets $1
Alameda22: folds 
bigtiger4: folds 
Weegolo: folds 
Uncalled bet ($1) returned to deputy2002
deputy2002 collected $0.95 from pot
deputy2002: doesn't show hand 
*** SUMMARY ***
Total pot $1 | Rake $0.05 
Board [Td 6h 9h]
Seat 1: AtrY folded before Flop (didn't bet)
Seat 2: Headpro76 folded before Flop (didn't bet)
Seat 3: bigtiger4 folded on the Flop
Seat 4: Weegolo (button) folded on the Flop
Seat 8: deputy2002 (small blind) collected ($0.95)
Seat 9: Alameda22 (big blind) folded on the Flop



PokerStars Game #20095161270:  Hold'em No Limit ($0.10/$0.25) - 2008/09/02 15:05:42 ET
Table 'Varsavia' 9-max Seat #8 is the button
Seat 1: AtrY ($31.65 in chips) 
Seat 2: Headpro76 ($23.65 in chips) 
Seat 3: bigtiger4 ($32.45 in chips) 
Seat 4: Weegolo ($8.65 in chips) 
Seat 8: deputy2002 ($17.95 in chips) 
Seat 9: Alameda22 ($26.60 in chips) 
Alameda22: posts small blind $0.10
AtrY: posts big blind $0.25
AKl3gi0n: is sitting out 
*** HOLE CARDS ***
Dealt to Alameda22 [3c 4h]
AKl3gi0n has returned
Headpro76: calls $0.25
bigtiger4: calls $0.25
Weegolo: folds 
deputy2002: folds 
Alameda22: folds 
AtrY: checks 
*** FLOP *** [5c Jc 7s]
AtrY: checks 
Headpro76: checks 
bigtiger4: checks 
*** TURN *** [5c Jc 7s] [Jh]
AtrY: bets $0.75
Headpro76: folds 
bigtiger4: calls $0.75
*** RIVER *** [5c Jc 7s Jh] [Qd]
AtrY: bets $1.50
bigtiger4: calls $1.50
*** SHOW DOWN ***
AtrY: shows [9c Jd] (three of a kind, Jacks)
bigtiger4: mucks hand 
AtrY collected $5.10 from pot
*** SUMMARY ***
Total pot $5.35 | Rake $0.25 
Board [5c Jc 7s Jh Qd]
Seat 1: AtrY (big blind) showed [9c Jd] and won ($5.10) with three of a kind, Jacks
Seat 2: Headpro76 folded on the Turn
Seat 3: bigtiger4 mucked [5h 6s]
Seat 4: Weegolo folded before Flop (didn't bet)
Seat 8: deputy2002 (button) folded before Flop (didn't bet)
Seat 9: Alameda22 (small blind) folded before Flop



PokerStars Game #20095189967:  Hold'em No Limit ($0.10/$0.25) - 2008/09/02 15:06:50 ET
Table 'Varsavia' 9-max Seat #9 is the button
Seat 1: AtrY ($34.25 in chips) 
Seat 2: Headpro76 ($23.40 in chips) 
Seat 3: bigtiger4 ($29.95 in chips) 
Seat 4: Weegolo ($8.65 in chips) 
Seat 6: AKl3gi0n ($6.20 in chips) 
Seat 8: deputy2002 ($17.95 in chips) 
Seat 9: Alameda22 ($26.50 in chips) 
AtrY: posts small blind $0.10
Headpro76: posts big blind $0.25
AKl3gi0n: posts small blind $0.10
*** HOLE CARDS ***
Dealt to Alameda22 [Kc Th]
bigtiger4: calls $0.25
Weegolo: folds 
AKl3gi0n: calls $0.25
deputy2002: folds 
Alameda22: folds 
AtrY: folds 
Headpro76: checks 
*** FLOP *** [2c Ad 6d]
Headpro76: checks 
bigtiger4: checks 
AKl3gi0n: checks 
*** TURN *** [2c Ad 6d] [Jc]
Headpro76: checks 
bigtiger4: checks 
AKl3gi0n: checks 
*** RIVER *** [2c Ad 6d Jc] [Ah]
Headpro76: checks 
bigtiger4: checks 
AKl3gi0n: checks 
*** SHOW DOWN ***
Headpro76: shows [Kd Qc] (a pair of Aces)
bigtiger4: mucks hand 
AKl3gi0n: shows [8s 8d] (two pair, Aces and Eights)
AKl3gi0n collected $0.95 from pot
*** SUMMARY ***
Total pot $0.95 | Rake $0 
Board [2c Ad 6d Jc Ah]
Seat 1: AtrY (small blind) folded before Flop
Seat 2: Headpro76 (big blind) showed [Kd Qc] and lost with a pair of Aces
Seat 3: bigtiger4 mucked [7h Qd]
Seat 4: Weegolo folded before Flop (didn't bet)
Seat 6: AKl3gi0n showed [8s 8d] and won ($0.95) with two pair, Aces and Eights
Seat 8: deputy2002 folded before Flop (didn't bet)
Seat 9: Alameda22 (button) folded before Flop (didn't bet)



PokerStars Game #20095214655:  Hold'em No Limit ($0.10/$0.25) - 2008/09/02 15:07:48 ET
Table 'Varsavia' 9-max Seat #1 is the button
Seat 1: AtrY ($34.15 in chips) 
Seat 2: Headpro76 ($23.15 in chips) 
Seat 3: bigtiger4 ($29.70 in chips) 
Seat 4: Weegolo ($8.65 in chips) 
Seat 6: AKl3gi0n ($6.80 in chips) 
Seat 8: deputy2002 ($17.95 in chips) 
Seat 9: Alameda22 ($26.50 in chips) 
Headpro76: posts small blind $0.10
bigtiger4: posts big blind $0.25
*** HOLE CARDS ***
Dealt to Alameda22 [4d 6h]
Weegolo: calls $0.25
AKl3gi0n: folds 
deputy2002: calls $0.25
Alameda22: folds 
AtrY: folds 
Headpro76: folds 
bigtiger4: checks 
*** FLOP *** [9c Kc 9h]
bigtiger4: checks 
Weegolo: checks 
deputy2002: bets $0.75
bigtiger4: calls $0.75
Weegolo: folds 
*** TURN *** [9c Kc 9h] [5h]
bigtiger4: checks 
deputy2002: bets $1.50
bigtiger4: raises $1.50 to $3
deputy2002: raises $1.50 to $4.50
bigtiger4: raises $5.50 to $10
deputy2002: folds 
Uncalled bet ($5.50) returned to bigtiger4
bigtiger4 collected $10.80 from pot
bigtiger4: doesn't show hand 
*** SUMMARY ***
Total pot $11.35 | Rake $0.55 
Board [9c Kc 9h 5h]
Seat 1: AtrY (button) folded before Flop (didn't bet)
Seat 2: Headpro76 (small blind) folded before Flop
Seat 3: bigtiger4 (big blind) collected ($10.80)
Seat 4: Weegolo folded on the Flop
Seat 6: AKl3gi0n folded before Flop (didn't bet)
Seat 8: deputy2002 folded on the Turn
Seat 9: Alameda22 folded before Flop (didn't bet)



PokerStars Game #20095257272:  Hold'em No Limit ($0.10/$0.25) - 2008/09/02 15:09:30 ET
Table 'Varsavia' 9-max Seat #2 is the button
Seat 1: AtrY ($34.15 in chips) 
Seat 2: Headpro76 ($23.05 in chips) 
Seat 3: bigtiger4 ($35 in chips) 
Seat 4: Weegolo ($8.40 in chips) 
Seat 6: AKl3gi0n ($6.80 in chips) 
Seat 8: deputy2002 ($12.45 in chips) 
Seat 9: Alameda22 ($26.50 in chips) 
bigtiger4: posts small blind $0.10
Weegolo: posts big blind $0.25
*** HOLE CARDS ***
Dealt to Alameda22 [Qc 9c]
AKl3gi0n: folds 
deputy2002: folds 
Alameda22: folds 
AtrY: folds 
Headpro76: calls $0.25
bigtiger4: calls $0.15
Weegolo: checks 
*** FLOP *** [Js Th 8h]
bigtiger4: checks 
Weegolo: checks 
Headpro76: bets $0.75
bigtiger4: folds 
Weegolo: folds 
Uncalled bet ($0.75) returned to Headpro76
Headpro76 collected $0.75 from pot
*** SUMMARY ***
Total pot $0.75 | Rake $0 
Board [Js Th 8h]
Seat 1: AtrY folded before Flop (didn't bet)
Seat 2: Headpro76 (button) collected ($0.75)
Seat 3: bigtiger4 (small blind) folded on the Flop
Seat 4: Weegolo (big blind) folded on the Flop
Seat 6: AKl3gi0n folded before Flop (didn't bet)
Seat 8: deputy2002 folded before Flop (didn't bet)
Seat 9: Alameda22 folded before Flop (didn't bet)



PokerStars Game #20095285960:  Hold'em No Limit ($0.10/$0.25) - 2008/09/02 15:10:39 ET
Table 'Varsavia' 9-max Seat #3 is the button
Seat 1: AtrY ($34.15 in chips) 
Seat 2: Headpro76 ($23.55 in chips) 
Seat 3: bigtiger4 ($34.75 in chips) 
Seat 4: Weegolo ($8.15 in chips) 
Seat 6: AKl3gi0n ($6.80 in chips) 
Seat 8: deputy2002 ($12.45 in chips) 
Seat 9: Alameda22 ($26.50 in chips) 
Weegolo: posts small blind $0.10
AKl3gi0n: posts big blind $0.25
*** HOLE CARDS ***
Dealt to Alameda22 [Tc 6s]
deputy2002: folds 
Alameda22: folds 
AtrY: folds 
Headpro76: calls $0.25
bigtiger4: calls $0.25
Weegolo: calls $0.15
AKl3gi0n: checks 
*** FLOP *** [7c Ah 4d]
Hitdark leaves the table
Weegolo: checks 
Kukoc69 joins the table at seat #5 
AKl3gi0n: checks 
Headpro76: checks 
bigtiger4: checks 
*** TURN *** [7c Ah 4d] [Ac]
Weegolo: checks 
AKl3gi0n: checks 
Headpro76: checks 
bigtiger4: bets $1
Weegolo: folds 
AKl3gi0n: folds 
Headpro76: folds 
Uncalled bet ($1) returned to bigtiger4
bigtiger4 collected $0.95 from pot
bigtiger4: doesn't show hand 
*** SUMMARY ***
Total pot $1 | Rake $0.05 
Board [7c Ah 4d Ac]
Seat 1: AtrY folded before Flop (didn't bet)
Seat 2: Headpro76 folded on the Turn
Seat 3: bigtiger4 (button) collected ($0.95)
Seat 4: Weegolo (small blind) folded on the Turn
Seat 6: AKl3gi0n (big blind) folded on the Turn
Seat 8: deputy2002 folded before Flop (didn't bet)
Seat 9: Alameda22 folded before Flop (didn't bet)



PokerStars Game #20095319122:  Hold'em No Limit ($0.10/$0.25) - 2008/09/02 15:11:59 ET
Table 'Varsavia' 9-max Seat #4 is the button
Seat 1: AtrY ($34.15 in chips) 
Seat 2: Headpro76 ($23.30 in chips) 
Seat 3: bigtiger4 ($35.45 in chips) 
Seat 4: Weegolo ($7.90 in chips) 
Seat 6: AKl3gi0n ($6.55 in chips) 
Seat 9: Alameda22 ($26.50 in chips) 
Kukoc69 will be allowed to play after the button
AKl3gi0n: posts small blind $0.10
deputy2002: is sitting out 
Alameda22: posts big blind $0.25
*** HOLE CARDS ***
Dealt to Alameda22 [5s 3h]
deputy2002 leaves the table
bohry was removed from the table for failing to post
AtrY: folds 
Headpro76: folds 
bigtiger4: calls $0.25
Weegolo: folds 
Ewax joins the table at seat #8 
AKl3gi0n: folds 
Alameda22: checks 
*** FLOP *** [Qc 4d 6h]
dawinci80 joins the table at seat #7 
Alameda22: checks 
bigtiger4: checks 
*** TURN *** [Qc 4d 6h] [8c]
Alameda22: checks 
bigtiger4: bets $0.25
Alameda22: folds 
Uncalled bet ($0.25) returned to bigtiger4
bigtiger4 collected $0.60 from pot
bigtiger4: doesn't show hand 
*** SUMMARY ***
Total pot $0.60 | Rake $0 
Board [Qc 4d 6h 8c]
Seat 1: AtrY folded before Flop (didn't bet)
Seat 2: Headpro76 folded before Flop (didn't bet)
Seat 3: bigtiger4 collected ($0.60)
Seat 4: Weegolo (button) folded before Flop (didn't bet)
Seat 6: AKl3gi0n (small blind) folded before Flop
Seat 9: Alameda22 (big blind) folded on the Turn



PokerStars Game #20095342158:  Hold'em No Limit ($0.10/$0.25) - 2008/09/02 15:12:54 ET
Table 'Varsavia' 9-max Seat #6 is the button
Seat 1: AtrY ($34.15 in chips) 
Seat 2: Headpro76 ($23.30 in chips) 
Seat 3: bigtiger4 ($35.80 in chips) 
Seat 4: Weegolo ($7.90 in chips) 
Seat 6: AKl3gi0n ($6.45 in chips) 
Seat 9: Alameda22 ($26.25 in chips) 
dawinci80 will be allowed to play after the button
Ewax will be allowed to play after the button
Alameda22: posts small blind $0.10
AtrY: posts big blind $0.25
Kukoc69: sits out 
*** HOLE CARDS ***
Dealt to Alameda22 [2c 8d]
Headpro76: folds 
bigtiger4: calls $0.25
Weegolo: folds 
AKl3gi0n: folds 
Alameda22: folds 
AtrY: checks 
*** FLOP *** [Tc 3h Jd]
AtrY: checks 
bigtiger4: bets $0.25
AtrY: folds 
Uncalled bet ($0.25) returned to bigtiger4
bigtiger4 collected $0.60 from pot
*** SUMMARY ***
Total pot $0.60 | Rake $0 
Board [Tc 3h Jd]
Seat 1: AtrY (big blind) folded on the Flop
Seat 2: Headpro76 folded before Flop (didn't bet)
Seat 3: bigtiger4 collected ($0.60)
Seat 4: Weegolo folded before Flop (didn't bet)
Seat 6: AKl3gi0n (button) folded before Flop (didn't bet)
Seat 9: Alameda22 (small blind) folded before Flop



PokerStars Game #20095357965:  Hold'em No Limit ($0.10/$0.25) - 2008/09/02 15:13:33 ET
Table 'Varsavia' 9-max Seat #9 is the button
Seat 1: AtrY ($33.90 in chips) 
Seat 2: Headpro76 ($23.30 in chips) 
Seat 3: bigtiger4 ($36.15 in chips) 
Seat 4: Weegolo ($7.90 in chips) 
Seat 6: AKl3gi0n ($6.45 in chips) 
Seat 7: dawinci80 ($5 in chips) 
Seat 9: Alameda22 ($26.15 in chips) 
AtrY: posts small blind $0.10
Headpro76: posts big blind $0.25
Kukoc69: sits out 
dawinci80: posts big blind $0.25
Ewax: sits out 
*** HOLE CARDS ***
Dealt to Alameda22 [8c Td]
bigtiger4: calls $0.25
Weegolo: folds 
AKl3gi0n: folds 
dawinci80: checks 
Alameda22: folds 
AtrY: folds 
Headpro76: checks 
*** FLOP *** [Jd Qs Ks]
Headpro76: checks 
bigtiger4: checks 
dawinci80: bets $0.25
Headpro76: calls $0.25
bigtiger4: folds 
*** TURN *** [Jd Qs Ks] [3s]
Headpro76: checks 
dawinci80: bets $0.75
Headpro76: calls $0.75
*** RIVER *** [Jd Qs Ks 3s] [7s]
Headpro76: checks 
dawinci80: bets $1.75
Headpro76: folds 
Uncalled bet ($1.75) returned to dawinci80
dawinci80 collected $2.75 from pot
*** SUMMARY ***
Total pot $2.85 | Rake $0.10 
Board [Jd Qs Ks 3s 7s]
Seat 1: AtrY (small blind) folded before Flop
Seat 2: Headpro76 (big blind) folded on the River
Seat 3: bigtiger4 folded on the Flop
Seat 4: Weegolo folded before Flop (didn't bet)
Seat 6: AKl3gi0n folded before Flop (didn't bet)
Seat 7: dawinci80 collected ($2.75)
Seat 9: Alameda22 (button) folded before Flop (didn't bet)



PokerStars Game #20095389309:  Hold'em No Limit ($0.10/$0.25) - 2008/09/02 15:14:50 ET
Table 'Varsavia' 9-max Seat #1 is the button
Seat 1: AtrY ($33.80 in chips) 
Seat 2: Headpro76 ($22.05 in chips) 
Seat 3: bigtiger4 ($35.90 in chips) 
Seat 4: Weegolo ($7.90 in chips) 
Seat 6: AKl3gi0n ($6.45 in chips) 
Seat 7: dawinci80 ($6.50 in chips) 
Seat 9: Alameda22 ($26.15 in chips) 
Headpro76: posts small blind $0.10
bigtiger4: posts big blind $0.25
Kukoc69: sits out 
Ewax: sits out 
*** HOLE CARDS ***
Dealt to Alameda22 [Kc Kh]
Weegolo: raises $0.25 to $0.50
AKl3gi0n: folds 
dawinci80: folds 
Alameda22: raises $1.50 to $2
AtrY: folds 
Headpro76: folds 
bigtiger4: folds 
Weegolo: calls $1.50
*** FLOP *** [Ts 5c 7d]
Weegolo: checks 
Alameda22: bets $2.75
Weegolo: folds 
Uncalled bet ($2.75) returned to Alameda22
Alameda22 collected $4.15 from pot
Alameda22: doesn't show hand 
*** SUMMARY ***
Total pot $4.35 | Rake $0.20 
Board [Ts 5c 7d]
Seat 1: AtrY (button) folded before Flop (didn't bet)
Seat 2: Headpro76 (small blind) folded before Flop
Seat 3: bigtiger4 (big blind) folded before Flop
Seat 4: Weegolo folded on the Flop
Seat 6: AKl3gi0n folded before Flop (didn't bet)
Seat 7: dawinci80 folded before Flop (didn't bet)
Seat 9: Alameda22 collected ($4.15)



PokerStars Game #20095410883:  Hold'em No Limit ($0.10/$0.25) - 2008/09/02 15:15:45 ET
Table 'Varsavia' 9-max Seat #2 is the button
Seat 1: AtrY ($33.80 in chips) 
Seat 2: Headpro76 ($21.95 in chips) 
Seat 3: bigtiger4 ($35.65 in chips) 
Seat 4: Weegolo ($5.90 in chips) 
Seat 6: AKl3gi0n ($6.45 in chips) 
Seat 7: dawinci80 ($6.50 in chips) 
Seat 9: Alameda22 ($28.30 in chips) 
bigtiger4: posts small blind $0.10
Weegolo: posts big blind $0.25
Kukoc69: sits out 
Ewax: sits out 
*** HOLE CARDS ***
Dealt to Alameda22 [Kh Jh]
AKl3gi0n: folds 
dawinci80: folds 
Alameda22: folds 
AtrY: folds 
Headpro76: folds 
bigtiger4: calls $0.15
Weegolo: checks 
*** FLOP *** [Ac 8s Ks]
bigtiger4: checks 
Weegolo: bets $0.25
bigtiger4: calls $0.25
*** TURN *** [Ac 8s Ks] [9d]
bigtiger4: checks 
Weegolo: checks 
*** RIVER *** [Ac 8s Ks 9d] [Ts]
bigtiger4: checks 
Weegolo: checks 
*** SHOW DOWN ***
bigtiger4: shows [3d 3s] (a pair of Threes)
Weegolo: shows [Jc Tc] (a pair of Tens)
Weegolo collected $0.95 from pot
*** SUMMARY ***
Total pot $1 | Rake $0.05 
Board [Ac 8s Ks 9d Ts]
Seat 1: AtrY folded before Flop (didn't bet)
Seat 2: Headpro76 (button) folded before Flop (didn't bet)
Seat 3: bigtiger4 (small blind) showed [3d 3s] and lost with a pair of Threes
Seat 4: Weegolo (big blind) showed [Jc Tc] and won ($0.95) with a pair of Tens
Seat 6: AKl3gi0n folded before Flop (didn't bet)
Seat 7: dawinci80 folded before Flop (didn't bet)
Seat 9: Alameda22 folded before Flop (didn't bet)



PokerStars Game #20095430799:  Hold'em No Limit ($0.10/$0.25) - 2008/09/02 15:16:32 ET
Table 'Varsavia' 9-max Seat #3 is the button
Seat 1: AtrY ($33.80 in chips) 
Seat 2: Headpro76 ($21.95 in chips) 
Seat 3: bigtiger4 ($35.15 in chips) 
Seat 4: Weegolo ($6.35 in chips) 
Seat 5: Kukoc69 ($25 in chips) 
Seat 6: AKl3gi0n ($6.45 in chips) 
Seat 7: dawinci80 ($6.50 in chips) 
Seat 9: Alameda22 ($28.30 in chips) 
Weegolo: posts small blind $0.10
Kukoc69: posts big blind $0.25
Ewax: sits out 
*** HOLE CARDS ***
Dealt to Alameda22 [Qc 9s]
AKl3gi0n: folds 
dawinci80: folds 
Alameda22: folds 
AtrY: folds 
Headpro76: folds 
bigtiger4: folds 
Weegolo: calls $0.15
Kukoc69: checks 
*** FLOP *** [9c 4s Ts]
Weegolo: checks 
Kukoc69: bets $0.50
Weegolo: folds 
Uncalled bet ($0.50) returned to Kukoc69
Kukoc69 collected $0.50 from pot
Kukoc69: doesn't show hand 
*** SUMMARY ***
Total pot $0.50 | Rake $0 
Board [9c 4s Ts]
Seat 1: AtrY folded before Flop (didn't bet)
Seat 2: Headpro76 folded before Flop (didn't bet)
Seat 3: bigtiger4 (button) folded before Flop (didn't bet)
Seat 4: Weegolo (small blind) folded on the Flop
Seat 5: Kukoc69 (big blind) collected ($0.50)
Seat 6: AKl3gi0n folded before Flop (didn't bet)
Seat 7: dawinci80 folded before Flop (didn't bet)
Seat 9: Alameda22 folded before Flop (didn't bet)



PokerStars Game #20095455727:  Hold'em No Limit ($0.10/$0.25) - 2008/09/02 15:17:31 ET
Table 'Varsavia' 9-max Seat #4 is the button
Seat 1: AtrY ($33.80 in chips) 
Seat 2: Headpro76 ($21.95 in chips) 
Seat 3: bigtiger4 ($35.15 in chips) 
Seat 4: Weegolo ($6.10 in chips) 
Seat 5: Kukoc69 ($25.25 in chips) 
Seat 6: AKl3gi0n ($6.45 in chips) 
Seat 7: dawinci80 ($6.50 in chips) 
Seat 9: Alameda22 ($28.30 in chips) 
Kukoc69: posts small blind $0.10
AKl3gi0n: posts big blind $0.25
Ewax: sits out 
*** HOLE CARDS ***
Dealt to Alameda22 [6c Jh]
dawinci80: folds 
Alameda22: folds 
AtrY: folds 
Headpro76: folds 
bigtiger4: raises $0.50 to $0.75
Weegolo: folds 
Kukoc69: folds 
AKl3gi0n: folds 
Uncalled bet ($0.50) returned to bigtiger4
bigtiger4 collected $0.60 from pot
*** SUMMARY ***
Total pot $0.60 | Rake $0 
Seat 1: AtrY folded before Flop (didn't bet)
Seat 2: Headpro76 folded before Flop (didn't bet)
Seat 3: bigtiger4 collected ($0.60)
Seat 4: Weegolo (button) folded before Flop (didn't bet)
Seat 5: Kukoc69 (small blind) folded before Flop
Seat 6: AKl3gi0n (big blind) folded before Flop
Seat 7: dawinci80 folded before Flop (didn't bet)
Seat 9: Alameda22 folded before Flop (didn't bet)



PokerStars Game #20095469594:  Hold'em No Limit ($0.10/$0.25) - 2008/09/02 15:18:04 ET
Table 'Varsavia' 9-max Seat #5 is the button
Seat 1: AtrY ($33.80 in chips) 
Seat 2: Headpro76 ($21.95 in chips) 
Seat 3: bigtiger4 ($35.50 in chips) 
Seat 4: Weegolo ($6.10 in chips) 
Seat 5: Kukoc69 ($25.15 in chips) 
Seat 6: AKl3gi0n ($6.20 in chips) 
Seat 7: dawinci80 ($6.50 in chips) 
Seat 9: Alameda22 ($28.30 in chips) 
AKl3gi0n: posts small blind $0.10
dawinci80: posts big blind $0.25
Ewax: sits out 
*** HOLE CARDS ***
Dealt to Alameda22 [7d Ad]
Alameda22: folds 
AtrY: folds 
Headpro76: calls $0.25
bigtiger4: raises $0.25 to $0.50
Weegolo: folds 
Kukoc69: folds 
AKl3gi0n: calls $0.40
dawinci80: folds 
Headpro76: calls $0.25
*** FLOP *** [6h 4h Kh]
AKl3gi0n: bets $0.75
Headpro76: folds 
Headpro76 is sitting out
bigtiger4: folds 
Uncalled bet ($0.75) returned to AKl3gi0n
AKl3gi0n collected $1.70 from pot
AKl3gi0n: doesn't show hand 
*** SUMMARY ***
Total pot $1.75 | Rake $0.05 
Board [6h 4h Kh]
Seat 1: AtrY folded before Flop (didn't bet)
Seat 2: Headpro76 folded on the Flop
Seat 3: bigtiger4 folded on the Flop
Seat 4: Weegolo folded before Flop (didn't bet)
Seat 5: Kukoc69 (button) folded before Flop (didn't bet)
Seat 6: AKl3gi0n (small blind) collected ($1.70)
Seat 7: dawinci80 (big blind) folded before Flop
Seat 9: Alameda22 folded before Flop (didn't bet)



PokerStars Game #20095489007:  Hold'em No Limit ($0.10/$0.25) - 2008/09/02 15:18:51 ET
Table 'Varsavia' 9-max Seat #6 is the button
Seat 1: AtrY ($33.80 in chips) 
Seat 3: bigtiger4 ($35 in chips) 
Seat 4: Weegolo ($6.10 in chips) 
Seat 5: Kukoc69 ($25.15 in chips) 
Seat 6: AKl3gi0n ($7.40 in chips) 
Seat 7: dawinci80 ($6.25 in chips) 
Seat 8: Ewax ($25 in chips) 
Seat 9: Alameda22 ($28.30 in chips) 
dawinci80: posts small blind $0.10
Ewax: posts big blind $0.25
*** HOLE CARDS ***
Dealt to Alameda22 [5s 9h]
Alameda22: folds 
AtrY: raises $0.75 to $1
bigtiger4: folds 
Weegolo: folds 
Kukoc69: folds 
AKl3gi0n: folds 
dawinci80: folds 
Ewax: folds 
Uncalled bet ($0.75) returned to AtrY
AtrY collected $0.60 from pot
AtrY: doesn't show hand 
*** SUMMARY ***
Total pot $0.60 | Rake $0 
Seat 1: AtrY collected ($0.60)
Seat 3: bigtiger4 folded before Flop (didn't bet)
Seat 4: Weegolo folded before Flop (didn't bet)
Seat 5: Kukoc69 folded before Flop (didn't bet)
Seat 6: AKl3gi0n (button) folded before Flop (didn't bet)
Seat 7: dawinci80 (small blind) folded before Flop
Seat 8: Ewax (big blind) folded before Flop
Seat 9: Alameda22 folded before Flop (didn't bet)



PokerStars Game #20095506818:  Hold'em No Limit ($0.10/$0.25) - 2008/09/02 15:19:34 ET
Table 'Varsavia' 9-max Seat #7 is the button
Seat 1: AtrY ($34.15 in chips) 
Seat 3: bigtiger4 ($35 in chips) 
Seat 4: Weegolo ($6.10 in chips) 
Seat 5: Kukoc69 ($25.15 in chips) 
Seat 6: AKl3gi0n ($7.40 in chips) 
Seat 7: dawinci80 ($6.15 in chips) 
Seat 8: Ewax ($24.75 in chips) 
Seat 9: Alameda22 ($28.30 in chips) 
Ewax: posts small blind $0.10
Alameda22: posts big blind $0.25
*** HOLE CARDS ***
Dealt to Alameda22 [2c Qd]
AtrY: folds 
bigtiger4: calls $0.25
Weegolo: folds 
Kukoc69: folds 
AKl3gi0n: folds 
dawinci80: raises $0.50 to $0.75
Ewax: folds 
Alameda22: folds 
bigtiger4: calls $0.50
*** FLOP *** [2s 2h 9d]
bigtiger4: checks 
dawinci80: bets $0.75
bigtiger4: folds 
Uncalled bet ($0.75) returned to dawinci80
dawinci80 collected $1.80 from pot
*** SUMMARY ***
Total pot $1.85 | Rake $0.05 
Board [2s 2h 9d]
Seat 1: AtrY folded before Flop (didn't bet)
Seat 3: bigtiger4 folded on the Flop
Seat 4: Weegolo folded before Flop (didn't bet)
Seat 5: Kukoc69 folded before Flop (didn't bet)
Seat 6: AKl3gi0n folded before Flop (didn't bet)
Seat 7: dawinci80 (button) collected ($1.80)
Seat 8: Ewax (small blind) folded before Flop
Seat 9: Alameda22 (big blind) folded before Flop



PokerStars Game #20095531358:  Hold'em No Limit ($0.10/$0.25) - 2008/09/02 15:20:33 ET
Table 'Varsavia' 9-max Seat #8 is the button
Seat 1: AtrY ($34.15 in chips) 
Seat 3: bigtiger4 ($34.25 in chips) 
Seat 4: Weegolo ($6.10 in chips) 
Seat 5: Kukoc69 ($25.15 in chips) 
Seat 6: AKl3gi0n ($7.40 in chips) 
Seat 7: dawinci80 ($7.20 in chips) 
Seat 8: Ewax ($24.65 in chips) 
Seat 9: Alameda22 ($28.05 in chips) 
Alameda22: posts small blind $0.10
AtrY: posts big blind $0.25
*** HOLE CARDS ***
Dealt to Alameda22 [7h 8d]
bigtiger4: folds 
Weegolo: folds 
Kukoc69: folds 
AKl3gi0n: folds 
dawinci80: folds 
Ewax: folds 
Alameda22: folds 
Uncalled bet ($0.15) returned to AtrY
AtrY collected $0.20 from pot
AtrY: doesn't show hand 
*** SUMMARY ***
Total pot $0.20 | Rake $0 
Seat 1: AtrY (big blind) collected ($0.20)
Seat 3: bigtiger4 folded before Flop (didn't bet)
Seat 4: Weegolo folded before Flop (didn't bet)
Seat 5: Kukoc69 folded before Flop (didn't bet)
Seat 6: AKl3gi0n folded before Flop (didn't bet)
Seat 7: dawinci80 folded before Flop (didn't bet)
Seat 8: Ewax (button) folded before Flop (didn't bet)
Seat 9: Alameda22 (small blind) folded before Flop



PokerStars Game #20095542848:  Hold'em No Limit ($0.10/$0.25) - 2008/09/02 15:21:00 ET
Table 'Varsavia' 9-max Seat #9 is the button
Seat 1: AtrY ($34.25 in chips) 
Seat 3: bigtiger4 ($34.25 in chips) 
Seat 4: Weegolo ($6.10 in chips) 
Seat 5: Kukoc69 ($25.15 in chips) 
Seat 6: AKl3gi0n ($7.40 in chips) 
Seat 7: dawinci80 ($7.20 in chips) 
Seat 8: Ewax ($24.65 in chips) 
Seat 9: Alameda22 ($27.95 in chips) 
AtrY: posts small blind $0.10
bigtiger4: posts big blind $0.25
*** HOLE CARDS ***
Dealt to Alameda22 [5d Td]
Weegolo: folds 
Kukoc69: folds 
AKl3gi0n: folds 
dawinci80: folds 
Ewax: folds 
Alameda22: folds 
AtrY: folds 
Uncalled bet ($0.15) returned to bigtiger4
bigtiger4 collected $0.20 from pot
bigtiger4: doesn't show hand 
*** SUMMARY ***
Total pot $0.20 | Rake $0 
Seat 1: AtrY (small blind) folded before Flop
Seat 3: bigtiger4 (big blind) collected ($0.20)
Seat 4: Weegolo folded before Flop (didn't bet)
Seat 5: Kukoc69 folded before Flop (didn't bet)
Seat 6: AKl3gi0n folded before Flop (didn't bet)
Seat 7: dawinci80 folded before Flop (didn't bet)
Seat 8: Ewax folded before Flop (didn't bet)
Seat 9: Alameda22 (button) folded before Flop (didn't bet)



PokerStars Game #20095560892:  Hold'em No Limit ($0.10/$0.25) - 2008/09/02 15:21:43 ET
Table 'Varsavia' 9-max Seat #1 is the button
Seat 1: AtrY ($34.15 in chips) 
Seat 3: bigtiger4 ($34.35 in chips) 
Seat 4: Weegolo ($6.10 in chips) 
Seat 5: Kukoc69 ($25.15 in chips) 
Seat 6: AKl3gi0n ($7.40 in chips) 
Seat 7: dawinci80 ($7.20 in chips) 
Seat 8: Ewax ($24.65 in chips) 
Seat 9: Alameda22 ($27.95 in chips) 
bigtiger4: posts small blind $0.10
Weegolo: posts big blind $0.25
*** HOLE CARDS ***
Dealt to Alameda22 [6h 5h]
Kukoc69: folds 
AKl3gi0n: folds 
dawinci80: folds 
Ewax: folds 
Alameda22: folds 
AtrY: folds 
bigtiger4: calls $0.15
Weegolo: checks 
*** FLOP *** [Js 4d Kh]
bigtiger4: checks 
Weegolo: checks 
*** TURN *** [Js 4d Kh] [Qh]
bigtiger4: checks 
Weegolo: checks 
*** RIVER *** [Js 4d Kh Qh] [5c]
bigtiger4: checks 
Weegolo: checks 
*** SHOW DOWN ***
bigtiger4: shows [9h 6s] (high card King)
Headpro76 has returned
Weegolo: mucks hand 
bigtiger4 collected $0.50 from pot
*** SUMMARY ***
Total pot $0.50 | Rake $0 
Board [Js 4d Kh Qh 5c]
Seat 1: AtrY (button) folded before Flop (didn't bet)
Seat 3: bigtiger4 (small blind) showed [9h 6s] and won ($0.50) with high card King
Seat 4: Weegolo (big blind) mucked [8d 6c]
Seat 5: Kukoc69 folded before Flop (didn't bet)
Seat 6: AKl3gi0n folded before Flop (didn't bet)
Seat 7: dawinci80 folded before Flop (didn't bet)
Seat 8: Ewax folded before Flop (didn't bet)
Seat 9: Alameda22 folded before Flop (didn't bet)



PokerStars Game #20095579629:  Hold'em No Limit ($0.10/$0.25) - 2008/09/02 15:22:27 ET
Table 'Varsavia' 9-max Seat #3 is the button
Seat 1: AtrY ($34.15 in chips) 
Seat 2: Headpro76 ($21.45 in chips) 
Seat 3: bigtiger4 ($34.60 in chips) 
Seat 4: Weegolo ($5.85 in chips) 
Seat 5: Kukoc69 ($25.15 in chips) 
Seat 6: AKl3gi0n ($7.40 in chips) 
Seat 7: dawinci80 ($7.20 in chips) 
Seat 8: Ewax ($24.65 in chips) 
Seat 9: Alameda22 ($27.95 in chips) 
Weegolo: posts small blind $0.10
Kukoc69: posts big blind $0.25
Headpro76: posts small & big blinds $0.35
*** HOLE CARDS ***
Dealt to Alameda22 [8h Jd]
AKl3gi0n: folds 
dawinci80: folds 
Ewax: folds 
Alameda22: folds 
AtrY: raises $1 to $1.25
Headpro76: folds 
bigtiger4: calls $1.25
Weegolo: folds 
Kukoc69: folds 
*** FLOP *** [Qh 6d Td]
AtrY: bets $2
bigtiger4: calls $2
*** TURN *** [Qh 6d Td] [Js]
AtrY: bets $4.50
bigtiger4: raises $5.50 to $10
AtrY: folds 
Uncalled bet ($5.50) returned to bigtiger4
bigtiger4 collected $15.45 from pot
bigtiger4: doesn't show hand 
*** SUMMARY ***
Total pot $16.20 | Rake $0.75 
Board [Qh 6d Td Js]
Seat 1: AtrY folded on the Turn
Seat 2: Headpro76 folded before Flop
Seat 3: bigtiger4 (button) collected ($15.45)
Seat 4: Weegolo (small blind) folded before Flop
Seat 5: Kukoc69 (big blind) folded before Flop
Seat 6: AKl3gi0n folded before Flop (didn't bet)
Seat 7: dawinci80 folded before Flop (didn't bet)
Seat 8: Ewax folded before Flop (didn't bet)
Seat 9: Alameda22 folded before Flop (didn't bet)



PokerStars Game #20095615650:  Hold'em No Limit ($0.10/$0.25) - 2008/09/02 15:23:51 ET
Table 'Varsavia' 9-max Seat #4 is the button
Seat 1: AtrY ($26.40 in chips) 
Seat 2: Headpro76 ($21.10 in chips) 
Seat 3: bigtiger4 ($42.30 in chips) 
Seat 4: Weegolo ($5.75 in chips) 
Seat 5: Kukoc69 ($24.90 in chips) 
Seat 6: AKl3gi0n ($7.40 in chips) 
Seat 7: dawinci80 ($7.20 in chips) 
Seat 8: Ewax ($24.65 in chips) 
Seat 9: Alameda22 ($27.95 in chips) 
Kukoc69: posts small blind $0.10
AKl3gi0n: posts big blind $0.25
*** HOLE CARDS ***
Dealt to Alameda22 [9d 4h]
dawinci80 is disconnected 
dawinci80 has timed out while disconnected
dawinci80: folds 
dawinci80 is sitting out
Ewax: folds 
dawinci80 is connected 
dawinci80 has returned
Alameda22: folds 
AtrY: raises $0.75 to $1
Headpro76: raises $1.50 to $2.50
bigtiger4: folds 
Weegolo: folds 
Kukoc69: folds 
AKl3gi0n: folds 
AtrY: calls $1.50
*** FLOP *** [3d 2h 8h]
AtrY: checks 
Headpro76: bets $2.50
AtrY: folds 
Uncalled bet ($2.50) returned to Headpro76
Headpro76 collected $5.10 from pot
*** SUMMARY ***
Total pot $5.35 | Rake $0.25 
Board [3d 2h 8h]
Seat 1: AtrY folded on the Flop
Seat 2: Headpro76 collected ($5.10)
Seat 3: bigtiger4 folded before Flop (didn't bet)
Seat 4: Weegolo (button) folded before Flop (didn't bet)
Seat 5: Kukoc69 (small blind) folded before Flop
Seat 6: AKl3gi0n (big blind) folded before Flop
Seat 7: dawinci80 folded before Flop (didn't bet)
Seat 8: Ewax folded before Flop (didn't bet)
Seat 9: Alameda22 folded before Flop (didn't bet)



PokerStars Game #20095663386:  Hold'em No Limit ($0.10/$0.25) - 2008/09/02 15:25:44 ET
Table 'Varsavia' 9-max Seat #5 is the button
Seat 1: AtrY ($25 in chips) 
Seat 2: Headpro76 ($23.70 in chips) 
Seat 3: bigtiger4 ($42.30 in chips) 
Seat 4: Weegolo ($5.75 in chips) 
Seat 5: Kukoc69 ($24.80 in chips) 
Seat 6: AKl3gi0n ($7.15 in chips) 
Seat 7: dawinci80 ($7.20 in chips) 
Seat 8: Ewax ($24.65 in chips) 
Seat 9: Alameda22 ($27.95 in chips) 
AKl3gi0n: posts small blind $0.10
dawinci80: posts big blind $0.25
*** HOLE CARDS ***
Dealt to Alameda22 [3d As]
Ewax: folds 
Alameda22: folds 
AtrY: folds 
Headpro76: calls $0.25
bigtiger4: folds 
Weegolo: folds 
Kukoc69: folds 
AKl3gi0n: calls $0.15
dawinci80: checks 
*** FLOP *** [3s 8c Ac]
AKl3gi0n: checks 
dawinci80: checks 
Headpro76: checks 
*** TURN *** [3s 8c Ac] [7s]
AKl3gi0n: checks 
dawinci80: folds 
Headpro76: checks 
*** RIVER *** [3s 8c Ac 7s] [8d]
AKl3gi0n: checks 
Headpro76: checks 
*** SHOW DOWN ***
AKl3gi0n: shows [9h Jc] (a pair of Eights)
Headpro76: shows [2h 2s] (two pair, Eights and Deuces)
Headpro76 collected $0.75 from pot
*** SUMMARY ***
Total pot $0.75 | Rake $0 
Board [3s 8c Ac 7s 8d]
Seat 1: AtrY folded before Flop (didn't bet)
Seat 2: Headpro76 showed [2h 2s] and won ($0.75) with two pair, Eights and Deuces
Seat 3: bigtiger4 folded before Flop (didn't bet)
Seat 4: Weegolo folded before Flop (didn't bet)
Seat 5: Kukoc69 (button) folded before Flop (didn't bet)
Seat 6: AKl3gi0n (small blind) showed [9h Jc] and lost with a pair of Eights
Seat 7: dawinci80 (big blind) folded on the Turn
Seat 8: Ewax folded before Flop (didn't bet)
Seat 9: Alameda22 folded before Flop (didn't bet)



PokerStars Game #20095691503:  Hold'em No Limit ($0.10/$0.25) - 2008/09/02 15:26:50 ET
Table 'Varsavia' 9-max Seat #6 is the button
Seat 1: AtrY ($25 in chips) 
Seat 2: Headpro76 ($24.20 in chips) 
Seat 3: bigtiger4 ($42.30 in chips) 
Seat 4: Weegolo ($5.75 in chips) 
Seat 5: Kukoc69 ($24.80 in chips) 
Seat 6: AKl3gi0n ($6.90 in chips) 
Seat 7: dawinci80 ($6.95 in chips) 
Seat 8: Ewax ($24.65 in chips) 
Seat 9: Alameda22 ($27.95 in chips) 
dawinci80: posts small blind $0.10
Ewax: posts big blind $0.25
*** HOLE CARDS ***
Dealt to Alameda22 [Kc Ts]
Alameda22: folds 
AtrY: folds 
Headpro76: folds 
bigtiger4: calls $0.25
Weegolo: folds 
Kukoc69: folds 
AKl3gi0n: folds 
dawinci80: folds 
Ewax: checks 
*** FLOP *** [Ac 6h Kh]
Ewax: checks 
bigtiger4: checks 
*** TURN *** [Ac 6h Kh] [2c]
Ewax: checks 
Weegolo is sitting out
bigtiger4: checks 
*** RIVER *** [Ac 6h Kh 2c] [7c]
Ewax: checks 
bigtiger4: checks 
*** SHOW DOWN ***
Ewax: shows [4s Jd] (high card Ace)
bigtiger4: shows [2h 4c] (a pair of Deuces)
bigtiger4 collected $0.60 from pot
*** SUMMARY ***
Total pot $0.60 | Rake $0 
Board [Ac 6h Kh 2c 7c]
Seat 1: AtrY folded before Flop (didn't bet)
Seat 2: Headpro76 folded before Flop (didn't bet)
Seat 3: bigtiger4 showed [2h 4c] and won ($0.60) with a pair of Deuces
Seat 4: Weegolo folded before Flop (didn't bet)
Seat 5: Kukoc69 folded before Flop (didn't bet)
Seat 6: AKl3gi0n (button) folded before Flop (didn't bet)
Seat 7: dawinci80 (small blind) folded before Flop
Seat 8: Ewax (big blind) showed [4s Jd] and lost with high card Ace
Seat 9: Alameda22 folded before Flop (didn't bet)



PokerStars Game #20095710428:  Hold'em No Limit ($0.10/$0.25) - 2008/09/02 15:27:34 ET
Table 'Varsavia' 9-max Seat #7 is the button
Seat 1: AtrY ($25 in chips) 
Seat 2: Headpro76 ($24.20 in chips) 
Seat 3: bigtiger4 ($42.65 in chips) 
Seat 5: Kukoc69 ($24.80 in chips) 
Seat 6: AKl3gi0n ($6.90 in chips) 
Seat 7: dawinci80 ($6.85 in chips) 
Seat 8: Ewax ($24.40 in chips) 
Seat 9: Alameda22 ($27.95 in chips) 
Ewax: posts small blind $0.10
Alameda22: posts big blind $0.25
*** HOLE CARDS ***
Dealt to Alameda22 [Js Kc]
AtrY: folds 
Headpro76: folds 
bigtiger4: folds 
Kukoc69: folds 
AKl3gi0n: calls $0.25
dawinci80: folds 
Ewax: folds 
Alameda22: checks 
*** FLOP *** [Qh Qs 3s]
Alameda22: checks 
AKl3gi0n: bets $0.25
Alameda22: folds 
Uncalled bet ($0.25) returned to AKl3gi0n
AKl3gi0n collected $0.60 from pot
*** SUMMARY ***
Total pot $0.60 | Rake $0 
Board [Qh Qs 3s]
Seat 1: AtrY folded before Flop (didn't bet)
Seat 2: Headpro76 folded before Flop (didn't bet)
Seat 3: bigtiger4 folded before Flop (didn't bet)
Seat 5: Kukoc69 folded before Flop (didn't bet)
Seat 6: AKl3gi0n collected ($0.60)
Seat 7: dawinci80 (button) folded before Flop (didn't bet)
Seat 8: Ewax (small blind) folded before Flop
Seat 9: Alameda22 (big blind) folded on the Flop



PokerStars Game #20095744729:  Hold'em No Limit ($0.10/$0.25) - 2008/09/02 15:28:54 ET
Table 'Varsavia' 9-max Seat #8 is the button
Seat 1: AtrY ($25 in chips) 
Seat 2: Headpro76 ($24.20 in chips) 
Seat 3: bigtiger4 ($42.65 in chips) 
Seat 5: Kukoc69 ($24.80 in chips) 
Seat 6: AKl3gi0n ($7.25 in chips) 
Seat 7: dawinci80 ($6.85 in chips) 
Seat 8: Ewax ($24.30 in chips) 
Seat 9: Alameda22 ($27.70 in chips) 
Alameda22: posts small blind $0.10
AtrY: posts big blind $0.25
*** HOLE CARDS ***
Dealt to Alameda22 [7d 4c]
Headpro76: folds 
bigtiger4: calls $0.25
Kukoc69: folds 
AKl3gi0n: folds 
dawinci80: folds 
Ewax: folds 
Alameda22: folds 
AtrY: checks 
*** FLOP *** [Jh 9s Ad]
AtrY: checks 
bigtiger4: checks 
*** TURN *** [Jh 9s Ad] [Qs]
Weegolo has returned
AtrY: checks 
bigtiger4: bets $0.25
AtrY: folds 
Uncalled bet ($0.25) returned to bigtiger4
bigtiger4 collected $0.60 from pot
bigtiger4: doesn't show hand 
*** SUMMARY ***
Total pot $0.60 | Rake $0 
Board [Jh 9s Ad Qs]
Seat 1: AtrY (big blind) folded on the Turn
Seat 2: Headpro76 folded before Flop (didn't bet)
Seat 3: bigtiger4 collected ($0.60)
Seat 5: Kukoc69 folded before Flop (didn't bet)
Seat 6: AKl3gi0n folded before Flop (didn't bet)
Seat 7: dawinci80 folded before Flop (didn't bet)
Seat 8: Ewax (button) folded before Flop (didn't bet)
Seat 9: Alameda22 (small blind) folded before Flop



PokerStars Game #20095766363:  Hold'em No Limit ($0.10/$0.25) - 2008/09/02 15:29:46 ET
Table 'Varsavia' 9-max Seat #9 is the button
Seat 1: AtrY ($24.75 in chips) 
Seat 2: Headpro76 ($24.20 in chips) 
Seat 3: bigtiger4 ($43 in chips) 
Seat 4: Weegolo ($5.75 in chips) 
Seat 5: Kukoc69 ($24.80 in chips) 
Seat 6: AKl3gi0n ($7.25 in chips) 
Seat 7: dawinci80 ($6.85 in chips) 
Seat 8: Ewax ($24.30 in chips) 
Seat 9: Alameda22 ($27.60 in chips) 
AtrY: posts small blind $0.10
Headpro76: posts big blind $0.25
*** HOLE CARDS ***
Dealt to Alameda22 [5s 7d]
bigtiger4: folds 
Weegolo: calls $0.25
Kukoc69: folds 
AKl3gi0n: calls $0.25
dawinci80: folds 
Ewax: folds 
Alameda22: folds 
AtrY: folds 
Headpro76: checks 
*** FLOP *** [3h 9h 7h]
Headpro76: checks 
Weegolo: checks 
AKl3gi0n: checks 
*** TURN *** [3h 9h 7h] [Ac]
Headpro76: checks 
Weegolo: checks 
AKl3gi0n: bets $0.25
Headpro76: folds 
Weegolo: folds 
Uncalled bet ($0.25) returned to AKl3gi0n
AKl3gi0n collected $0.85 from pot
AKl3gi0n: shows [8s As] (a pair of Aces)
*** SUMMARY ***
Total pot $0.85 | Rake $0 
Board [3h 9h 7h Ac]
Seat 1: AtrY (small blind) folded before Flop
Seat 2: Headpro76 (big blind) folded on the Turn
Seat 3: bigtiger4 folded before Flop (didn't bet)
Seat 4: Weegolo folded on the Turn
Seat 5: Kukoc69 folded before Flop (didn't bet)
Seat 6: AKl3gi0n collected ($0.85)
Seat 7: dawinci80 folded before Flop (didn't bet)
Seat 8: Ewax folded before Flop (didn't bet)
Seat 9: Alameda22 (button) folded before Flop (didn't bet)



PokerStars Game #20095803173:  Hold'em No Limit ($0.10/$0.25) - 2008/09/02 15:31:10 ET
Table 'Varsavia' 9-max Seat #1 is the button
Seat 1: AtrY ($24.65 in chips) 
Seat 2: Headpro76 ($23.95 in chips) 
Seat 3: bigtiger4 ($43 in chips) 
Seat 4: Weegolo ($5.50 in chips) 
Seat 5: Kukoc69 ($24.80 in chips) 
Seat 6: AKl3gi0n ($7.85 in chips) 
Seat 7: dawinci80 ($6.85 in chips) 
Seat 8: Ewax ($24.30 in chips) 
Seat 9: Alameda22 ($27.60 in chips) 
Headpro76: posts small blind $0.10
bigtiger4: posts big blind $0.25
*** HOLE CARDS ***
Dealt to Alameda22 [Qd 2d]
Weegolo: folds 
Kukoc69: folds 
AKl3gi0n: folds 
dawinci80: folds 
Ewax: folds 
Alameda22: folds 
AtrY: raises $0.75 to $1
Headpro76: folds 
bigtiger4: calls $0.75
*** FLOP *** [2s 7c 9s]
bigtiger4: bets $0.50
AtrY: raises $2 to $2.50
bigtiger4: calls $2
*** TURN *** [2s 7c 9s] [7h]
bigtiger4: bets $2.50
AtrY: folds 
Uncalled bet ($2.50) returned to bigtiger4
bigtiger4 collected $6.75 from pot
bigtiger4: doesn't show hand 
*** SUMMARY ***
Total pot $7.10 | Rake $0.35 
Board [2s 7c 9s 7h]
Seat 1: AtrY (button) folded on the Turn
Seat 2: Headpro76 (small blind) folded before Flop
Seat 3: bigtiger4 (big blind) collected ($6.75)
Seat 4: Weegolo folded before Flop (didn't bet)
Seat 5: Kukoc69 folded before Flop (didn't bet)
Seat 6: AKl3gi0n folded before Flop (didn't bet)
Seat 7: dawinci80 folded before Flop (didn't bet)
Seat 8: Ewax folded before Flop (didn't bet)
Seat 9: Alameda22 folded before Flop (didn't bet)



PokerStars Game #20095834518:  Hold'em No Limit ($0.10/$0.25) - 2008/09/02 15:32:24 ET
Table 'Varsavia' 9-max Seat #2 is the button
Seat 1: AtrY ($25 in chips) 
Seat 2: Headpro76 ($23.85 in chips) 
Seat 3: bigtiger4 ($46.25 in chips) 
Seat 4: Weegolo ($5.50 in chips) 
Seat 5: Kukoc69 ($24.80 in chips) 
Seat 6: AKl3gi0n ($7.85 in chips) 
Seat 7: dawinci80 ($6.85 in chips) 
Seat 8: Ewax ($24.30 in chips) 
Seat 9: Alameda22 ($27.60 in chips) 
bigtiger4: posts small blind $0.10
Weegolo: posts big blind $0.25
*** HOLE CARDS ***
Dealt to Alameda22 [7h 2s]
Kukoc69: raises $0.75 to $1
AKl3gi0n: folds 
dawinci80: folds 
Ewax: folds 
Alameda22: folds 
AtrY: folds 
Headpro76: folds 
bigtiger4: calls $0.90
Weegolo: folds 
*** FLOP *** [2h 6h 8c]
bigtiger4: checks 
Kukoc69: bets $1.50
bigtiger4: calls $1.50
*** TURN *** [2h 6h 8c] [Jh]
bigtiger4: bets $1.50
Kukoc69: calls $1.50
*** RIVER *** [2h 6h 8c Jh] [3h]
bigtiger4: checks 
Kukoc69: bets $5.50
bigtiger4: folds 
Uncalled bet ($5.50) returned to Kukoc69
Kukoc69 collected $7.85 from pot
Kukoc69: doesn't show hand 
*** SUMMARY ***
Total pot $8.25 | Rake $0.40 
Board [2h 6h 8c Jh 3h]
Seat 1: AtrY folded before Flop (didn't bet)
Seat 2: Headpro76 (button) folded before Flop (didn't bet)
Seat 3: bigtiger4 (small blind) folded on the River
Seat 4: Weegolo (big blind) folded before Flop
Seat 5: Kukoc69 collected ($7.85)
Seat 6: AKl3gi0n folded before Flop (didn't bet)
Seat 7: dawinci80 folded before Flop (didn't bet)
Seat 8: Ewax folded before Flop (didn't bet)
Seat 9: Alameda22 folded before Flop (didn't bet)



PokerStars Game #20095873790:  Hold'em No Limit ($0.10/$0.25) - 2008/09/02 15:33:54 ET
Table 'Varsavia' 9-max Seat #3 is the button
Seat 1: AtrY ($25 in chips) 
Seat 2: Headpro76 ($23.85 in chips) 
Seat 3: bigtiger4 ($42.25 in chips) 
Seat 4: Weegolo ($5.25 in chips) 
Seat 5: Kukoc69 ($28.65 in chips) 
Seat 6: AKl3gi0n ($7.85 in chips) 
Seat 7: dawinci80 ($6.85 in chips) 
Seat 8: Ewax ($24.30 in chips) 
Seat 9: Alameda22 ($27.60 in chips) 
Weegolo: posts small blind $0.10
Kukoc69: posts big blind $0.25
*** HOLE CARDS ***
Dealt to Alameda22 [8h Kc]
AKl3gi0n: calls $0.25
dawinci80: folds 
Ewax: raises $1 to $1.25
Alameda22: folds 
AtrY: folds 
Headpro76: folds 
bigtiger4: calls $1.25
Weegolo: folds 
Kukoc69: folds 
AKl3gi0n: folds 
*** FLOP *** [Qd Ks Qh]
Ewax: bets $1.50
bigtiger4: folds 
Uncalled bet ($1.50) returned to Ewax
Ewax collected $2.95 from pot
Ewax: doesn't show hand 
*** SUMMARY ***
Total pot $3.10 | Rake $0.15 
Board [Qd Ks Qh]
Seat 1: AtrY folded before Flop (didn't bet)
Seat 2: Headpro76 folded before Flop (didn't bet)
Seat 3: bigtiger4 (button) folded on the Flop
Seat 4: Weegolo (small blind) folded before Flop
Seat 5: Kukoc69 (big blind) folded before Flop
Seat 6: AKl3gi0n folded before Flop
Seat 7: dawinci80 folded before Flop (didn't bet)
Seat 8: Ewax collected ($2.95)
Seat 9: Alameda22 folded before Flop (didn't bet)



PokerStars Game #20095905125:  Hold'em No Limit ($0.10/$0.25) - 2008/09/02 15:35:05 ET
Table 'Varsavia' 9-max Seat #4 is the button
Seat 1: AtrY ($25 in chips) 
Seat 2: Headpro76 ($23.85 in chips) 
Seat 3: bigtiger4 ($41 in chips) 
Seat 4: Weegolo ($5.15 in chips) 
Seat 5: Kukoc69 ($28.40 in chips) 
Seat 6: AKl3gi0n ($7.60 in chips) 
Seat 7: dawinci80 ($6.85 in chips) 
Seat 8: Ewax ($26 in chips) 
Seat 9: Alameda22 ($27.60 in chips) 
Kukoc69: posts small blind $0.10
AKl3gi0n: posts big blind $0.25
*** HOLE CARDS ***
Dealt to Alameda22 [6s 3h]
dawinci80: folds 
Ewax: folds 
Alameda22: folds 
AtrY: folds 
Headpro76: folds 
bigtiger4: folds 
Weegolo: folds 
Kukoc69: folds 
Uncalled bet ($0.15) returned to AKl3gi0n
AKl3gi0n collected $0.20 from pot
*** SUMMARY ***
Total pot $0.20 | Rake $0 
Seat 1: AtrY folded before Flop (didn't bet)
Seat 2: Headpro76 folded before Flop (didn't bet)
Seat 3: bigtiger4 folded before Flop (didn't bet)
Seat 4: Weegolo (button) folded before Flop (didn't bet)
Seat 5: Kukoc69 (small blind) folded before Flop
Seat 6: AKl3gi0n (big blind) collected ($0.20)
Seat 7: dawinci80 folded before Flop (didn't bet)
Seat 8: Ewax folded before Flop (didn't bet)
Seat 9: Alameda22 folded before Flop (didn't bet)



PokerStars Game #20095916444:  Hold'em No Limit ($0.10/$0.25) - 2008/09/02 15:35:32 ET
Table 'Varsavia' 9-max Seat #5 is the button
Seat 1: AtrY ($25 in chips) 
Seat 2: Headpro76 ($23.85 in chips) 
Seat 3: bigtiger4 ($41 in chips) 
Seat 4: Weegolo ($5.15 in chips) 
Seat 5: Kukoc69 ($28.30 in chips) 
Seat 6: AKl3gi0n ($7.70 in chips) 
Seat 7: dawinci80 ($6.85 in chips) 
Seat 8: Ewax ($26 in chips) 
Seat 9: Alameda22 ($27.60 in chips) 
AKl3gi0n: posts small blind $0.10
dawinci80: posts big blind $0.25
*** HOLE CARDS ***
Dealt to Alameda22 [Qh Ah]
Ewax: folds 
Alameda22: raises $0.75 to $1
AtrY: folds 
Headpro76: folds 
bigtiger4: folds 
Weegolo: folds 
Kukoc69: folds 
AKl3gi0n: folds 
dawinci80: calls $0.75
*** FLOP *** [7s 8d Tc]
dawinci80: checks 
Alameda22: bets $1.25
dawinci80: folds 
Uncalled bet ($1.25) returned to Alameda22
Alameda22 collected $2 from pot
Alameda22: doesn't show hand 
*** SUMMARY ***
Total pot $2.10 | Rake $0.10 
Board [7s 8d Tc]
Seat 1: AtrY folded before Flop (didn't bet)
Seat 2: Headpro76 folded before Flop (didn't bet)
Seat 3: bigtiger4 folded before Flop (didn't bet)
Seat 4: Weegolo folded before Flop (didn't bet)
Seat 5: Kukoc69 (button) folded before Flop (didn't bet)
Seat 6: AKl3gi0n (small blind) folded before Flop
Seat 7: dawinci80 (big blind) folded on the Flop
Seat 8: Ewax folded before Flop (didn't bet)
Seat 9: Alameda22 collected ($2)



PokerStars Game #20095947169:  Hold'em No Limit ($0.10/$0.25) - 2008/09/02 15:36:44 ET
Table 'Varsavia' 9-max Seat #6 is the button
Seat 1: AtrY ($25 in chips) 
Seat 2: Headpro76 ($23.85 in chips) 
Seat 3: bigtiger4 ($41 in chips) 
Seat 4: Weegolo ($5.15 in chips) 
Seat 5: Kukoc69 ($28.30 in chips) 
Seat 6: AKl3gi0n ($7.60 in chips) 
Seat 7: dawinci80 ($5.85 in chips) 
Seat 8: Ewax ($26 in chips) 
Seat 9: Alameda22 ($28.60 in chips) 
dawinci80: posts small blind $0.10
Ewax: posts big blind $0.25
*** HOLE CARDS ***
Dealt to Alameda22 [Ac 4h]
Alameda22: folds 
AtrY: folds 
Headpro76: folds 
bigtiger4: raises $0.50 to $0.75
Weegolo: folds 
Kukoc69: folds 
AKl3gi0n: folds 
dawinci80: folds 
Ewax: folds 
Uncalled bet ($0.50) returned to bigtiger4
bigtiger4 collected $0.60 from pot
bigtiger4: doesn't show hand 
*** SUMMARY ***
Total pot $0.60 | Rake $0 
Seat 1: AtrY folded before Flop (didn't bet)
Seat 2: Headpro76 folded before Flop (didn't bet)
Seat 3: bigtiger4 collected ($0.60)
Seat 4: Weegolo folded before Flop (didn't bet)
Seat 5: Kukoc69 folded before Flop (didn't bet)
Seat 6: AKl3gi0n (button) folded before Flop (didn't bet)
Seat 7: dawinci80 (small blind) folded before Flop
Seat 8: Ewax (big blind) folded before Flop
Seat 9: Alameda22 folded before Flop (didn't bet)



PokerStars Game #20095968096:  Hold'em No Limit ($0.10/$0.25) - 2008/09/02 15:37:32 ET
Table 'Varsavia' 9-max Seat #7 is the button
Seat 1: AtrY ($25 in chips) 
Seat 2: Headpro76 ($23.85 in chips) 
Seat 3: bigtiger4 ($41.35 in chips) 
Seat 4: Weegolo ($5.15 in chips) 
Seat 5: Kukoc69 ($28.30 in chips) 
Seat 6: AKl3gi0n ($7.60 in chips) 
Seat 7: dawinci80 ($5.75 in chips) 
Seat 8: Ewax ($25.75 in chips) 
Seat 9: Alameda22 ($28.60 in chips) 
Ewax: posts small blind $0.10
Alameda22: posts big blind $0.25
*** HOLE CARDS ***
Dealt to Alameda22 [3s 3d]
AtrY: folds 
Headpro76: folds 
Headpro76 leaves the table
bigtiger4: calls $0.25
Weegolo: folds 
Kukoc69: folds 
AKl3gi0n: folds 
lxamE joins the table at seat #2 
dawinci80: raises $0.75 to $1
Ewax: folds 
Alameda22: folds 
bigtiger4: raises $4.50 to $5.50
dawinci80: folds 
Uncalled bet ($4.50) returned to bigtiger4
bigtiger4 collected $2.35 from pot
bigtiger4: doesn't show hand 
*** SUMMARY ***
Total pot $2.35 | Rake $0 
Seat 1: AtrY folded before Flop (didn't bet)
Seat 2: Headpro76 folded before Flop (didn't bet)
Seat 3: bigtiger4 collected ($2.35)
Seat 4: Weegolo folded before Flop (didn't bet)
Seat 5: Kukoc69 folded before Flop (didn't bet)
Seat 6: AKl3gi0n folded before Flop (didn't bet)
Seat 7: dawinci80 (button) folded before Flop
Seat 8: Ewax (small blind) folded before Flop
Seat 9: Alameda22 (big blind) folded before Flop



PokerStars Game #20095996982:  Hold'em No Limit ($0.10/$0.25) - 2008/09/02 15:38:41 ET
Table 'Varsavia' 9-max Seat #8 is the button
Seat 1: AtrY ($25 in chips) 
Seat 3: bigtiger4 ($42.70 in chips) 
Seat 4: Weegolo ($5.15 in chips) 
Seat 5: Kukoc69 ($28.30 in chips) 
Seat 6: AKl3gi0n ($7.60 in chips) 
Seat 7: dawinci80 ($4.75 in chips) 
Seat 8: Ewax ($25.65 in chips) 
Seat 9: Alameda22 ($28.35 in chips) 
Alameda22: posts small blind $0.10
AtrY: posts big blind $0.25
lxamE: sits out 
*** HOLE CARDS ***
Dealt to Alameda22 [Qc 6d]
bigtiger4: calls $0.25
Weegolo: folds 
Kukoc69: folds 
AKl3gi0n: folds 
dawinci80: folds 
Ewax: calls $0.25
Alameda22: folds 
AtrY: checks 
*** FLOP *** [3s 5s 9s]
AtrY: checks 
bigtiger4: checks 
Ewax: checks 
*** TURN *** [3s 5s 9s] [Kd]
AtrY: checks 
bigtiger4: checks 
Ewax: checks 
*** RIVER *** [3s 5s 9s Kd] [9h]
AtrY: checks 
bigtiger4: checks 
Ewax: checks 
*** SHOW DOWN ***
AtrY: shows [4s Jc] (a pair of Nines)
bigtiger4: shows [8h Qh] (a pair of Nines - King+Queen kicker)
Ewax: mucks hand 
bigtiger4 collected $0.85 from pot
*** SUMMARY ***
Total pot $0.85 | Rake $0 
Board [3s 5s 9s Kd 9h]
Seat 1: AtrY (big blind) showed [4s Jc] and lost with a pair of Nines
Seat 3: bigtiger4 showed [8h Qh] and won ($0.85) with a pair of Nines
Seat 4: Weegolo folded before Flop (didn't bet)
Seat 5: Kukoc69 folded before Flop (didn't bet)
Seat 6: AKl3gi0n folded before Flop (didn't bet)
Seat 7: dawinci80 folded before Flop (didn't bet)
Seat 8: Ewax (button) mucked [Th Jd]
Seat 9: Alameda22 (small blind) folded before Flop



PokerStars Game #20096020116:  Hold'em No Limit ($0.10/$0.25) - 2008/09/02 15:39:35 ET
Table 'Varsavia' 9-max Seat #9 is the button
Seat 1: AtrY ($24.75 in chips) 
Seat 2: lxamE ($5 in chips) 
Seat 3: bigtiger4 ($43.30 in chips) 
Seat 4: Weegolo ($5.15 in chips) 
Seat 5: Kukoc69 ($28.30 in chips) 
Seat 6: AKl3gi0n ($7.60 in chips) 
Seat 7: dawinci80 ($4.75 in chips) 
Seat 8: Ewax ($25.40 in chips) 
Seat 9: Alameda22 ($28.25 in chips) 
AtrY: posts small blind $0.10
lxamE: posts big blind $0.25
*** HOLE CARDS ***
Dealt to Alameda22 [5c 2d]
bigtiger4: raises $0.25 to $0.50
Weegolo: folds 
Kukoc69: folds 
AKl3gi0n: folds 
dawinci80: calls $0.50
Ewax: calls $0.50
Alameda22: folds 
AtrY: folds 
lxamE: folds 
*** FLOP *** [3s 5h 3h]
bigtiger4: bets $0.50
dawinci80: raises $0.50 to $1
Ewax: calls $1
bigtiger4: calls $0.50
*** TURN *** [3s 5h 3h] [2c]
bigtiger4: checks 
dawinci80: bets $3.25 and is all-in
Ewax: folds 
bigtiger4: folds 
Uncalled bet ($3.25) returned to dawinci80
dawinci80 collected $4.65 from pot
*** SUMMARY ***
Total pot $4.85 | Rake $0.20 
Board [3s 5h 3h 2c]
Seat 1: AtrY (small blind) folded before Flop
Seat 2: lxamE (big blind) folded before Flop
Seat 3: bigtiger4 folded on the Turn
Seat 4: Weegolo folded before Flop (didn't bet)
Seat 5: Kukoc69 folded before Flop (didn't bet)
Seat 6: AKl3gi0n folded before Flop (didn't bet)
Seat 7: dawinci80 collected ($4.65)
Seat 8: Ewax folded on the Turn
Seat 9: Alameda22 (button) folded before Flop (didn't bet)



PokerStars Game #20096055537:  Hold'em No Limit ($0.10/$0.25) - 2008/09/02 15:41:00 ET
Table 'Varsavia' 9-max Seat #1 is the button
Seat 1: AtrY ($24.65 in chips) 
Seat 2: lxamE ($4.75 in chips) 
Seat 3: bigtiger4 ($41.80 in chips) 
Seat 4: Weegolo ($5.15 in chips) 
Seat 5: Kukoc69 ($28.30 in chips) 
Seat 6: AKl3gi0n ($7.60 in chips) 
Seat 7: dawinci80 ($7.90 in chips) 
Seat 8: Ewax ($23.90 in chips) 
Seat 9: Alameda22 ($28.25 in chips) 
lxamE: posts small blind $0.10
bigtiger4: posts big blind $0.25
*** HOLE CARDS ***
Dealt to Alameda22 [Jc 8d]
Weegolo: folds 
Kukoc69: folds 
Kukoc69 leaves the table
AKl3gi0n: calls $0.25
dawinci80: folds 
Ewax: folds 
Alameda22: folds 
AtrY: folds 
lxamE: folds 
bigtiger4: checks 
*** FLOP *** [Jh Td 3s]
bigtiger4: checks 
AKl3gi0n: checks 
*** TURN *** [Jh Td 3s] [5h]
bigtiger4: bets $0.75
AKl3gi0n: folds 
Uncalled bet ($0.75) returned to bigtiger4
bigtiger4 collected $0.60 from pot
bigtiger4: doesn't show hand 
*** SUMMARY ***
Total pot $0.60 | Rake $0 
Board [Jh Td 3s 5h]
Seat 1: AtrY (button) folded before Flop (didn't bet)
Seat 2: lxamE (small blind) folded before Flop
Seat 3: bigtiger4 (big blind) collected ($0.60)
Seat 4: Weegolo folded before Flop (didn't bet)
Seat 5: Kukoc69 folded before Flop (didn't bet)
Seat 6: AKl3gi0n folded on the Turn
Seat 7: dawinci80 folded before Flop (didn't bet)
Seat 8: Ewax folded before Flop (didn't bet)
Seat 9: Alameda22 folded before Flop (didn't bet)



PokerStars Game #20096082290:  Hold'em No Limit ($0.10/$0.25) - 2008/09/02 15:42:04 ET
Table 'Varsavia' 9-max Seat #2 is the button
Seat 1: AtrY ($24.65 in chips) 
Seat 2: lxamE ($4.65 in chips) 
Seat 3: bigtiger4 ($42.15 in chips) 
Seat 4: Weegolo ($5.15 in chips) 
Seat 6: AKl3gi0n ($7.35 in chips) 
Seat 7: dawinci80 ($7.90 in chips) 
Seat 8: Ewax ($23.90 in chips) 
Seat 9: Alameda22 ($28.25 in chips) 
bigtiger4: posts small blind $0.10
Weegolo: posts big blind $0.25
*** HOLE CARDS ***
Dealt to Alameda22 [4h 7s]
AKl3gi0n: folds 
dawinci80: folds 
Ewax: folds 
Alameda22: folds 
AtrY: raises $0.75 to $1
lxamE: folds 
bigtiger4: calls $0.90
Weegolo: folds 
*** FLOP *** [6c Ad Js]
bigtiger4: checks 
AtrY: checks 
*** TURN *** [6c Ad Js] [Ac]
bigtiger4: bets $1
AtrY: folds 
Uncalled bet ($1) returned to bigtiger4
bigtiger4 collected $2.15 from pot
*** SUMMARY ***
Total pot $2.25 | Rake $0.10 
Board [6c Ad Js Ac]
Seat 1: AtrY folded on the Turn
Seat 2: lxamE (button) folded before Flop (didn't bet)
Seat 3: bigtiger4 (small blind) collected ($2.15)
Seat 4: Weegolo (big blind) folded before Flop
Seat 6: AKl3gi0n folded before Flop (didn't bet)
Seat 7: dawinci80 folded before Flop (didn't bet)
Seat 8: Ewax folded before Flop (didn't bet)
Seat 9: Alameda22 folded before Flop (didn't bet)



PokerStars Game #20096100956:  Hold'em No Limit ($0.10/$0.25) - 2008/09/02 15:42:49 ET
Table 'Varsavia' 9-max Seat #3 is the button
Seat 1: AtrY ($23.65 in chips) 
Seat 2: lxamE ($4.65 in chips) 
Seat 3: bigtiger4 ($43.30 in chips) 
Seat 4: Weegolo ($4.90 in chips) 
Seat 6: AKl3gi0n ($7.35 in chips) 
Seat 7: dawinci80 ($7.90 in chips) 
Seat 8: Ewax ($23.90 in chips) 
Seat 9: Alameda22 ($28.25 in chips) 
Weegolo: posts small blind $0.10
AKl3gi0n: posts big blind $0.25
*** HOLE CARDS ***
Dealt to Alameda22 [8s 7s]
dawinci80: folds 
Ewax: folds 
Alameda22: folds 
AtrY: folds 
lxamE: folds 
bigtiger4: raises $0.25 to $0.50
Weegolo: folds 
AKl3gi0n: folds 
Uncalled bet ($0.25) returned to bigtiger4
bigtiger4 collected $0.60 from pot
*** SUMMARY ***
Total pot $0.60 | Rake $0 
Seat 1: AtrY folded before Flop (didn't bet)
Seat 2: lxamE folded before Flop (didn't bet)
Seat 3: bigtiger4 (button) collected ($0.60)
Seat 4: Weegolo (small blind) folded before Flop
Seat 6: AKl3gi0n (big blind) folded before Flop
Seat 7: dawinci80 folded before Flop (didn't bet)
Seat 8: Ewax folded before Flop (didn't bet)
Seat 9: Alameda22 folded before Flop (didn't bet)



PokerStars Game #20096122692:  Hold'em No Limit ($0.10/$0.25) - 2008/09/02 15:43:42 ET
Table 'Varsavia' 9-max Seat #4 is the button
Seat 1: AtrY ($23.65 in chips) 
Seat 2: lxamE ($4.65 in chips) 
Seat 3: bigtiger4 ($43.65 in chips) 
Seat 4: Weegolo ($4.80 in chips) 
Seat 6: AKl3gi0n ($7.10 in chips) 
Seat 7: dawinci80 ($7.90 in chips) 
Seat 8: Ewax ($23.90 in chips) 
Seat 9: Alameda22 ($28.25 in chips) 
AKl3gi0n: posts small blind $0.10
dawinci80: posts big blind $0.25
*** HOLE CARDS ***
Dealt to Alameda22 [4s 2h]
Ewax: folds 
Alameda22: folds 
AtrY: folds 
lxamE: folds 
bigtiger4: raises $0.25 to $0.50
Weegolo: folds 
AKl3gi0n: calls $0.40
dawinci80: calls $0.25
*** FLOP *** [8h 4h 3s]
AKl3gi0n: bets $0.50
dawinci80: calls $0.50
bigtiger4: calls $0.50
*** TURN *** [8h 4h 3s] [7c]
AKl3gi0n: checks 
dawinci80: bets $0.50
bigtiger4: calls $0.50
AKl3gi0n: folds 
*** RIVER *** [8h 4h 3s 7c] [8d]
dawinci80: bets $0.75
bigtiger4: folds 
Uncalled bet ($0.75) returned to dawinci80
dawinci80 collected $3.85 from pot
*** SUMMARY ***
Total pot $4 | Rake $0.15 
Board [8h 4h 3s 7c 8d]
Seat 1: AtrY folded before Flop (didn't bet)
Seat 2: lxamE folded before Flop (didn't bet)
Seat 3: bigtiger4 folded on the River
Seat 4: Weegolo (button) folded before Flop (didn't bet)
Seat 6: AKl3gi0n (small blind) folded on the Turn
Seat 7: dawinci80 (big blind) collected ($3.85)
Seat 8: Ewax folded before Flop (didn't bet)
Seat 9: Alameda22 folded before Flop (didn't bet)



PokerStars Game #20096151005:  Hold'em No Limit ($0.10/$0.25) - 2008/09/02 15:44:50 ET
Table 'Varsavia' 9-max Seat #6 is the button
Seat 1: AtrY ($23.65 in chips) 
Seat 2: lxamE ($4.65 in chips) 
Seat 3: bigtiger4 ($42.15 in chips) 
Seat 4: Weegolo ($4.80 in chips) 
Seat 6: AKl3gi0n ($6.10 in chips) 
Seat 7: dawinci80 ($10.25 in chips) 
Seat 8: Ewax ($23.90 in chips) 
Seat 9: Alameda22 ($28.25 in chips) 
dawinci80: posts small blind $0.10
Ewax: posts big blind $0.25
*** HOLE CARDS ***
Dealt to Alameda22 [3c 9d]
chessmanA1 joins the table at seat #5 
Alameda22: folds 
AtrY: folds 
lxamE: folds 
bigtiger4: raises $0.75 to $1
Weegolo: folds 
AKl3gi0n: folds 
dawinci80: folds 
Ewax: folds 
Uncalled bet ($0.75) returned to bigtiger4
bigtiger4 collected $0.60 from pot
bigtiger4: doesn't show hand 
*** SUMMARY ***
Total pot $0.60 | Rake $0 
Seat 1: AtrY folded before Flop (didn't bet)
Seat 2: lxamE folded before Flop (didn't bet)
Seat 3: bigtiger4 collected ($0.60)
Seat 4: Weegolo folded before Flop (didn't bet)
Seat 6: AKl3gi0n (button) folded before Flop (didn't bet)
Seat 7: dawinci80 (small blind) folded before Flop
Seat 8: Ewax (big blind) folded before Flop
Seat 9: Alameda22 folded before Flop (didn't bet)



PokerStars Game #20096170380:  Hold'em No Limit ($0.10/$0.25) - 2008/09/02 15:45:37 ET
Table 'Varsavia' 9-max Seat #7 is the button
Seat 1: AtrY ($23.65 in chips) 
Seat 2: lxamE ($4.65 in chips) 
Seat 3: bigtiger4 ($42.50 in chips) 
Seat 4: Weegolo ($4.80 in chips) 
Seat 6: AKl3gi0n ($6.10 in chips) 
Seat 7: dawinci80 ($10.15 in chips) 
Seat 8: Ewax ($23.65 in chips) 
Seat 9: Alameda22 ($28.25 in chips) 
Ewax: posts small blind $0.10
Alameda22: posts big blind $0.25
chessmanA1: sits out 
*** HOLE CARDS ***
Dealt to Alameda22 [2c 4c]
AtrY: folds 
lxamE: folds 
bigtiger4: folds 
Weegolo: calls $0.25
AKl3gi0n: folds 
bigtiger4 leaves the table
dawinci80: folds 
Ewax: folds 
Alameda22: checks 
*** FLOP *** [8c Ac 3c]
attilale001 joins the table at seat #3 
Alameda22: bets $0.50
Weegolo: folds 
Uncalled bet ($0.50) returned to Alameda22
Alameda22 collected $0.60 from pot
Alameda22: doesn't show hand 
*** SUMMARY ***
Total pot $0.60 | Rake $0 
Board [8c Ac 3c]
Seat 1: AtrY folded before Flop (didn't bet)
Seat 2: lxamE folded before Flop (didn't bet)
Seat 3: bigtiger4 folded before Flop (didn't bet)
Seat 4: Weegolo folded on the Flop
Seat 6: AKl3gi0n folded before Flop (didn't bet)
Seat 7: dawinci80 (button) folded before Flop (didn't bet)
Seat 8: Ewax (small blind) folded before Flop
Seat 9: Alameda22 (big blind) collected ($0.60)



PokerStars Game #20096203888:  Hold'em No Limit ($0.10/$0.25) - 2008/09/02 15:46:59 ET
Table 'Varsavia' 9-max Seat #8 is the button
Seat 1: AtrY ($23.65 in chips) 
Seat 2: lxamE ($4.65 in chips) 
Seat 3: attilale001 ($5 in chips) 
Seat 4: Weegolo ($4.55 in chips) 
Seat 6: AKl3gi0n ($6.10 in chips) 
Seat 7: dawinci80 ($10.15 in chips) 
Seat 8: Ewax ($23.55 in chips) 
Seat 9: Alameda22 ($28.60 in chips) 
Alameda22: posts small blind $0.10
AtrY: posts big blind $0.25
attilale001: posts big blind $0.25
chessmanA1: sits out 
*** HOLE CARDS ***
Dealt to Alameda22 [6d 2h]
lxamE: folds 
attilale001: checks 
Weegolo: calls $0.25
AKl3gi0n: raises $0.25 to $0.50
dawinci80: folds 
Ewax: folds 
Alameda22: folds 
AtrY: folds 
attilale001: calls $0.25
Weegolo: calls $0.25
*** FLOP *** [2c 3h Ah]
attilale001: checks 
Weegolo: checks 
AKl3gi0n: bets $0.50
attilale001: calls $0.50
Weegolo: folds 
*** TURN *** [2c 3h Ah] [2d]
attilale001: checks 
AKl3gi0n: bets $0.50
attilale001: calls $0.50
*** RIVER *** [2c 3h Ah 2d] [9c]
attilale001: checks 
AKl3gi0n: checks 
*** SHOW DOWN ***
attilale001: shows [Qc Th] (a pair of Deuces)
AKl3gi0n: shows [Ad Td] (two pair, Aces and Deuces)
AKl3gi0n collected $3.70 from pot
*** SUMMARY ***
Total pot $3.85 | Rake $0.15 
Board [2c 3h Ah 2d 9c]
Seat 1: AtrY (big blind) folded before Flop
Seat 2: lxamE folded before Flop (didn't bet)
Seat 3: attilale001 showed [Qc Th] and lost with a pair of Deuces
Seat 4: Weegolo folded on the Flop
Seat 6: AKl3gi0n showed [Ad Td] and won ($3.70) with two pair, Aces and Deuces
Seat 7: dawinci80 folded before Flop (didn't bet)
Seat 8: Ewax (button) folded before Flop (didn't bet)
Seat 9: Alameda22 (small blind) folded before Flop



PokerStars Game #20096232039:  Hold'em No Limit ($0.10/$0.25) - 2008/09/02 15:48:09 ET
Table 'Varsavia' 9-max Seat #9 is the button
Seat 1: AtrY ($23.40 in chips) 
Seat 2: lxamE ($4.65 in chips) 
Seat 3: attilale001 ($3.50 in chips) 
Seat 4: Weegolo ($4.05 in chips) 
Seat 6: AKl3gi0n ($8.30 in chips) 
Seat 7: dawinci80 ($10.15 in chips) 
Seat 8: Ewax ($23.55 in chips) 
Seat 9: Alameda22 ($28.50 in chips) 
AtrY: posts small blind $0.10
lxamE: posts big blind $0.25
chessmanA1: sits out 
*** HOLE CARDS ***
Dealt to Alameda22 [Ks Qs]
attilale001: folds 
Weegolo: calls $0.25
AKl3gi0n: folds 
dawinci80: calls $0.25
Ewax: folds 
Alameda22: folds 
AtrY: folds 
lxamE: checks 
*** FLOP *** [7h 9h 4s]
lxamE: checks 
Weegolo: bets $0.25
dawinci80: calls $0.25
lxamE: calls $0.25
*** TURN *** [7h 9h 4s] [7s]
lxamE: checks 
Weegolo: bets $0.25
dawinci80: calls $0.25
lxamE: calls $0.25
*** RIVER *** [7h 9h 4s 7s] [Ac]
lxamE: bets $1.50
Weegolo: folds 
dawinci80: folds 
Uncalled bet ($1.50) returned to lxamE
lxamE collected $2.25 from pot
lxamE: doesn't show hand 
*** SUMMARY ***
Total pot $2.35 | Rake $0.10 
Board [7h 9h 4s 7s Ac]
Seat 1: AtrY (small blind) folded before Flop
Seat 2: lxamE (big blind) collected ($2.25)
Seat 3: attilale001 folded before Flop (didn't bet)
Seat 4: Weegolo folded on the River
Seat 6: AKl3gi0n folded before Flop (didn't bet)
Seat 7: dawinci80 folded on the River
Seat 8: Ewax folded before Flop (didn't bet)
Seat 9: Alameda22 (button) folded before Flop (didn't bet)



PokerStars Game #20096273383:  Hold'em No Limit ($0.10/$0.25) - 2008/09/02 15:49:51 ET
Table 'Varsavia' 9-max Seat #1 is the button
Seat 1: AtrY ($23.30 in chips) 
Seat 2: lxamE ($6.15 in chips) 
Seat 3: attilale001 ($3.50 in chips) 
Seat 4: Weegolo ($3.30 in chips) 
Seat 6: AKl3gi0n ($8.30 in chips) 
Seat 7: dawinci80 ($9.40 in chips) 
Seat 8: Ewax ($23.55 in chips) 
Seat 9: Alameda22 ($28.50 in chips) 
lxamE: posts small blind $0.10
attilale001: posts big blind $0.25
chessmanA1: sits out 
*** HOLE CARDS ***
Dealt to Alameda22 [3c 4h]
Weegolo: folds 
AKl3gi0n: calls $0.25
dawinci80: folds 
Ewax: folds 
Alameda22: folds 
AtrY: folds 
lxamE: folds 
attilale001: checks 
*** FLOP *** [7c 7s Kh]
attilale001: checks 
AKl3gi0n: bets $0.25
attilale001: folds 
Uncalled bet ($0.25) returned to AKl3gi0n
AKl3gi0n collected $0.60 from pot
AKl3gi0n: doesn't show hand 
*** SUMMARY ***
Total pot $0.60 | Rake $0 
Board [7c 7s Kh]
Seat 1: AtrY (button) folded before Flop (didn't bet)
Seat 2: lxamE (small blind) folded before Flop
Seat 3: attilale001 (big blind) folded on the Flop
Seat 4: Weegolo folded before Flop (didn't bet)
Seat 6: AKl3gi0n collected ($0.60)
Seat 7: dawinci80 folded before Flop (didn't bet)
Seat 8: Ewax folded before Flop (didn't bet)
Seat 9: Alameda22 folded before Flop (didn't bet)



PokerStars Game #20096299750:  Hold'em No Limit ($0.10/$0.25) - 2008/09/02 15:50:57 ET
Table 'Varsavia' 9-max Seat #2 is the button
Seat 1: AtrY ($23.30 in chips) 
Seat 2: lxamE ($6.05 in chips) 
Seat 3: attilale001 ($3.25 in chips) 
Seat 4: Weegolo ($7.30 in chips) 
Seat 6: AKl3gi0n ($8.65 in chips) 
Seat 7: dawinci80 ($9.40 in chips) 
Seat 8: Ewax ($23.55 in chips) 
Seat 9: Alameda22 ($28.50 in chips) 
attilale001: posts small blind $0.10
Weegolo: posts big blind $0.25
chessmanA1: sits out 
*** HOLE CARDS ***
Dealt to Alameda22 [2h Th]
AKl3gi0n: calls $0.25
dawinci80: folds 
Ewax: folds 
Alameda22: folds 
AtrY: raises $1 to $1.25
lxamE: folds 
attilale001: folds 
Weegolo: folds 
AKl3gi0n: calls $1
*** FLOP *** [5h 2c Ad]
AKl3gi0n: bets $0.75
AtrY: raises $2.25 to $3
AKl3gi0n: folds 
Uncalled bet ($2.25) returned to AtrY
AtrY collected $4.15 from pot
AtrY: doesn't show hand 
*** SUMMARY ***
Total pot $4.35 | Rake $0.20 
Board [5h 2c Ad]
Seat 1: AtrY collected ($4.15)
Seat 2: lxamE (button) folded before Flop (didn't bet)
Seat 3: attilale001 (small blind) folded before Flop
Seat 4: Weegolo (big blind) folded before Flop
Seat 6: AKl3gi0n folded on the Flop
Seat 7: dawinci80 folded before Flop (didn't bet)
Seat 8: Ewax folded before Flop (didn't bet)
Seat 9: Alameda22 folded before Flop (didn't bet)



PokerStars Game #20096323509:  Hold'em No Limit ($0.10/$0.25) - 2008/09/02 15:51:56 ET
Table 'Varsavia' 9-max Seat #3 is the button
Seat 1: AtrY ($25.45 in chips) 
Seat 2: lxamE ($6.05 in chips) 
Seat 3: attilale001 ($3.15 in chips) 
Seat 4: Weegolo ($7.05 in chips) 
Seat 5: chessmanA1 ($15 in chips) 
Seat 6: AKl3gi0n ($6.65 in chips) 
Seat 7: dawinci80 ($9.40 in chips) 
Seat 8: Ewax ($23.55 in chips) 
Seat 9: Alameda22 ($28.50 in chips) 
Weegolo: posts small blind $0.10
chessmanA1: posts big blind $0.25
*** HOLE CARDS ***
Dealt to Alameda22 [9d 9c]
AKl3gi0n: calls $0.25
dawinci80: folds 
Ewax: folds 
Alameda22: folds 
AtrY: folds 
lxamE: folds 
attilale001: folds 
Weegolo: calls $0.15
chessmanA1: checks 
*** FLOP *** [Ad 6s 3h]
Weegolo: checks 
chessmanA1: bets $0.75
AKl3gi0n: folds 
Weegolo: folds 
Uncalled bet ($0.75) returned to chessmanA1
chessmanA1 collected $0.75 from pot
chessmanA1: doesn't show hand 
*** SUMMARY ***
Total pot $0.75 | Rake $0 
Board [Ad 6s 3h]
Seat 1: AtrY folded before Flop (didn't bet)
Seat 2: lxamE folded before Flop (didn't bet)
Seat 3: attilale001 (button) folded before Flop (didn't bet)
Seat 4: Weegolo (small blind) folded on the Flop
Seat 5: chessmanA1 (big blind) collected ($0.75)
Seat 6: AKl3gi0n folded on the Flop
Seat 7: dawinci80 folded before Flop (didn't bet)
Seat 8: Ewax folded before Flop (didn't bet)
Seat 9: Alameda22 folded before Flop (didn't bet)



PokerStars Game #20096348062:  Hold'em No Limit ($0.10/$0.25) - 2008/09/02 15:52:57 ET
Table 'Varsavia' 9-max Seat #4 is the button
Seat 1: AtrY ($25.45 in chips) 
Seat 2: lxamE ($6.05 in chips) 
Seat 3: attilale001 ($3.15 in chips) 
Seat 4: Weegolo ($6.80 in chips) 
Seat 5: chessmanA1 ($15.50 in chips) 
Seat 6: AKl3gi0n ($6.40 in chips) 
Seat 7: dawinci80 ($9.40 in chips) 
Seat 8: Ewax ($23.55 in chips) 
Seat 9: Alameda22 ($28.50 in chips) 
chessmanA1: posts small blind $0.10
AKl3gi0n: posts big blind $0.25
*** HOLE CARDS ***
Dealt to Alameda22 [9h 2d]
dawinci80: folds 
Ewax: folds 
Alameda22: folds 
AtrY: raises $0.75 to $1
lxamE: folds 
attilale001: folds 
Weegolo: folds 
chessmanA1: folds 
AKl3gi0n: folds 
Uncalled bet ($0.75) returned to AtrY
AtrY collected $0.60 from pot
AtrY: doesn't show hand 
*** SUMMARY ***
Total pot $0.60 | Rake $0 
Seat 1: AtrY collected ($0.60)
Seat 2: lxamE folded before Flop (didn't bet)
Seat 3: attilale001 folded before Flop (didn't bet)
Seat 4: Weegolo (button) folded before Flop (didn't bet)
Seat 5: chessmanA1 (small blind) folded before Flop
Seat 6: AKl3gi0n (big blind) folded before Flop
Seat 7: dawinci80 folded before Flop (didn't bet)
Seat 8: Ewax folded before Flop (didn't bet)
Seat 9: Alameda22 folded before Flop (didn't bet)



PokerStars Game #20096360245:  Hold'em No Limit ($0.10/$0.25) - 2008/09/02 15:53:27 ET
Table 'Varsavia' 9-max Seat #5 is the button
Seat 1: AtrY ($25.80 in chips) 
Seat 2: lxamE ($6.05 in chips) 
Seat 3: attilale001 ($3.15 in chips) 
Seat 4: Weegolo ($6.80 in chips) 
Seat 5: chessmanA1 ($15.40 in chips) 
Seat 6: AKl3gi0n ($6.15 in chips) 
Seat 7: dawinci80 ($9.40 in chips) 
Seat 8: Ewax ($23.55 in chips) 
Seat 9: Alameda22 ($28.50 in chips) 
AKl3gi0n: posts small blind $0.10
dawinci80: posts big blind $0.25
*** HOLE CARDS ***
Dealt to Alameda22 [Td 9d]
Ewax: folds 
Alameda22: folds 
AtrY: folds 
lxamE: folds 
attilale001: calls $0.25
Weegolo: folds 
chessmanA1: folds 
AKl3gi0n: folds 
dawinci80: checks 
*** FLOP *** [5d Ac 2h]
dawinci80: checks 
attilale001: checks 
*** TURN *** [5d Ac 2h] [7h]
dawinci80: checks 
attilale001: checks 
*** RIVER *** [5d Ac 2h 7h] [5h]
dawinci80: checks 
attilale001: bets $0.25
dawinci80: folds 
Uncalled bet ($0.25) returned to attilale001
attilale001 collected $0.60 from pot
attilale001: doesn't show hand 
*** SUMMARY ***
Total pot $0.60 | Rake $0 
Board [5d Ac 2h 7h 5h]
Seat 1: AtrY folded before Flop (didn't bet)
Seat 2: lxamE folded before Flop (didn't bet)
Seat 3: attilale001 collected ($0.60)
Seat 4: Weegolo folded before Flop (didn't bet)
Seat 5: chessmanA1 (button) folded before Flop (didn't bet)
Seat 6: AKl3gi0n (small blind) folded before Flop
Seat 7: dawinci80 (big blind) folded on the River
Seat 8: Ewax folded before Flop (didn't bet)
Seat 9: Alameda22 folded before Flop (didn't bet)



PokerStars Game #20096392980:  Hold'em No Limit ($0.10/$0.25) - 2008/09/02 15:54:48 ET
Table 'Varsavia' 9-max Seat #6 is the button
Seat 1: AtrY ($25.80 in chips) 
Seat 2: lxamE ($6.05 in chips) 
Seat 3: attilale001 ($3.50 in chips) 
Seat 4: Weegolo ($6.80 in chips) 
Seat 5: chessmanA1 ($15.40 in chips) 
Seat 6: AKl3gi0n ($6.05 in chips) 
Seat 7: dawinci80 ($9.15 in chips) 
Seat 8: Ewax ($23.55 in chips) 
Seat 9: Alameda22 ($28.50 in chips) 
dawinci80: posts small blind $0.10
Ewax: posts big blind $0.25
*** HOLE CARDS ***
Dealt to Alameda22 [2c 5c]
Alameda22: folds 
AtrY: folds 
lxamE: folds 
attilale001: folds 
Weegolo: calls $0.25
chessmanA1: folds 
AKl3gi0n: folds 
dawinci80: calls $0.15
Ewax has timed out
Ewax: folds 
*** FLOP *** [Td Ac Qs]
Ewax is sitting out
dawinci80: checks 
Weegolo: checks 
*** TURN *** [Td Ac Qs] [Jc]
dawinci80: checks 
Weegolo: checks 
*** RIVER *** [Td Ac Qs Jc] [7h]
dawinci80: checks 
Weegolo: checks 
*** SHOW DOWN ***
dawinci80: shows [8h Kc] (a straight, Ten to Ace)
Weegolo: mucks hand 
dawinci80 collected $0.75 from pot
*** SUMMARY ***
Total pot $0.75 | Rake $0 
Board [Td Ac Qs Jc 7h]
Seat 1: AtrY folded before Flop (didn't bet)
Seat 2: lxamE folded before Flop (didn't bet)
Seat 3: attilale001 folded before Flop (didn't bet)
Seat 4: Weegolo mucked [Th Qh]
Seat 5: chessmanA1 folded before Flop (didn't bet)
Seat 6: AKl3gi0n (button) folded before Flop (didn't bet)
Seat 7: dawinci80 (small blind) showed [8h Kc] and won ($0.75) with a straight, Ten to Ace
Seat 8: Ewax (big blind) folded before Flop
Seat 9: Alameda22 folded before Flop (didn't bet)



PokerStars Game #20096454567:  Hold'em No Limit ($0.10/$0.25) - 2008/09/02 15:57:20 ET
Table 'Varsavia' 9-max Seat #7 is the button
Seat 1: AtrY ($25.80 in chips) 
Seat 2: lxamE ($6.05 in chips) 
Seat 3: attilale001 ($3.50 in chips) 
Seat 4: Weegolo ($6.55 in chips) 
Seat 5: chessmanA1 ($15.40 in chips) 
Seat 6: AKl3gi0n ($6.05 in chips) 
Seat 7: dawinci80 ($9.65 in chips) 
Seat 9: Alameda22 ($28.50 in chips) 
Alameda22: posts small blind $0.10
AtrY: posts big blind $0.25
*** HOLE CARDS ***
Dealt to Alameda22 [4h 7s]
lxamE: folds 
lxamE leaves the table
attilale001: folds 
Weegolo: calls $0.25
chessmanA1: folds 
AKl3gi0n: folds 
dawinci80: folds 
Alameda22: folds 
AtrY: checks 
*** FLOP *** [8d Ks Ac]
AtrY: checks 
Weegolo: bets $0.25
AtrY: folds 
Uncalled bet ($0.25) returned to Weegolo
Weegolo collected $0.60 from pot
Weegolo: doesn't show hand 
*** SUMMARY ***
Total pot $0.60 | Rake $0 
Board [8d Ks Ac]
Seat 1: AtrY (big blind) folded on the Flop
Seat 2: lxamE folded before Flop (didn't bet)
Seat 3: attilale001 folded before Flop (didn't bet)
Seat 4: Weegolo collected ($0.60)
Seat 5: chessmanA1 folded before Flop (didn't bet)
Seat 6: AKl3gi0n folded before Flop (didn't bet)
Seat 7: dawinci80 (button) folded before Flop (didn't bet)
Seat 9: Alameda22 (small blind) folded before Flop



PokerStars Game #20096470542:  Hold'em No Limit ($0.10/$0.25) - 2008/09/02 15:58:00 ET
Table 'Varsavia' 9-max Seat #9 is the button
Seat 1: AtrY ($25.55 in chips) 
Seat 3: attilale001 ($3.50 in chips) 
Seat 4: Weegolo ($6.90 in chips) 
Seat 5: chessmanA1 ($15.40 in chips) 
Seat 6: AKl3gi0n ($6.05 in chips) 
Seat 7: dawinci80 ($9.65 in chips) 
Seat 9: Alameda22 ($28.40 in chips) 
AtrY: posts small blind $0.10
attilale001: posts big blind $0.25
*** HOLE CARDS ***
Dealt to Alameda22 [Jh 4h]
Weegolo: folds 
chessmanA1: folds 
AKl3gi0n: folds 
dawinci80: folds 
Alameda22: folds 
AtrY: calls $0.15
attilale001: checks 
*** FLOP *** [Ah Qs 6c]
AtrY: checks 
attilale001: checks 
*** TURN *** [Ah Qs 6c] [Ad]
AtrY: bets $0.50
jmaxsparty joins the table at seat #2 
attilale001: folds 
Uncalled bet ($0.50) returned to AtrY
AtrY collected $0.50 from pot
AtrY: doesn't show hand 
*** SUMMARY ***
Total pot $0.50 | Rake $0 
Board [Ah Qs 6c Ad]
Seat 1: AtrY (small blind) collected ($0.50)
Seat 3: attilale001 (big blind) folded on the Turn
Seat 4: Weegolo folded before Flop (didn't bet)
Seat 5: chessmanA1 folded before Flop (didn't bet)
Seat 6: AKl3gi0n folded before Flop (didn't bet)
Seat 7: dawinci80 folded before Flop (didn't bet)
Seat 9: Alameda22 (button) folded before Flop (didn't bet)



PokerStars Game #20096485330:  Hold'em No Limit ($0.10/$0.25) - 2008/09/02 15:58:36 ET
Table 'Varsavia' 9-max Seat #1 is the button
Seat 1: AtrY ($25.80 in chips) 
Seat 3: attilale001 ($3.25 in chips) 
Seat 4: Weegolo ($6.90 in chips) 
Seat 5: chessmanA1 ($15.40 in chips) 
Seat 6: AKl3gi0n ($6.05 in chips) 
Seat 7: dawinci80 ($9.65 in chips) 
Seat 9: Alameda22 ($28.40 in chips) 
jmaxsparty will be allowed to play after the button
attilale001: posts small blind $0.10
Weegolo: posts big blind $0.25
*** HOLE CARDS ***
Dealt to Alameda22 [4d Jh]
chessmanA1: folds 
AKl3gi0n: folds 
dawinci80: folds 
Alameda22: folds 
AtrY: folds 
attilale001: calls $0.15
Weegolo: checks 
*** FLOP *** [5s Tc Ks]
attilale001: checks 
Weegolo: checks 
*** TURN *** [5s Tc Ks] [Td]
attilale001: checks 
Weegolo: checks 
*** RIVER *** [5s Tc Ks Td] [Qs]
attilale001: checks 
Weegolo: checks 
*** SHOW DOWN ***
attilale001: shows [7d 9d] (a pair of Tens)
Weegolo: shows [Jd 8d] (a pair of Tens - King+Queen+Jack kicker)
Weegolo collected $0.50 from pot
*** SUMMARY ***
Total pot $0.50 | Rake $0 
Board [5s Tc Ks Td Qs]
Seat 1: AtrY (button) folded before Flop (didn't bet)
Seat 3: attilale001 (small blind) showed [7d 9d] and lost with a pair of Tens
Seat 4: Weegolo (big blind) showed [Jd 8d] and won ($0.50) with a pair of Tens
Seat 5: chessmanA1 folded before Flop (didn't bet)
Seat 6: AKl3gi0n folded before Flop (didn't bet)
Seat 7: dawinci80 folded before Flop (didn't bet)
Seat 9: Alameda22 folded before Flop (didn't bet)



PokerStars Game #20096507409:  Hold'em No Limit ($0.10/$0.25) - 2008/09/02 15:59:31 ET
Table 'Varsavia' 9-max Seat #3 is the button
Seat 1: AtrY ($25.80 in chips) 
Seat 2: jmaxsparty ($12 in chips) 
Seat 3: attilale001 ($3 in chips) 
Seat 4: Weegolo ($7.15 in chips) 
Seat 5: chessmanA1 ($15.40 in chips) 
Seat 6: AKl3gi0n ($6.05 in chips) 
Seat 7: dawinci80 ($9.65 in chips) 
Seat 9: Alameda22 ($28.40 in chips) 
Weegolo: posts small blind $0.10
chessmanA1: posts big blind $0.25
jmaxsparty: posts big blind $0.25
*** HOLE CARDS ***
Dealt to Alameda22 [4h 2s]
AKl3gi0n: folds 
dawinci80: calls $0.25
Alameda22: folds 
AtrY: folds 
jmaxsparty: checks 
attilale001: folds 
Weegolo: calls $0.15
chessmanA1: checks 
*** FLOP *** [Qs Ac Qc]
Weegolo: checks 
chessmanA1: checks 
dawinci80: checks 
jmaxsparty: checks 
*** TURN *** [Qs Ac Qc] [Ah]
Weegolo: bets $0.50
chessmanA1: folds 
dawinci80: folds 
jmaxsparty: folds 
Uncalled bet ($0.50) returned to Weegolo
Weegolo collected $0.95 from pot
*** SUMMARY ***
Total pot $1 | Rake $0.05 
Board [Qs Ac Qc Ah]
Seat 1: AtrY folded before Flop (didn't bet)
Seat 2: jmaxsparty folded on the Turn
Seat 3: attilale001 (button) folded before Flop (didn't bet)
Seat 4: Weegolo (small blind) collected ($0.95)
Seat 5: chessmanA1 (big blind) folded on the Turn
Seat 6: AKl3gi0n folded before Flop (didn't bet)
Seat 7: dawinci80 folded on the Turn
Seat 9: Alameda22 folded before Flop (didn't bet)



PokerStars Game #20096543703:  Hold'em No Limit ($0.10/$0.25) - 2008/09/02 16:00:59 ET
Table 'Varsavia' 9-max Seat #4 is the button
Seat 1: AtrY ($25.80 in chips) 
Seat 2: jmaxsparty ($11.75 in chips) 
Seat 3: attilale001 ($3 in chips) 
Seat 4: Weegolo ($7.85 in chips) 
Seat 5: chessmanA1 ($15.15 in chips) 
Seat 6: AKl3gi0n ($6.05 in chips) 
Seat 7: dawinci80 ($9.40 in chips) 
Seat 9: Alameda22 ($28.40 in chips) 
chessmanA1: posts small blind $0.10
AKl3gi0n: posts big blind $0.25
*** HOLE CARDS ***
Dealt to Alameda22 [7h 3c]
dawinci80: folds 
Alameda22: folds 
AtrY: folds 
jmaxsparty: folds 
attilale001: folds 
Weegolo: calls $0.25
chessmanA1: calls $0.15
AKl3gi0n: checks 
*** FLOP *** [7s 2d 2s]
chessmanA1: checks 
AKl3gi0n: checks 
Weegolo: checks 
*** TURN *** [7s 2d 2s] [4c]
chessmanA1: checks 
AKl3gi0n: checks 
Weegolo: checks 
*** RIVER *** [7s 2d 2s 4c] [5s]
chessmanA1: checks 
AKl3gi0n: checks 
Weegolo: checks 
*** SHOW DOWN ***
chessmanA1: shows [Jc Ad] (a pair of Deuces)
AKl3gi0n: mucks hand 
Weegolo: mucks hand 
chessmanA1 collected $0.75 from pot
*** SUMMARY ***
Total pot $0.75 | Rake $0 
Board [7s 2d 2s 4c 5s]
Seat 1: AtrY folded before Flop (didn't bet)
Seat 2: jmaxsparty folded before Flop (didn't bet)
Seat 3: attilale001 folded before Flop (didn't bet)
Seat 4: Weegolo (button) mucked [8s Ah]
Seat 5: chessmanA1 (small blind) showed [Jc Ad] and won ($0.75) with a pair of Deuces
Seat 6: AKl3gi0n (big blind) mucked [Kd 9d]
Seat 7: dawinci80 folded before Flop (didn't bet)
Seat 9: Alameda22 folded before Flop (didn't bet)



PokerStars Game #20096584417:  Hold'em No Limit ($0.10/$0.25) - 2008/09/02 16:02:38 ET
Table 'Varsavia' 9-max Seat #5 is the button
Seat 1: AtrY ($25.80 in chips) 
Seat 2: jmaxsparty ($11.75 in chips) 
Seat 3: attilale001 ($3 in chips) 
Seat 4: Weegolo ($7.60 in chips) 
Seat 5: chessmanA1 ($15.65 in chips) 
Seat 6: AKl3gi0n ($5.80 in chips) 
Seat 7: dawinci80 ($9.40 in chips) 
Seat 9: Alameda22 ($28.40 in chips) 
AKl3gi0n: posts small blind $0.10
dawinci80: posts big blind $0.25
*** HOLE CARDS ***
Dealt to Alameda22 [7c 4h]
Alameda22: folds 
AtrY: folds 
jmaxsparty: calls $0.25
attilale001: folds 
Weegolo: folds 
chessmanA1: folds 
AKl3gi0n: calls $0.15
dawinci80: checks 
*** FLOP *** [Td 7h 4c]
AKl3gi0n: bets $0.25
dawinci80: calls $0.25
jmaxsparty: raises $0.45 to $0.70
AKl3gi0n: folds 
dawinci80: folds 
Uncalled bet ($0.45) returned to jmaxsparty
jmaxsparty collected $1.45 from pot
jmaxsparty: doesn't show hand 
*** SUMMARY ***
Total pot $1.50 | Rake $0.05 
Board [Td 7h 4c]
Seat 1: AtrY folded before Flop (didn't bet)
Seat 2: jmaxsparty collected ($1.45)
Seat 3: attilale001 folded before Flop (didn't bet)
Seat 4: Weegolo folded before Flop (didn't bet)
Seat 5: chessmanA1 (button) folded before Flop (didn't bet)
Seat 6: AKl3gi0n (small blind) folded on the Flop
Seat 7: dawinci80 (big blind) folded on the Flop
Seat 9: Alameda22 folded before Flop (didn't bet)



PokerStars Game #20096604191:  Hold'em No Limit ($0.10/$0.25) - 2008/09/02 16:03:27 ET
Table 'Varsavia' 9-max Seat #6 is the button
Seat 1: AtrY ($25.80 in chips) 
Seat 2: jmaxsparty ($12.70 in chips) 
Seat 3: attilale001 ($3 in chips) 
Seat 4: Weegolo ($7.60 in chips) 
Seat 5: chessmanA1 ($15.65 in chips) 
Seat 6: AKl3gi0n ($5.30 in chips) 
Seat 7: dawinci80 ($8.90 in chips) 
Seat 9: Alameda22 ($28.40 in chips) 
dawinci80: posts small blind $0.10
Alameda22: posts big blind $0.25
*** HOLE CARDS ***
Dealt to Alameda22 [Qs 5s]
AtrY: folds 
jmaxsparty: calls $0.25
attilale001: folds 
Weegolo: raises $0.25 to $0.50
chessmanA1: folds 
AKl3gi0n: folds 
dawinci80: folds 
Alameda22: folds 
jmaxsparty: calls $0.25
*** FLOP *** [Ah 3h Kd]
jmaxsparty: checks 
Weegolo: bets $0.75
jmaxsparty: folds 
Uncalled bet ($0.75) returned to Weegolo
Weegolo collected $1.30 from pot
Weegolo: doesn't show hand 
*** SUMMARY ***
Total pot $1.35 | Rake $0.05 
Board [Ah 3h Kd]
Seat 1: AtrY folded before Flop (didn't bet)
Seat 2: jmaxsparty folded on the Flop
Seat 3: attilale001 folded before Flop (didn't bet)
Seat 4: Weegolo collected ($1.30)
Seat 5: chessmanA1 folded before Flop (didn't bet)
Seat 6: AKl3gi0n (button) folded before Flop (didn't bet)
Seat 7: dawinci80 (small blind) folded before Flop
Seat 9: Alameda22 (big blind) folded before Flop



PokerStars Game #20096629521:  Hold'em No Limit ($0.10/$0.25) - 2008/09/02 16:04:28 ET
Table 'Varsavia' 9-max Seat #7 is the button
Seat 1: AtrY ($25.80 in chips) 
Seat 2: jmaxsparty ($12.20 in chips) 
Seat 3: attilale001 ($3 in chips) 
Seat 4: Weegolo ($8.40 in chips) 
Seat 5: chessmanA1 ($15.65 in chips) 
Seat 6: AKl3gi0n ($5.30 in chips) 
Seat 7: dawinci80 ($8.80 in chips) 
Seat 9: Alameda22 ($28.15 in chips) 
Alameda22: posts small blind $0.10
AtrY: posts big blind $0.25
*** HOLE CARDS ***
Dealt to Alameda22 [4h 5h]
jmaxsparty: folds 
attilale001: folds 
Weegolo: folds 
chessmanA1: folds 
AKl3gi0n: calls $0.25
dawinci80: folds 
Alameda22: folds 
AtrY: checks 
*** FLOP *** [7d 2c 6s]
AtrY: bets $0.50
AKl3gi0n: raises $0.50 to $1
AtrY: folds 
Uncalled bet ($0.50) returned to AKl3gi0n
AKl3gi0n collected $1.55 from pot
AKl3gi0n: doesn't show hand 
*** SUMMARY ***
Total pot $1.60 | Rake $0.05 
Board [7d 2c 6s]
Seat 1: AtrY (big blind) folded on the Flop
Seat 2: jmaxsparty folded before Flop (didn't bet)
Seat 3: attilale001 folded before Flop (didn't bet)
Seat 4: Weegolo folded before Flop (didn't bet)
Seat 5: chessmanA1 folded before Flop (didn't bet)
Seat 6: AKl3gi0n collected ($1.55)
Seat 7: dawinci80 (button) folded before Flop (didn't bet)
Seat 9: Alameda22 (small blind) folded before Flop



PokerStars Game #20096645827:  Hold'em No Limit ($0.10/$0.25) - 2008/09/02 16:05:07 ET
Table 'Varsavia' 9-max Seat #9 is the button
Seat 1: AtrY ($25.05 in chips) 
Seat 2: jmaxsparty ($12.20 in chips) 
Seat 3: attilale001 ($3 in chips) 
Seat 4: Weegolo ($8.40 in chips) 
Seat 5: chessmanA1 ($15.65 in chips) 
Seat 6: AKl3gi0n ($6.10 in chips) 
Seat 7: dawinci80 ($8.80 in chips) 
Seat 9: Alameda22 ($28.05 in chips) 
AtrY: posts small blind $0.10
jmaxsparty: posts big blind $0.25
*** HOLE CARDS ***
Dealt to Alameda22 [4d 5s]
attilale001: calls $0.25
Weegolo: folds 
chessmanA1: folds 
AKl3gi0n: folds 
dawinci80: folds 
Alameda22: folds 
AtrY: folds 
jmaxsparty: checks 
*** FLOP *** [5d 4s 6h]
jmaxsparty: bets $0.25
attilale001: calls $0.25
*** TURN *** [5d 4s 6h] [9c]
jmaxsparty: bets $0.75
attilale001: calls $0.75
*** RIVER *** [5d 4s 6h 9c] [7d]
jmaxsparty: checks 
attilale001: checks 
*** SHOW DOWN ***
jmaxsparty: shows [9h 6d] (two pair, Nines and Sixes)
attilale001: mucks hand 
jmaxsparty collected $2.50 from pot
*** SUMMARY ***
Total pot $2.60 | Rake $0.10 
Board [5d 4s 6h 9c 7d]
Seat 1: AtrY (small blind) folded before Flop
Seat 2: jmaxsparty (big blind) showed [9h 6d] and won ($2.50) with two pair, Nines and Sixes
Seat 3: attilale001 mucked [4c Ah]
Seat 4: Weegolo folded before Flop (didn't bet)
Seat 5: chessmanA1 folded before Flop (didn't bet)
Seat 6: AKl3gi0n folded before Flop (didn't bet)
Seat 7: dawinci80 folded before Flop (didn't bet)
Seat 9: Alameda22 (button) folded before Flop (didn't bet)



PokerStars Game #20096675219:  Hold'em No Limit ($0.10/$0.25) - 2008/09/02 16:06:19 ET
Table 'Varsavia' 9-max Seat #1 is the button
Seat 1: AtrY ($24.95 in chips) 
Seat 2: jmaxsparty ($13.45 in chips) 
Seat 3: attilale001 ($1.75 in chips) 
Seat 4: Weegolo ($8.40 in chips) 
Seat 5: chessmanA1 ($15.65 in chips) 
Seat 6: AKl3gi0n ($6.10 in chips) 
Seat 7: dawinci80 ($8.80 in chips) 
Seat 9: Alameda22 ($28.05 in chips) 
jmaxsparty: posts small blind $0.10
attilale001: posts big blind $0.25
*** HOLE CARDS ***
Dealt to Alameda22 [Th 3h]
Weegolo: folds 
chessmanA1: folds 
AKl3gi0n: raises $0.25 to $0.50
dawinci80: calls $0.50
Alameda22: folds 
AtrY: folds 
Ewax has returned
jmaxsparty: folds 
attilale001: folds 
*** FLOP *** [2h 8c 5s]
AKl3gi0n: bets $1
dawinci80: folds 
Uncalled bet ($1) returned to AKl3gi0n
AKl3gi0n collected $1.30 from pot
*** SUMMARY ***
Total pot $1.35 | Rake $0.05 
Board [2h 8c 5s]
Seat 1: AtrY (button) folded before Flop (didn't bet)
Seat 2: jmaxsparty (small blind) folded before Flop
Seat 3: attilale001 (big blind) folded before Flop
Seat 4: Weegolo folded before Flop (didn't bet)
Seat 5: chessmanA1 folded before Flop (didn't bet)
Seat 6: AKl3gi0n collected ($1.30)
Seat 7: dawinci80 folded on the Flop
Seat 9: Alameda22 folded before Flop (didn't bet)



PokerStars Game #20096703409:  Hold'em No Limit ($0.10/$0.25) - 2008/09/02 16:07:26 ET
Table 'Varsavia' 9-max Seat #2 is the button
Seat 1: AtrY ($24.95 in chips) 
Seat 2: jmaxsparty ($13.35 in chips) 
Seat 3: attilale001 ($1.50 in chips) 
Seat 4: Weegolo ($8.40 in chips) 
Seat 5: chessmanA1 ($15.65 in chips) 
Seat 6: AKl3gi0n ($6.90 in chips) 
Seat 7: dawinci80 ($8.30 in chips) 
Seat 9: Alameda22 ($28.05 in chips) 
attilale001: posts small blind $0.10
Weegolo: posts big blind $0.25
Ewax: sits out 
*** HOLE CARDS ***
Dealt to Alameda22 [6d Th]
chessmanA1: folds 
AKl3gi0n: folds 
dawinci80: folds 
Alameda22: folds 
AtrY: folds 
jmaxsparty: folds 
attilale001: folds 
Uncalled bet ($0.15) returned to Weegolo
Weegolo collected $0.20 from pot
*** SUMMARY ***
Total pot $0.20 | Rake $0 
Seat 1: AtrY folded before Flop (didn't bet)
Seat 2: jmaxsparty (button) folded before Flop (didn't bet)
Seat 3: attilale001 (small blind) folded before Flop
Seat 4: Weegolo (big blind) collected ($0.20)
Seat 5: chessmanA1 folded before Flop (didn't bet)
Seat 6: AKl3gi0n folded before Flop (didn't bet)
Seat 7: dawinci80 folded before Flop (didn't bet)
Seat 9: Alameda22 folded before Flop (didn't bet)



PokerStars Game #20096721751:  Hold'em No Limit ($0.10/$0.25) - 2008/09/02 16:08:10 ET
Table 'Varsavia' 9-max Seat #3 is the button
Seat 1: AtrY ($24.95 in chips) 
Seat 2: jmaxsparty ($13.35 in chips) 
Seat 3: attilale001 ($1.40 in chips) 
Seat 4: Weegolo ($8.50 in chips) 
Seat 5: chessmanA1 ($15.65 in chips) 
Seat 6: AKl3gi0n ($6.90 in chips) 
Seat 7: dawinci80 ($8.30 in chips) 
Seat 9: Alameda22 ($28.05 in chips) 
Weegolo: posts small blind $0.10
chessmanA1: posts big blind $0.25
Ewax: sits out 
*** HOLE CARDS ***
Dealt to Alameda22 [Th 2d]
AKl3gi0n: folds 
dawinci80: folds 
Alameda22: folds 
AtrY: folds 
jmaxsparty: raises $0.25 to $0.50
attilale001: folds 
Weegolo: folds 
chessmanA1: folds 
Uncalled bet ($0.25) returned to jmaxsparty
jmaxsparty collected $0.60 from pot
jmaxsparty: doesn't show hand 
*** SUMMARY ***
Total pot $0.60 | Rake $0 
Seat 1: AtrY folded before Flop (didn't bet)
Seat 2: jmaxsparty collected ($0.60)
Seat 3: attilale001 (button) folded before Flop (didn't bet)
Seat 4: Weegolo (small blind) folded before Flop
Seat 5: chessmanA1 (big blind) folded before Flop
Seat 6: AKl3gi0n folded before Flop (didn't bet)
Seat 7: dawinci80 folded before Flop (didn't bet)
Seat 9: Alameda22 folded before Flop (didn't bet)



PokerStars Game #20096737326:  Hold'em No Limit ($0.10/$0.25) - 2008/09/02 16:08:47 ET
Table 'Varsavia' 9-max Seat #4 is the button
Seat 1: AtrY ($24.95 in chips) 
Seat 2: jmaxsparty ($13.70 in chips) 
Seat 3: attilale001 ($1.40 in chips) 
Seat 4: Weegolo ($8.40 in chips) 
Seat 5: chessmanA1 ($15.40 in chips) 
Seat 6: AKl3gi0n ($6.90 in chips) 
Seat 7: dawinci80 ($8.30 in chips) 
Seat 9: Alameda22 ($28.05 in chips) 
chessmanA1: posts small blind $0.10
AKl3gi0n: posts big blind $0.25
Ewax: sits out 
*** HOLE CARDS ***
Dealt to Alameda22 [Th 8d]
dawinci80: folds 
Alameda22: folds 
AtrY: folds 
jmaxsparty: folds 
attilale001: calls $0.25
Weegolo: folds 
chessmanA1: folds 
AKl3gi0n: checks 
*** FLOP *** [2c 3h 9d]
AKl3gi0n: checks 
attilale001: checks 
*** TURN *** [2c 3h 9d] [4h]
AKl3gi0n: bets $0.50
attilale001: folds 
Uncalled bet ($0.50) returned to AKl3gi0n
AKl3gi0n collected $0.60 from pot
AKl3gi0n: doesn't show hand 
*** SUMMARY ***
Total pot $0.60 | Rake $0 
Board [2c 3h 9d 4h]
Seat 1: AtrY folded before Flop (didn't bet)
Seat 2: jmaxsparty folded before Flop (didn't bet)
Seat 3: attilale001 folded on the Turn
Seat 4: Weegolo (button) folded before Flop (didn't bet)
Seat 5: chessmanA1 (small blind) folded before Flop
Seat 6: AKl3gi0n (big blind) collected ($0.60)
Seat 7: dawinci80 folded before Flop (didn't bet)
Seat 9: Alameda22 folded before Flop (didn't bet)



PokerStars Game #20096760098:  Hold'em No Limit ($0.10/$0.25) - 2008/09/02 16:09:42 ET
Table 'Varsavia' 9-max Seat #5 is the button
Seat 1: AtrY ($24.95 in chips) 
Seat 2: jmaxsparty ($13.70 in chips) 
Seat 3: attilale001 ($1.15 in chips) 
Seat 4: Weegolo ($8.40 in chips) 
Seat 5: chessmanA1 ($15.30 in chips) 
Seat 6: AKl3gi0n ($7.25 in chips) 
Seat 7: dawinci80 ($8.30 in chips) 
Seat 9: Alameda22 ($28.05 in chips) 
AKl3gi0n: posts small blind $0.10
dawinci80: posts big blind $0.25
Ewax: sits out 
*** HOLE CARDS ***
Dealt to Alameda22 [As 4h]
Alameda22: folds 
AtrY: folds 
jmaxsparty: folds 
attilale001: folds 
Weegolo: folds 
chessmanA1: folds 
AKl3gi0n: calls $0.15
dawinci80: raises $0.75 to $1
AKl3gi0n: calls $0.75
*** FLOP *** [6d 8s Ks]
AKl3gi0n: checks 
dawinci80: bets $1
AKl3gi0n: folds 
Uncalled bet ($1) returned to dawinci80
dawinci80 collected $1.90 from pot
*** SUMMARY ***
Total pot $2 | Rake $0.10 
Board [6d 8s Ks]
Seat 1: AtrY folded before Flop (didn't bet)
Seat 2: jmaxsparty folded before Flop (didn't bet)
Seat 3: attilale001 folded before Flop (didn't bet)
Seat 4: Weegolo folded before Flop (didn't bet)
Seat 5: chessmanA1 (button) folded before Flop (didn't bet)
Seat 6: AKl3gi0n (small blind) folded on the Flop
Seat 7: dawinci80 (big blind) collected ($1.90)
Seat 9: Alameda22 folded before Flop (didn't bet)



PokerStars Game #20096795199:  Hold'em No Limit ($0.10/$0.25) - 2008/09/02 16:11:06 ET
Table 'Varsavia' 9-max Seat #6 is the button
Seat 1: AtrY ($24.95 in chips) 
Seat 2: jmaxsparty ($13.70 in chips) 
Seat 3: attilale001 ($1.15 in chips) 
Seat 4: Weegolo ($8.40 in chips) 
Seat 5: chessmanA1 ($15.30 in chips) 
Seat 6: AKl3gi0n ($6.25 in chips) 
Seat 7: dawinci80 ($9.20 in chips) 
Seat 8: Ewax ($23.30 in chips) 
Seat 9: Alameda22 ($28.05 in chips) 
dawinci80: posts small blind $0.10
Ewax: posts big blind $0.25
*** HOLE CARDS ***
Dealt to Alameda22 [6h 3s]
Alameda22: folds 
AtrY: folds 
jmaxsparty: raises $0.25 to $0.50
attilale001: calls $0.50
Weegolo: calls $0.50
chessmanA1: folds 
AKl3gi0n: folds 
dawinci80: calls $0.40
Ewax: folds 
*** FLOP *** [Ts 6c Jc]
dawinci80: bets $1
jmaxsparty: calls $1
attilale001: calls $0.65 and is all-in
Weegolo: folds 
*** TURN *** [Ts 6c Jc] [Tc]
dawinci80: bets $0.50
jmaxsparty: calls $0.50
*** RIVER *** [Ts 6c Jc Tc] [8d]
dawinci80: bets $0.75
jmaxsparty: folds 
Uncalled bet ($0.75) returned to dawinci80
*** SHOW DOWN ***
dawinci80: shows [Js Ah] (two pair, Jacks and Tens)
dawinci80 collected $1.65 from side pot
attilale001: mucks hand 
dawinci80 collected $4 from main pot
*** SUMMARY ***
Total pot $5.90 Main pot $4. Side pot $1.65. | Rake $0.25 
Board [Ts 6c Jc Tc 8d]
Seat 1: AtrY folded before Flop (didn't bet)
Seat 2: jmaxsparty folded on the River
Seat 3: attilale001 mucked [As 4d]
Seat 4: Weegolo folded on the Flop
Seat 5: chessmanA1 folded before Flop (didn't bet)
Seat 6: AKl3gi0n (button) folded before Flop (didn't bet)
Seat 7: dawinci80 (small blind) showed [Js Ah] and won ($5.65) with two pair, Jacks and Tens
Seat 8: Ewax (big blind) folded before Flop
Seat 9: Alameda22 folded before Flop (didn't bet)



PokerStars Game #20096830265:  Hold'em No Limit ($0.10/$0.25) - 2008/09/02 16:12:31 ET
Table 'Varsavia' 9-max Seat #7 is the button
Seat 1: AtrY ($24.95 in chips) 
Seat 2: jmaxsparty ($11.70 in chips) 
Seat 3: attilale001 ($5 in chips) 
Seat 4: Weegolo ($7.90 in chips) 
Seat 5: chessmanA1 ($15.30 in chips) 
Seat 6: AKl3gi0n ($6.25 in chips) 
Seat 7: dawinci80 ($12.85 in chips) 
Seat 8: Ewax ($23.05 in chips) 
Seat 9: Alameda22 ($28.05 in chips) 
Ewax: posts small blind $0.10
Alameda22: posts big blind $0.25
*** HOLE CARDS ***
Dealt to Alameda22 [3c 6h]
AtrY: folds 
jmaxsparty: folds 
attilale001: folds 
Weegolo: folds 
chessmanA1: folds 
AKl3gi0n: folds 
dawinci80: raises $0.75 to $1
Ewax: folds 
Alameda22: folds 
Uncalled bet ($0.75) returned to dawinci80
dawinci80 collected $0.60 from pot
*** SUMMARY ***
Total pot $0.60 | Rake $0 
Seat 1: AtrY folded before Flop (didn't bet)
Seat 2: jmaxsparty folded before Flop (didn't bet)
Seat 3: attilale001 folded before Flop (didn't bet)
Seat 4: Weegolo folded before Flop (didn't bet)
Seat 5: chessmanA1 folded before Flop (didn't bet)
Seat 6: AKl3gi0n folded before Flop (didn't bet)
Seat 7: dawinci80 (button) collected ($0.60)
Seat 8: Ewax (small blind) folded before Flop
Seat 9: Alameda22 (big blind) folded before Flop



PokerStars Game #20096846399:  Hold'em No Limit ($0.10/$0.25) - 2008/09/02 16:13:09 ET
Table 'Varsavia' 9-max Seat #8 is the button
Seat 1: AtrY ($24.95 in chips) 
Seat 2: jmaxsparty ($11.70 in chips) 
Seat 3: attilale001 ($5 in chips) 
Seat 4: Weegolo ($7.90 in chips) 
Seat 5: chessmanA1 ($15.30 in chips) 
Seat 6: AKl3gi0n ($6.25 in chips) 
Seat 7: dawinci80 ($13.20 in chips) 
Seat 8: Ewax ($22.95 in chips) 
Seat 9: Alameda22 ($27.80 in chips) 
Alameda22: posts small blind $0.10
AtrY: posts big blind $0.25
*** HOLE CARDS ***
Dealt to Alameda22 [Kh 2d]
jmaxsparty: folds 
attilale001: folds 
Weegolo: folds 
chessmanA1: folds 
AKl3gi0n: folds 
dawinci80: folds 
Ewax: folds 
Alameda22: folds 
Uncalled bet ($0.15) returned to AtrY
AtrY collected $0.20 from pot
AtrY: doesn't show hand 
*** SUMMARY ***
Total pot $0.20 | Rake $0 
Seat 1: AtrY (big blind) collected ($0.20)
Seat 2: jmaxsparty folded before Flop (didn't bet)
Seat 3: attilale001 folded before Flop (didn't bet)
Seat 4: Weegolo folded before Flop (didn't bet)
Seat 5: chessmanA1 folded before Flop (didn't bet)
Seat 6: AKl3gi0n folded before Flop (didn't bet)
Seat 7: dawinci80 folded before Flop (didn't bet)
Seat 8: Ewax (button) folded before Flop (didn't bet)
Seat 9: Alameda22 (small blind) folded before Flop



PokerStars Game #20096858641:  Hold'em No Limit ($0.10/$0.25) - 2008/09/02 16:13:38 ET
Table 'Varsavia' 9-max Seat #9 is the button
Seat 1: AtrY ($25.05 in chips) 
Seat 2: jmaxsparty ($11.70 in chips) 
Seat 3: attilale001 ($5 in chips) 
Seat 4: Weegolo ($7.90 in chips) 
Seat 5: chessmanA1 ($15.30 in chips) 
Seat 6: AKl3gi0n ($6.25 in chips) 
Seat 7: dawinci80 ($13.20 in chips) 
Seat 8: Ewax ($22.95 in chips) 
Seat 9: Alameda22 ($27.70 in chips) 
AtrY: posts small blind $0.10
jmaxsparty: posts big blind $0.25
*** HOLE CARDS ***
Dealt to Alameda22 [Jc 3c]
attilale001: folds 
Weegolo: folds 
chessmanA1: folds 
AKl3gi0n: folds 
dawinci80: folds 
Ewax: folds 
Alameda22: folds 
AtrY: folds 
Uncalled bet ($0.15) returned to jmaxsparty
jmaxsparty collected $0.20 from pot
jmaxsparty: doesn't show hand 
*** SUMMARY ***
Total pot $0.20 | Rake $0 
Seat 1: AtrY (small blind) folded before Flop
Seat 2: jmaxsparty (big blind) collected ($0.20)
Seat 3: attilale001 folded before Flop (didn't bet)
Seat 4: Weegolo folded before Flop (didn't bet)
Seat 5: chessmanA1 folded before Flop (didn't bet)
Seat 6: AKl3gi0n folded before Flop (didn't bet)
Seat 7: dawinci80 folded before Flop (didn't bet)
Seat 8: Ewax folded before Flop (didn't bet)
Seat 9: Alameda22 (button) folded before Flop (didn't bet)



PokerStars Game #20096870433:  Hold'em No Limit ($0.10/$0.25) - 2008/09/02 16:14:06 ET
Table 'Varsavia' 9-max Seat #1 is the button
Seat 1: AtrY ($24.95 in chips) 
Seat 2: jmaxsparty ($11.80 in chips) 
Seat 3: attilale001 ($5 in chips) 
Seat 4: Weegolo ($7.90 in chips) 
Seat 5: chessmanA1 ($15.30 in chips) 
Seat 6: AKl3gi0n ($6.25 in chips) 
Seat 7: dawinci80 ($13.20 in chips) 
Seat 8: Ewax ($22.95 in chips) 
Seat 9: Alameda22 ($27.70 in chips) 
jmaxsparty: posts small blind $0.10
attilale001: posts big blind $0.25
*** HOLE CARDS ***
Dealt to Alameda22 [Th 3h]
Weegolo: folds 
chessmanA1: folds 
AKl3gi0n: folds 
dawinci80: folds 
Ewax: folds 
Alameda22: folds 
AtrY: folds 
jmaxsparty: calls $0.15
attilale001: checks 
*** FLOP *** [Kh 4d 9c]
jmaxsparty: checks 
attilale001: checks 
*** TURN *** [Kh 4d 9c] [Qs]
jmaxsparty: bets $0.25
attilale001: folds 
Uncalled bet ($0.25) returned to jmaxsparty
jmaxsparty collected $0.50 from pot
jmaxsparty: doesn't show hand 
*** SUMMARY ***
Total pot $0.50 | Rake $0 
Board [Kh 4d 9c Qs]
Seat 1: AtrY (button) folded before Flop (didn't bet)
Seat 2: jmaxsparty (small blind) collected ($0.50)
Seat 3: attilale001 (big blind) folded on the Turn
Seat 4: Weegolo folded before Flop (didn't bet)
Seat 5: chessmanA1 folded before Flop (didn't bet)
Seat 6: AKl3gi0n folded before Flop (didn't bet)
Seat 7: dawinci80 folded before Flop (didn't bet)
Seat 8: Ewax folded before Flop (didn't bet)
Seat 9: Alameda22 folded before Flop (didn't bet)



PokerStars Game #20096889377:  Hold'em No Limit ($0.10/$0.25) - 2008/09/02 16:14:51 ET
Table 'Varsavia' 9-max Seat #2 is the button
Seat 1: AtrY ($24.95 in chips) 
Seat 2: jmaxsparty ($12.05 in chips) 
Seat 3: attilale001 ($4.75 in chips) 
Seat 4: Weegolo ($7.90 in chips) 
Seat 5: chessmanA1 ($15.30 in chips) 
Seat 6: AKl3gi0n ($6.25 in chips) 
Seat 7: dawinci80 ($13.20 in chips) 
Seat 8: Ewax ($22.95 in chips) 
Seat 9: Alameda22 ($27.70 in chips) 
attilale001: posts small blind $0.10
Weegolo: posts big blind $0.25
*** HOLE CARDS ***
Dealt to Alameda22 [6d 6c]
chessmanA1: folds 
AKl3gi0n: folds 
dawinci80: folds 
Ewax: folds 
Alameda22: folds 
AtrY: raises $0.75 to $1
jmaxsparty: folds 
attilale001: folds 
Weegolo: folds 
Uncalled bet ($0.75) returned to AtrY
AtrY collected $0.60 from pot
AtrY: doesn't show hand 
*** SUMMARY ***
Total pot $0.60 | Rake $0 
Seat 1: AtrY collected ($0.60)
Seat 2: jmaxsparty (button) folded before Flop (didn't bet)
Seat 3: attilale001 (small blind) folded before Flop
Seat 4: Weegolo (big blind) folded before Flop
Seat 5: chessmanA1 folded before Flop (didn't bet)
Seat 6: AKl3gi0n folded before Flop (didn't bet)
Seat 7: dawinci80 folded before Flop (didn't bet)
Seat 8: Ewax folded before Flop (didn't bet)
Seat 9: Alameda22 folded before Flop (didn't bet)



PokerStars Game #20096903744:  Hold'em No Limit ($0.10/$0.25) - 2008/09/02 16:15:25 ET
Table 'Varsavia' 9-max Seat #3 is the button
Seat 1: AtrY ($25.30 in chips) 
Seat 2: jmaxsparty ($12.05 in chips) 
Seat 3: attilale001 ($4.65 in chips) 
Seat 4: Weegolo ($7.65 in chips) 
Seat 5: chessmanA1 ($15.30 in chips) 
Seat 6: AKl3gi0n ($6.25 in chips) 
Seat 7: dawinci80 ($13.20 in chips) 
Seat 8: Ewax ($22.95 in chips) 
Seat 9: Alameda22 ($27.70 in chips) 
Weegolo: posts small blind $0.10
chessmanA1: posts big blind $0.25
*** HOLE CARDS ***
Dealt to Alameda22 [5s Ts]
AKl3gi0n: folds 
dawinci80: folds 
Ewax: folds 
Alameda22: folds 
AtrY: raises $0.75 to $1
jmaxsparty: folds 
jmaxsparty is sitting out
attilale001: folds 
Weegolo: folds 
chessmanA1: folds 
Uncalled bet ($0.75) returned to AtrY
AtrY collected $0.60 from pot
AtrY: doesn't show hand 
*** SUMMARY ***
Total pot $0.60 | Rake $0 
Seat 1: AtrY collected ($0.60)
Seat 2: jmaxsparty folded before Flop (didn't bet)
Seat 3: attilale001 (button) folded before Flop (didn't bet)
Seat 4: Weegolo (small blind) folded before Flop
Seat 5: chessmanA1 (big blind) folded before Flop
Seat 6: AKl3gi0n folded before Flop (didn't bet)
Seat 7: dawinci80 folded before Flop (didn't bet)
Seat 8: Ewax folded before Flop (didn't bet)
Seat 9: Alameda22 folded before Flop (didn't bet)



PokerStars Game #20096929146:  Hold'em No Limit ($0.10/$0.25) - 2008/09/02 16:16:25 ET
Table 'Varsavia' 9-max Seat #4 is the button
Seat 1: AtrY ($25.65 in chips) 
Seat 3: attilale001 ($4.65 in chips) 
Seat 4: Weegolo ($7.55 in chips) 
Seat 5: chessmanA1 ($15.05 in chips) 
Seat 6: AKl3gi0n ($6.25 in chips) 
Seat 7: dawinci80 ($13.20 in chips) 
Seat 8: Ewax ($22.95 in chips) 
Seat 9: Alameda22 ($27.70 in chips) 
chessmanA1: posts small blind $0.10
AKl3gi0n: posts big blind $0.25
*** HOLE CARDS ***
Dealt to Alameda22 [9d 5s]
dawinci80: raises $0.75 to $1
Ewax: folds 
Alameda22: folds 
AtrY: folds 
attilale001: folds 
Weegolo: folds 
chessmanA1: folds 
AKl3gi0n: folds 
Uncalled bet ($0.75) returned to dawinci80
dawinci80 collected $0.60 from pot
*** SUMMARY ***
Total pot $0.60 | Rake $0 
Seat 1: AtrY folded before Flop (didn't bet)
Seat 3: attilale001 folded before Flop (didn't bet)
Seat 4: Weegolo (button) folded before Flop (didn't bet)
Seat 5: chessmanA1 (small blind) folded before Flop
Seat 6: AKl3gi0n (big blind) folded before Flop
Seat 7: dawinci80 collected ($0.60)
Seat 8: Ewax folded before Flop (didn't bet)
Seat 9: Alameda22 folded before Flop (didn't bet)



PokerStars Game #20096942820:  Hold'em No Limit ($0.10/$0.25) - 2008/09/02 16:16:58 ET
Table 'Varsavia' 9-max Seat #5 is the button
Seat 1: AtrY ($25.65 in chips) 
Seat 3: attilale001 ($4.65 in chips) 
Seat 4: Weegolo ($7.55 in chips) 
Seat 5: chessmanA1 ($14.95 in chips) 
Seat 6: AKl3gi0n ($6 in chips) 
Seat 7: dawinci80 ($13.55 in chips) 
Seat 8: Ewax ($22.95 in chips) 
Seat 9: Alameda22 ($27.70 in chips) 
AKl3gi0n: posts small blind $0.10
dawinci80: posts big blind $0.25
*** HOLE CARDS ***
Dealt to Alameda22 [9s 7s]
Ewax: folds 
Alameda22: folds 
AtrY: folds 
attilale001: folds 
Weegolo: calls $0.25
chessmanA1: folds 
AKl3gi0n: calls $0.15
dawinci80: checks 
*** FLOP *** [Jc Jh Qd]
AKl3gi0n: bets $0.50
dawinci80: folds 
Weegolo: folds 
Uncalled bet ($0.50) returned to AKl3gi0n
AKl3gi0n collected $0.75 from pot
AKl3gi0n: shows [Qs 5s] (two pair, Queens and Jacks)
*** SUMMARY ***
Total pot $0.75 | Rake $0 
Board [Jc Jh Qd]
Seat 1: AtrY folded before Flop (didn't bet)
Seat 3: attilale001 folded before Flop (didn't bet)
Seat 4: Weegolo folded on the Flop
Seat 5: chessmanA1 (button) folded before Flop (didn't bet)
Seat 6: AKl3gi0n (small blind) collected ($0.75)
Seat 7: dawinci80 (big blind) folded on the Flop
Seat 8: Ewax folded before Flop (didn't bet)
Seat 9: Alameda22 folded before Flop (didn't bet)



PokerStars Game #20096956429:  Hold'em No Limit ($0.10/$0.25) - 2008/09/02 16:17:30 ET
Table 'Varsavia' 9-max Seat #6 is the button
Seat 1: AtrY ($25.65 in chips) 
Seat 3: attilale001 ($4.65 in chips) 
Seat 4: Weegolo ($7.30 in chips) 
Seat 5: chessmanA1 ($14.95 in chips) 
Seat 6: AKl3gi0n ($6.50 in chips) 
Seat 7: dawinci80 ($13.30 in chips) 
Seat 8: Ewax ($22.95 in chips) 
Seat 9: Alameda22 ($27.70 in chips) 
dawinci80: posts small blind $0.10
Ewax: posts big blind $0.25
*** HOLE CARDS ***
Dealt to Alameda22 [As 2d]
dawinci80 said, "NH!!!!!!!!!!!!!!!!!!!!!!!!!!!!1111"
Alameda22: folds 
AtrY: folds 
attilale001: folds 
Weegolo: calls $0.25
chessmanA1: folds 
AKl3gi0n: folds 
dawinci80: folds 
Ewax: checks 
*** FLOP *** [Ac 8h 9s]
Ewax: checks 
Weegolo: checks 
*** TURN *** [Ac 8h 9s] [3d]
Ewax: checks 
Weegolo: checks 
*** RIVER *** [Ac 8h 9s 3d] [Qd]
Ewax: checks 
Weegolo: bets $0.25
Ewax: folds 
Uncalled bet ($0.25) returned to Weegolo
Weegolo collected $0.60 from pot
Weegolo: doesn't show hand 
*** SUMMARY ***
Total pot $0.60 | Rake $0 
Board [Ac 8h 9s 3d Qd]
Seat 1: AtrY folded before Flop (didn't bet)
Seat 3: attilale001 folded before Flop (didn't bet)
Seat 4: Weegolo collected ($0.60)
Seat 5: chessmanA1 folded before Flop (didn't bet)
Seat 6: AKl3gi0n (button) folded before Flop (didn't bet)
Seat 7: dawinci80 (small blind) folded before Flop
Seat 8: Ewax (big blind) folded on the River
Seat 9: Alameda22 folded before Flop (didn't bet)



PokerStars Game #20096987484:  Hold'em No Limit ($0.10/$0.25) - 2008/09/02 16:18:43 ET
Table 'Varsavia' 9-max Seat #7 is the button
Seat 1: AtrY ($25.65 in chips) 
Seat 3: attilale001 ($4.65 in chips) 
Seat 4: Weegolo ($7.65 in chips) 
Seat 5: chessmanA1 ($14.95 in chips) 
Seat 6: AKl3gi0n ($6.50 in chips) 
Seat 7: dawinci80 ($13.20 in chips) 
Seat 8: Ewax ($22.70 in chips) 
Seat 9: Alameda22 ($27.70 in chips) 
Ewax: posts small blind $0.10
Alameda22: posts big blind $0.25
*** HOLE CARDS ***
Dealt to Alameda22 [Js 2s]
AtrY: folds 
attilale001: folds 
Weegolo: folds 
jmaxsparty has returned
chessmanA1: folds 
AKl3gi0n: folds 
dawinci80: raises $0.75 to $1
Ewax: folds 
Alameda22: folds 
Uncalled bet ($0.75) returned to dawinci80
dawinci80 collected $0.60 from pot
*** SUMMARY ***
Total pot $0.60 | Rake $0 
Seat 1: AtrY folded before Flop (didn't bet)
Seat 3: attilale001 folded before Flop (didn't bet)
Seat 4: Weegolo folded before Flop (didn't bet)
Seat 5: chessmanA1 folded before Flop (didn't bet)
Seat 6: AKl3gi0n folded before Flop (didn't bet)
Seat 7: dawinci80 (button) collected ($0.60)
Seat 8: Ewax (small blind) folded before Flop
Seat 9: Alameda22 (big blind) folded before Flop



PokerStars Game #20097013502:  Hold'em No Limit ($0.10/$0.25) - 2008/09/02 16:19:46 ET
Table 'Varsavia' 9-max Seat #8 is the button
Seat 1: AtrY ($25.65 in chips) 
Seat 2: jmaxsparty ($12.05 in chips) 
Seat 3: attilale001 ($4.65 in chips) 
Seat 4: Weegolo ($7.65 in chips) 
Seat 5: chessmanA1 ($14.95 in chips) 
Seat 6: AKl3gi0n ($6.50 in chips) 
Seat 7: dawinci80 ($13.55 in chips) 
Seat 8: Ewax ($22.60 in chips) 
Seat 9: Alameda22 ($27.45 in chips) 
Alameda22: posts small blind $0.10
AtrY: posts big blind $0.25
*** HOLE CARDS ***
Dealt to Alameda22 [Tc Ac]
jmaxsparty: folds 
attilale001: folds 
Weegolo: folds 
chessmanA1: folds 
AKl3gi0n: folds 
dawinci80: folds 
Ewax: folds 
Alameda22: folds 
Uncalled bet ($0.15) returned to AtrY
AtrY collected $0.20 from pot
AtrY: doesn't show hand 
*** SUMMARY ***
Total pot $0.20 | Rake $0 
Seat 1: AtrY (big blind) collected ($0.20)
Seat 2: jmaxsparty folded before Flop (didn't bet)
Seat 3: attilale001 folded before Flop (didn't bet)
Seat 4: Weegolo folded before Flop (didn't bet)
Seat 5: chessmanA1 folded before Flop (didn't bet)
Seat 6: AKl3gi0n folded before Flop (didn't bet)
Seat 7: dawinci80 folded before Flop (didn't bet)
Seat 8: Ewax (button) folded before Flop (didn't bet)
Seat 9: Alameda22 (small blind) folded before Flop



PokerStars Game #20097028388:  Hold'em No Limit ($0.10/$0.25) - 2008/09/02 16:20:22 ET
Table 'Varsavia' 9-max Seat #9 is the button
Seat 1: AtrY ($25.75 in chips) 
Seat 2: jmaxsparty ($12.05 in chips) 
Seat 3: attilale001 ($4.65 in chips) 
Seat 4: Weegolo ($7.65 in chips) 
Seat 5: chessmanA1 ($14.95 in chips) 
Seat 6: AKl3gi0n ($6.50 in chips) 
Seat 7: dawinci80 ($13.55 in chips) 
Seat 8: Ewax ($22.60 in chips) 
Seat 9: Alameda22 ($27.35 in chips) 
AtrY: posts small blind $0.10
jmaxsparty: posts big blind $0.25
*** HOLE CARDS ***
Dealt to Alameda22 [Qd Ks]
attilale001: folds 
Weegolo: folds 
chessmanA1: folds 
AKl3gi0n: calls $0.25
dawinci80: folds 
Ewax: folds 
Alameda22: folds 
AtrY: folds 
jmaxsparty: checks 
*** FLOP *** [7d Kh 9c]
jmaxsparty: checks 
AKl3gi0n: bets $0.25
jmaxsparty: folds 
Uncalled bet ($0.25) returned to AKl3gi0n
AKl3gi0n collected $0.60 from pot
AKl3gi0n: doesn't show hand 
*** SUMMARY ***
Total pot $0.60 | Rake $0 
Board [7d Kh 9c]
Seat 1: AtrY (small blind) folded before Flop
Seat 2: jmaxsparty (big blind) folded on the Flop
Seat 3: attilale001 folded before Flop (didn't bet)
Seat 4: Weegolo folded before Flop (didn't bet)
Seat 5: chessmanA1 folded before Flop (didn't bet)
Seat 6: AKl3gi0n collected ($0.60)
Seat 7: dawinci80 folded before Flop (didn't bet)
Seat 8: Ewax folded before Flop (didn't bet)
Seat 9: Alameda22 (button) folded before Flop (didn't bet)



PokerStars Game #20097049190:  Hold'em No Limit ($0.10/$0.25) - 2008/09/02 16:21:12 ET
Table 'Varsavia' 9-max Seat #1 is the button
Seat 1: AtrY ($25.65 in chips) 
Seat 2: jmaxsparty ($11.80 in chips) 
Seat 3: attilale001 ($4.65 in chips) 
Seat 4: Weegolo ($7.65 in chips) 
Seat 5: chessmanA1 ($14.95 in chips) 
Seat 6: AKl3gi0n ($6.85 in chips) 
Seat 7: dawinci80 ($13.55 in chips) 
Seat 8: Ewax ($22.60 in chips) 
Seat 9: Alameda22 ($27.35 in chips) 
jmaxsparty: posts small blind $0.10
attilale001: posts big blind $0.25
*** HOLE CARDS ***
Dealt to Alameda22 [9h 7s]
Weegolo: folds 
chessmanA1: folds 
AKl3gi0n: calls $0.25
dawinci80: folds 
Ewax: folds 
Alameda22: folds 
AtrY: raises $1 to $1.25
jmaxsparty: folds 
attilale001: calls $1
AKl3gi0n: folds 
*** FLOP *** [4d Ts 6c]
attilale001: checks 
AtrY: bets $1.50
attilale001: calls $1.50
*** TURN *** [4d Ts 6c] [4s]
attilale001: checks 
AtrY: bets $2
attilale001: calls $1.90 and is all-in
Uncalled bet ($0.10) returned to AtrY
*** RIVER *** [4d Ts 6c 4s] [Tc]
*** SHOW DOWN ***
attilale001: shows [Th Js] (a full house, Tens full of Fours)
AtrY: mucks hand 
attilale001 collected $9.20 from pot
*** SUMMARY ***
Total pot $9.65 | Rake $0.45 
Board [4d Ts 6c 4s Tc]
Seat 1: AtrY (button) mucked [8c Jc]
Seat 2: jmaxsparty (small blind) folded before Flop
Seat 3: attilale001 (big blind) showed [Th Js] and won ($9.20) with a full house, Tens full of Fours
Seat 4: Weegolo folded before Flop (didn't bet)
Seat 5: chessmanA1 folded before Flop (didn't bet)
Seat 6: AKl3gi0n folded before Flop
Seat 7: dawinci80 folded before Flop (didn't bet)
Seat 8: Ewax folded before Flop (didn't bet)
Seat 9: Alameda22 folded before Flop (didn't bet)



PokerStars Game #20097093885:  Hold'em No Limit ($0.10/$0.25) - 2008/09/02 16:23:00 ET
Table 'Varsavia' 9-max Seat #2 is the button
Seat 1: AtrY ($25 in chips) 
Seat 2: jmaxsparty ($11.70 in chips) 
Seat 3: attilale001 ($9.20 in chips) 
Seat 4: Weegolo ($7.65 in chips) 
Seat 5: chessmanA1 ($14.95 in chips) 
Seat 6: AKl3gi0n ($6.60 in chips) 
Seat 7: dawinci80 ($13.55 in chips) 
Seat 8: Ewax ($22.60 in chips) 
Seat 9: Alameda22 ($27.35 in chips) 
attilale001: posts small blind $0.10
Weegolo: posts big blind $0.25
*** HOLE CARDS ***
Dealt to Alameda22 [2h 9d]
chessmanA1: folds 
AKl3gi0n: folds 
dawinci80: folds 
Ewax: calls $0.25
Alameda22: folds 
AtrY: folds 
jmaxsparty: folds 
attilale001: folds 
attilale001 is sitting out
Weegolo: checks 
*** FLOP *** [4h 4s 5c]
Weegolo: checks 
Ewax: checks 
*** TURN *** [4h 4s 5c] [Ah]
Weegolo: checks 
Ewax: checks 
*** RIVER *** [4h 4s 5c Ah] [Jh]
Weegolo: checks 
Ewax: checks 
*** SHOW DOWN ***
Weegolo: shows [Ts Ks] (a pair of Fours)
Ewax: shows [Qc Kc] (a pair of Fours - Ace+King+Queen kicker)
Ewax collected $0.60 from pot
*** SUMMARY ***
Total pot $0.60 | Rake $0 
Board [4h 4s 5c Ah Jh]
Seat 1: AtrY folded before Flop (didn't bet)
Seat 2: jmaxsparty (button) folded before Flop (didn't bet)
Seat 3: attilale001 (small blind) folded before Flop
Seat 4: Weegolo (big blind) showed [Ts Ks] and lost with a pair of Fours
Seat 5: chessmanA1 folded before Flop (didn't bet)
Seat 6: AKl3gi0n folded before Flop (didn't bet)
Seat 7: dawinci80 folded before Flop (didn't bet)
Seat 8: Ewax showed [Qc Kc] and won ($0.60) with a pair of Fours
Seat 9: Alameda22 folded before Flop (didn't bet)



PokerStars Game #20097130163:  Hold'em No Limit ($0.10/$0.25) - 2008/09/02 16:24:28 ET
Table 'Varsavia' 9-max Seat #4 is the button
Seat 1: AtrY ($25 in chips) 
Seat 2: jmaxsparty ($11.70 in chips) 
Seat 4: Weegolo ($7.40 in chips) 
Seat 5: chessmanA1 ($14.95 in chips) 
Seat 6: AKl3gi0n ($6.60 in chips) 
Seat 7: dawinci80 ($13.55 in chips) 
Seat 8: Ewax ($22.95 in chips) 
Seat 9: Alameda22 ($27.35 in chips) 
chessmanA1: posts small blind $0.10
AKl3gi0n: posts big blind $0.25
*** HOLE CARDS ***
Dealt to Alameda22 [Ks 4c]
attilale001 has returned
dawinci80: folds 
Ewax: folds 
Alameda22: folds 
AtrY: folds 
jmaxsparty: folds 
Weegolo: folds 
chessmanA1: folds 
Uncalled bet ($0.15) returned to AKl3gi0n
AKl3gi0n collected $0.20 from pot
AKl3gi0n: doesn't show hand 
*** SUMMARY ***
Total pot $0.20 | Rake $0 
Seat 1: AtrY folded before Flop (didn't bet)
Seat 2: jmaxsparty folded before Flop (didn't bet)
Seat 4: Weegolo (button) folded before Flop (didn't bet)
Seat 5: chessmanA1 (small blind) folded before Flop
Seat 6: AKl3gi0n (big blind) collected ($0.20)
Seat 7: dawinci80 folded before Flop (didn't bet)
Seat 8: Ewax folded before Flop (didn't bet)
Seat 9: Alameda22 folded before Flop (didn't bet)



PokerStars Game #20097145090:  Hold'em No Limit ($0.10/$0.25) - 2008/09/02 16:25:04 ET
Table 'Varsavia' 9-max Seat #5 is the button
Seat 1: AtrY ($25 in chips) 
Seat 2: jmaxsparty ($11.70 in chips) 
Seat 3: attilale001 ($9.10 in chips) 
Seat 4: Weegolo ($7.40 in chips) 
Seat 5: chessmanA1 ($14.85 in chips) 
Seat 6: AKl3gi0n ($6.70 in chips) 
Seat 7: dawinci80 ($13.55 in chips) 
Seat 8: Ewax ($22.95 in chips) 
Seat 9: Alameda22 ($27.35 in chips) 
AKl3gi0n: posts small blind $0.10
dawinci80: posts big blind $0.25
*** HOLE CARDS ***
Dealt to Alameda22 [3s Kd]
Ewax: folds 
Alameda22: folds 
AtrY: folds 
jmaxsparty: raises $0.25 to $0.50
attilale001: calls $0.50
Weegolo: folds 
chessmanA1: folds 
AKl3gi0n: folds 
dawinci80: folds 
*** FLOP *** [4h 4s 6c]
jmaxsparty: bets $0.50
attilale001: calls $0.50
*** TURN *** [4h 4s 6c] [5h]
jmaxsparty: bets $1
attilale001: calls $1
*** RIVER *** [4h 4s 6c 5h] [Qh]
jmaxsparty: checks 
attilale001: checks 
*** SHOW DOWN ***
jmaxsparty: shows [Kc Ks] (two pair, Kings and Fours)
attilale001: mucks hand 
jmaxsparty collected $4.15 from pot
*** SUMMARY ***
Total pot $4.35 | Rake $0.20 
Board [4h 4s 6c 5h Qh]
Seat 1: AtrY folded before Flop (didn't bet)
Seat 2: jmaxsparty showed [Kc Ks] and won ($4.15) with two pair, Kings and Fours
Seat 3: attilale001 mucked [Ac Kh]
Seat 4: Weegolo folded before Flop (didn't bet)
Seat 5: chessmanA1 (button) folded before Flop (didn't bet)
Seat 6: AKl3gi0n (small blind) folded before Flop
Seat 7: dawinci80 (big blind) folded before Flop
Seat 8: Ewax folded before Flop (didn't bet)
Seat 9: Alameda22 folded before Flop (didn't bet)



PokerStars Game #20097174500:  Hold'em No Limit ($0.10/$0.25) - 2008/09/02 16:26:15 ET
Table 'Varsavia' 9-max Seat #6 is the button
Seat 1: AtrY ($25 in chips) 
Seat 2: jmaxsparty ($13.85 in chips) 
Seat 3: attilale001 ($7.10 in chips) 
Seat 4: Weegolo ($7.40 in chips) 
Seat 5: chessmanA1 ($14.85 in chips) 
Seat 6: AKl3gi0n ($6.60 in chips) 
Seat 7: dawinci80 ($13.30 in chips) 
Seat 8: Ewax ($22.95 in chips) 
Seat 9: Alameda22 ($27.35 in chips) 
dawinci80: posts small blind $0.10
Ewax: posts big blind $0.25
*** HOLE CARDS ***
Dealt to Alameda22 [3d Th]
Alameda22: folds 
AtrY has timed out
AtrY: folds 
AtrY is sitting out
jmaxsparty: folds 
attilale001: calls $0.25
Weegolo: folds 
chessmanA1: folds 
AKl3gi0n: folds 
dawinci80: folds 
AtrY has returned
Ewax: checks 
*** FLOP *** [5s Kc Kd]
Ewax: checks 
attilale001: checks 
*** TURN *** [5s Kc Kd] [Ac]
Ewax: checks 
attilale001: bets $0.25
Ewax: raises $0.75 to $1
attilale001: calls $0.75
*** RIVER *** [5s Kc Kd Ac] [6d]
Ewax: bets $2
attilale001: calls $2
*** SHOW DOWN ***
Ewax: shows [9d Kh] (three of a kind, Kings)
attilale001: mucks hand 
Ewax collected $6.30 from pot
*** SUMMARY ***
Total pot $6.60 | Rake $0.30 
Board [5s Kc Kd Ac 6d]
Seat 1: AtrY folded before Flop (didn't bet)
Seat 2: jmaxsparty folded before Flop (didn't bet)
Seat 3: attilale001 mucked [8c As]
Seat 4: Weegolo folded before Flop (didn't bet)
Seat 5: chessmanA1 folded before Flop (didn't bet)
Seat 6: AKl3gi0n (button) folded before Flop (didn't bet)
Seat 7: dawinci80 (small blind) folded before Flop
Seat 8: Ewax (big blind) showed [9d Kh] and won ($6.30) with three of a kind, Kings
Seat 9: Alameda22 folded before Flop (didn't bet)



PokerStars Game #20097216390:  Hold'em No Limit ($0.10/$0.25) - 2008/09/02 16:27:57 ET
Table 'Varsavia' 9-max Seat #7 is the button
Seat 1: AtrY ($25 in chips) 
Seat 2: jmaxsparty ($13.85 in chips) 
Seat 3: attilale001 ($3.85 in chips) 
Seat 4: Weegolo ($7.40 in chips) 
Seat 5: chessmanA1 ($14.85 in chips) 
Seat 6: AKl3gi0n ($6.60 in chips) 
Seat 7: dawinci80 ($13.20 in chips) 
Seat 8: Ewax ($26 in chips) 
Seat 9: Alameda22 ($27.35 in chips) 
Ewax: posts small blind $0.10
Alameda22: posts big blind $0.25
*** HOLE CARDS ***
Dealt to Alameda22 [7c Ts]
AtrY: folds 
jmaxsparty: folds 
attilale001: folds 
Weegolo: folds 
chessmanA1: folds 
AKl3gi0n: folds 
dawinci80: folds 
Ewax: folds 
Uncalled bet ($0.15) returned to Alameda22
Alameda22 collected $0.20 from pot
Alameda22: doesn't show hand 
*** SUMMARY ***
Total pot $0.20 | Rake $0 
Seat 1: AtrY folded before Flop (didn't bet)
Seat 2: jmaxsparty folded before Flop (didn't bet)
Seat 3: attilale001 folded before Flop (didn't bet)
Seat 4: Weegolo folded before Flop (didn't bet)
Seat 5: chessmanA1 folded before Flop (didn't bet)
Seat 6: AKl3gi0n folded before Flop (didn't bet)
Seat 7: dawinci80 (button) folded before Flop (didn't bet)
Seat 8: Ewax (small blind) folded before Flop
Seat 9: Alameda22 (big blind) collected ($0.20)



PokerStars Game #20097226018:  Hold'em No Limit ($0.10/$0.25) - 2008/09/02 16:28:20 ET
Table 'Varsavia' 9-max Seat #8 is the button
Seat 1: AtrY ($25 in chips) 
Seat 2: jmaxsparty ($13.85 in chips) 
Seat 3: attilale001 ($3.85 in chips) 
Seat 4: Weegolo ($7.40 in chips) 
Seat 5: chessmanA1 ($14.85 in chips) 
Seat 6: AKl3gi0n ($6.60 in chips) 
Seat 7: dawinci80 ($13.20 in chips) 
Seat 8: Ewax ($25.90 in chips) 
Seat 9: Alameda22 ($27.45 in chips) 
Alameda22: posts small blind $0.10
AtrY: posts big blind $0.25
*** HOLE CARDS ***
Dealt to Alameda22 [3s 6s]
jmaxsparty: folds 
attilale001: folds 
Weegolo: folds 
chessmanA1: raises $0.75 to $1
AKl3gi0n: folds 
dawinci80: folds 
Ewax: folds 
Alameda22: folds 
AtrY: folds 
Uncalled bet ($0.75) returned to chessmanA1
chessmanA1 collected $0.60 from pot
chessmanA1: doesn't show hand 
*** SUMMARY ***
Total pot $0.60 | Rake $0 
Seat 1: AtrY (big blind) folded before Flop
Seat 2: jmaxsparty folded before Flop (didn't bet)
Seat 3: attilale001 folded before Flop (didn't bet)
Seat 4: Weegolo folded before Flop (didn't bet)
Seat 5: chessmanA1 collected ($0.60)
Seat 6: AKl3gi0n folded before Flop (didn't bet)
Seat 7: dawinci80 folded before Flop (didn't bet)
Seat 8: Ewax (button) folded before Flop (didn't bet)
Seat 9: Alameda22 (small blind) folded before Flop



PokerStars Game #20097239649:  Hold'em No Limit ($0.10/$0.25) - 2008/09/02 16:28:53 ET
Table 'Varsavia' 9-max Seat #9 is the button
Seat 1: AtrY ($24.75 in chips) 
Seat 2: jmaxsparty ($13.85 in chips) 
Seat 3: attilale001 ($3.85 in chips) 
Seat 4: Weegolo ($7.40 in chips) 
Seat 5: chessmanA1 ($15.20 in chips) 
Seat 6: AKl3gi0n ($6.60 in chips) 
Seat 7: dawinci80 ($13.20 in chips) 
Seat 8: Ewax ($25.90 in chips) 
Seat 9: Alameda22 ($27.35 in chips) 
AtrY: posts small blind $0.10
jmaxsparty: posts big blind $0.25
*** HOLE CARDS ***
Dealt to Alameda22 [Ah 4c]
attilale001: folds 
Weegolo: folds 
chessmanA1: folds 
AKl3gi0n: folds 
dawinci80: raises $0.75 to $1
Ewax: folds 
Alameda22: folds 
AtrY: folds 
jmaxsparty: folds 
Uncalled bet ($0.75) returned to dawinci80
dawinci80 collected $0.60 from pot
*** SUMMARY ***
Total pot $0.60 | Rake $0 
Seat 1: AtrY (small blind) folded before Flop
Seat 2: jmaxsparty (big blind) folded before Flop
Seat 3: attilale001 folded before Flop (didn't bet)
Seat 4: Weegolo folded before Flop (didn't bet)
Seat 5: chessmanA1 folded before Flop (didn't bet)
Seat 6: AKl3gi0n folded before Flop (didn't bet)
Seat 7: dawinci80 collected ($0.60)
Seat 8: Ewax folded before Flop (didn't bet)
Seat 9: Alameda22 (button) folded before Flop (didn't bet)



PokerStars Game #20097252316:  Hold'em No Limit ($0.10/$0.25) - 2008/09/02 16:29:24 ET
Table 'Varsavia' 9-max Seat #1 is the button
Seat 1: AtrY ($24.65 in chips) 
Seat 2: jmaxsparty ($13.60 in chips) 
Seat 3: attilale001 ($3.85 in chips) 
Seat 4: Weegolo ($7.40 in chips) 
Seat 5: chessmanA1 ($15.20 in chips) 
Seat 6: AKl3gi0n ($6.60 in chips) 
Seat 7: dawinci80 ($13.55 in chips) 
Seat 8: Ewax ($25.90 in chips) 
Seat 9: Alameda22 ($27.35 in chips) 
jmaxsparty: posts small blind $0.10
attilale001: posts big blind $0.25
*** HOLE CARDS ***
Dealt to Alameda22 [Ks 8c]
Weegolo: folds 
chessmanA1: folds 
AKl3gi0n: folds 
dawinci80: folds 
Ewax: folds 
Alameda22: folds 
AtrY: folds 
jmaxsparty: folds 
Uncalled bet ($0.15) returned to attilale001
attilale001 collected $0.20 from pot
attilale001: doesn't show hand 
*** SUMMARY ***
Total pot $0.20 | Rake $0 
Seat 1: AtrY (button) folded before Flop (didn't bet)
Seat 2: jmaxsparty (small blind) folded before Flop
Seat 3: attilale001 (big blind) collected ($0.20)
Seat 4: Weegolo folded before Flop (didn't bet)
Seat 5: chessmanA1 folded before Flop (didn't bet)
Seat 6: AKl3gi0n folded before Flop (didn't bet)
Seat 7: dawinci80 folded before Flop (didn't bet)
Seat 8: Ewax folded before Flop (didn't bet)
Seat 9: Alameda22 folded before Flop (didn't bet)



PokerStars Game #20097268641:  Hold'em No Limit ($0.10/$0.25) - 2008/09/02 16:30:03 ET
Table 'Varsavia' 9-max Seat #2 is the button
Seat 1: AtrY ($24.65 in chips) 
Seat 2: jmaxsparty ($13.50 in chips) 
Seat 3: attilale001 ($3.95 in chips) 
Seat 4: Weegolo ($7.40 in chips) 
Seat 5: chessmanA1 ($15.20 in chips) 
Seat 6: AKl3gi0n ($6.60 in chips) 
Seat 7: dawinci80 ($13.55 in chips) 
Seat 8: Ewax ($25.90 in chips) 
Seat 9: Alameda22 ($27.35 in chips) 
attilale001: posts small blind $0.10
Weegolo: posts big blind $0.25
*** HOLE CARDS ***
Dealt to Alameda22 [Kh 7h]
chessmanA1: folds 
AKl3gi0n: folds 
dawinci80: folds 
Ewax: folds 
Alameda22: folds 
AtrY: folds 
jmaxsparty: folds 
attilale001: folds 
Uncalled bet ($0.15) returned to Weegolo
Weegolo collected $0.20 from pot
Weegolo: doesn't show hand 
*** SUMMARY ***
Total pot $0.20 | Rake $0 
Seat 1: AtrY folded before Flop (didn't bet)
Seat 2: jmaxsparty (button) folded before Flop (didn't bet)
Seat 3: attilale001 (small blind) folded before Flop
Seat 4: Weegolo (big blind) collected ($0.20)
Seat 5: chessmanA1 folded before Flop (didn't bet)
Seat 6: AKl3gi0n folded before Flop (didn't bet)
Seat 7: dawinci80 folded before Flop (didn't bet)
Seat 8: Ewax folded before Flop (didn't bet)
Seat 9: Alameda22 folded before Flop (didn't bet)



PokerStars Game #20097291966:  Hold'em No Limit ($0.10/$0.25) - 2008/09/02 16:30:59 ET
Table 'Varsavia' 9-max Seat #3 is the button
Seat 1: AtrY ($24.65 in chips) 
Seat 2: jmaxsparty ($13.50 in chips) 
Seat 3: attilale001 ($3.85 in chips) 
Seat 4: Weegolo ($7.50 in chips) 
Seat 5: chessmanA1 ($15.20 in chips) 
Seat 6: AKl3gi0n ($6.60 in chips) 
Seat 7: dawinci80 ($13.55 in chips) 
Seat 8: Ewax ($25.90 in chips) 
Seat 9: Alameda22 ($27.35 in chips) 
Weegolo: posts small blind $0.10
chessmanA1: posts big blind $0.25
*** HOLE CARDS ***
Dealt to Alameda22 [Jh 7c]
AKl3gi0n: folds 
dawinci80: folds 
Ewax: folds 
Alameda22: folds 
AtrY: raises $0.75 to $1
jmaxsparty: folds 
attilale001: folds 
Weegolo: calls $0.90
chessmanA1: folds 
*** FLOP *** [3h 8s Qh]
Weegolo: checks 
AtrY: checks 
*** TURN *** [3h 8s Qh] [As]
Weegolo: checks 
AtrY: bets $1.50
Weegolo: calls $1.50
*** RIVER *** [3h 8s Qh As] [9c]
Weegolo: checks 
AtrY: checks 
*** SHOW DOWN ***
Weegolo: shows [Ah Jc] (a pair of Aces)
AtrY: mucks hand 
Weegolo collected $5 from pot
*** SUMMARY ***
Total pot $5.25 | Rake $0.25 
Board [3h 8s Qh As 9c]
Seat 1: AtrY mucked [5h 5s]
Seat 2: jmaxsparty folded before Flop (didn't bet)
Seat 3: attilale001 (button) folded before Flop (didn't bet)
Seat 4: Weegolo (small blind) showed [Ah Jc] and won ($5) with a pair of Aces
Seat 5: chessmanA1 (big blind) folded before Flop
Seat 6: AKl3gi0n folded before Flop (didn't bet)
Seat 7: dawinci80 folded before Flop (didn't bet)
Seat 8: Ewax folded before Flop (didn't bet)
Seat 9: Alameda22 folded before Flop (didn't bet)



PokerStars Game #20097330055:  Hold'em No Limit ($0.10/$0.25) - 2008/09/02 16:32:32 ET
Table 'Varsavia' 9-max Seat #4 is the button
Seat 1: AtrY ($23.50 in chips) 
Seat 2: jmaxsparty ($13.50 in chips) 
Seat 3: attilale001 ($3.85 in chips) 
Seat 4: Weegolo ($10 in chips) 
Seat 5: chessmanA1 ($14.95 in chips) 
Seat 6: AKl3gi0n ($6.60 in chips) 
Seat 7: dawinci80 ($13.55 in chips) 
Seat 8: Ewax ($25.90 in chips) 
Seat 9: Alameda22 ($27.35 in chips) 
chessmanA1: posts small blind $0.10
AKl3gi0n: posts big blind $0.25
*** HOLE CARDS ***
Dealt to Alameda22 [Ac 8s]
dawinci80: folds 
Ewax: folds 
Alameda22: folds 
AtrY: folds 
jmaxsparty: folds 
attilale001: folds 
Weegolo: folds 
chessmanA1: folds 
Uncalled bet ($0.15) returned to AKl3gi0n
AKl3gi0n collected $0.20 from pot
AKl3gi0n: doesn't show hand 
*** SUMMARY ***
Total pot $0.20 | Rake $0 
Seat 1: AtrY folded before Flop (didn't bet)
Seat 2: jmaxsparty folded before Flop (didn't bet)
Seat 3: attilale001 folded before Flop (didn't bet)
Seat 4: Weegolo (button) folded before Flop (didn't bet)
Seat 5: chessmanA1 (small blind) folded before Flop
Seat 6: AKl3gi0n (big blind) collected ($0.20)
Seat 7: dawinci80 folded before Flop (didn't bet)
Seat 8: Ewax folded before Flop (didn't bet)
Seat 9: Alameda22 folded before Flop (didn't bet)



PokerStars Game #20097343542:  Hold'em No Limit ($0.10/$0.25) - 2008/09/02 16:33:05 ET
Table 'Varsavia' 9-max Seat #5 is the button
Seat 1: AtrY ($25 in chips) 
Seat 2: jmaxsparty ($13.50 in chips) 
Seat 3: attilale001 ($3.85 in chips) 
Seat 4: Weegolo ($10 in chips) 
Seat 5: chessmanA1 ($14.85 in chips) 
Seat 6: AKl3gi0n ($6.70 in chips) 
Seat 7: dawinci80 ($13.55 in chips) 
Seat 8: Ewax ($25.90 in chips) 
Seat 9: Alameda22 ($27.35 in chips) 
AKl3gi0n: posts small blind $0.10
dawinci80: posts big blind $0.25
*** HOLE CARDS ***
Dealt to Alameda22 [4c Ks]
Ewax: folds 
Alameda22: folds 
AtrY: folds 
jmaxsparty: calls $0.25
attilale001: calls $0.25
Weegolo: folds 
chessmanA1: calls $0.25
AKl3gi0n: folds 
dawinci80: checks 
*** FLOP *** [2c 5d 4d]
dawinci80: checks 
jmaxsparty: bets $0.25
attilale001: calls $0.25
chessmanA1: calls $0.25
dawinci80: folds 
*** TURN *** [2c 5d 4d] [5h]
jmaxsparty: checks 
attilale001: checks 
chessmanA1: checks 
*** RIVER *** [2c 5d 4d 5h] [Ts]
jmaxsparty: bets $0.25
attilale001: folds 
chessmanA1: folds 
Uncalled bet ($0.25) returned to jmaxsparty
jmaxsparty collected $1.80 from pot
jmaxsparty: doesn't show hand 
*** SUMMARY ***
Total pot $1.85 | Rake $0.05 
Board [2c 5d 4d 5h Ts]
Seat 1: AtrY folded before Flop (didn't bet)
Seat 2: jmaxsparty collected ($1.80)
Seat 3: attilale001 folded on the River
Seat 4: Weegolo folded before Flop (didn't bet)
Seat 5: chessmanA1 (button) folded on the River
Seat 6: AKl3gi0n (small blind) folded before Flop
Seat 7: dawinci80 (big blind) folded on the Flop
Seat 8: Ewax folded before Flop (didn't bet)
Seat 9: Alameda22 folded before Flop (didn't bet)



PokerStars Game #20097380790:  Hold'em No Limit ($0.10/$0.25) - 2008/09/02 16:34:35 ET
Table 'Varsavia' 9-max Seat #6 is the button
Seat 1: AtrY ($25 in chips) 
Seat 2: jmaxsparty ($14.80 in chips) 
Seat 3: attilale001 ($3.35 in chips) 
Seat 4: Weegolo ($10 in chips) 
Seat 5: chessmanA1 ($14.35 in chips) 
Seat 6: AKl3gi0n ($6.60 in chips) 
Seat 7: dawinci80 ($13.30 in chips) 
Seat 8: Ewax ($25.90 in chips) 
Seat 9: Alameda22 ($27.35 in chips) 
dawinci80: posts small blind $0.10
Ewax: posts big blind $0.25
*** HOLE CARDS ***
Dealt to Alameda22 [3h Kh]
Alameda22: folds 
AtrY: raises $0.75 to $1
jmaxsparty: folds 
attilale001: folds 
Weegolo: folds 
chessmanA1: folds 
AKl3gi0n: folds 
dawinci80: calls $0.90
Ewax: folds 
*** FLOP *** [7h Td Qh]
dawinci80: checks 
AtrY: bets $1.75
dawinci80: folds 
Uncalled bet ($1.75) returned to AtrY
AtrY collected $2.15 from pot
AtrY: doesn't show hand 
*** SUMMARY ***
Total pot $2.25 | Rake $0.10 
Board [7h Td Qh]
Seat 1: AtrY collected ($2.15)
Seat 2: jmaxsparty folded before Flop (didn't bet)
Seat 3: attilale001 folded before Flop (didn't bet)
Seat 4: Weegolo folded before Flop (didn't bet)
Seat 5: chessmanA1 folded before Flop (didn't bet)
Seat 6: AKl3gi0n (button) folded before Flop (didn't bet)
Seat 7: dawinci80 (small blind) folded on the Flop
Seat 8: Ewax (big blind) folded before Flop
Seat 9: Alameda22 folded before Flop (didn't bet)



PokerStars Game #20097404694:  Hold'em No Limit ($0.10/$0.25) - 2008/09/02 16:35:33 ET
Table 'Varsavia' 9-max Seat #7 is the button
Seat 1: AtrY ($26.15 in chips) 
Seat 2: jmaxsparty ($14.80 in chips) 
Seat 3: attilale001 ($3.35 in chips) 
Seat 4: Weegolo ($10 in chips) 
Seat 5: chessmanA1 ($14.35 in chips) 
Seat 6: AKl3gi0n ($6.60 in chips) 
Seat 7: dawinci80 ($12.30 in chips) 
Seat 8: Ewax ($25.65 in chips) 
Seat 9: Alameda22 ($27.35 in chips) 
Ewax: posts small blind $0.10
Alameda22: posts big blind $0.25
*** HOLE CARDS ***
Dealt to Alameda22 [7c Qc]
AtrY: folds 
jmaxsparty: folds 
attilale001: folds 
Weegolo: folds 
chessmanA1: folds 
AKl3gi0n: folds 
dawinci80: folds 
Ewax: folds 
Uncalled bet ($0.15) returned to Alameda22
Alameda22 collected $0.20 from pot
Alameda22: doesn't show hand 
*** SUMMARY ***
Total pot $0.20 | Rake $0 
Seat 1: AtrY folded before Flop (didn't bet)
Seat 2: jmaxsparty folded before Flop (didn't bet)
Seat 3: attilale001 folded before Flop (didn't bet)
Seat 4: Weegolo folded before Flop (didn't bet)
Seat 5: chessmanA1 folded before Flop (didn't bet)
Seat 6: AKl3gi0n folded before Flop (didn't bet)
Seat 7: dawinci80 (button) folded before Flop (didn't bet)
Seat 8: Ewax (small blind) folded before Flop
Seat 9: Alameda22 (big blind) collected ($0.20)



PokerStars Game #20097413893:  Hold'em No Limit ($0.10/$0.25) - 2008/09/02 16:35:55 ET
Table 'Varsavia' 9-max Seat #8 is the button
Seat 1: AtrY ($26.15 in chips) 
Seat 2: jmaxsparty ($14.80 in chips) 
Seat 3: attilale001 ($3.35 in chips) 
Seat 4: Weegolo ($10 in chips) 
Seat 5: chessmanA1 ($14.35 in chips) 
Seat 6: AKl3gi0n ($6.60 in chips) 
Seat 7: dawinci80 ($12.30 in chips) 
Seat 8: Ewax ($25.55 in chips) 
Seat 9: Alameda22 ($27.45 in chips) 
Alameda22: posts small blind $0.10
AtrY: posts big blind $0.25
*** HOLE CARDS ***
Dealt to Alameda22 [Ks 3c]
jmaxsparty: folds 
attilale001: folds 
Weegolo: calls $0.25
chessmanA1: folds 
AKl3gi0n: folds 
dawinci80: folds 
Ewax: folds 
Alameda22: folds 
AtrY: checks 
*** FLOP *** [2s Jd 6s]
AtrY: checks 
Weegolo: checks 
*** TURN *** [2s Jd 6s] [Td]
AtrY: bets $0.75
Weegolo: folds 
Uncalled bet ($0.75) returned to AtrY
AtrY collected $0.60 from pot
AtrY: doesn't show hand 
*** SUMMARY ***
Total pot $0.60 | Rake $0 
Board [2s Jd 6s Td]
Seat 1: AtrY (big blind) collected ($0.60)
Seat 2: jmaxsparty folded before Flop (didn't bet)
Seat 3: attilale001 folded before Flop (didn't bet)
Seat 4: Weegolo folded on the Turn
Seat 5: chessmanA1 folded before Flop (didn't bet)
Seat 6: AKl3gi0n folded before Flop (didn't bet)
Seat 7: dawinci80 folded before Flop (didn't bet)
Seat 8: Ewax (button) folded before Flop (didn't bet)
Seat 9: Alameda22 (small blind) folded before Flop



PokerStars Game #20097438963:  Hold'em No Limit ($0.10/$0.25) - 2008/09/02 16:36:57 ET
Table 'Varsavia' 9-max Seat #9 is the button
Seat 1: AtrY ($26.50 in chips) 
Seat 2: jmaxsparty ($14.80 in chips) 
Seat 3: attilale001 ($3.35 in chips) 
Seat 4: Weegolo ($9.75 in chips) 
Seat 5: chessmanA1 ($14.35 in chips) 
Seat 6: AKl3gi0n ($6.60 in chips) 
Seat 7: dawinci80 ($12.30 in chips) 
Seat 8: Ewax ($25.55 in chips) 
Seat 9: Alameda22 ($27.35 in chips) 
AtrY: posts small blind $0.10
jmaxsparty: posts big blind $0.25
*** HOLE CARDS ***
Dealt to Alameda22 [5d 4s]
attilale001: folds 
Weegolo: calls $0.25
chessmanA1: calls $0.25
AKl3gi0n: folds 
dawinci80: folds 
Ewax: folds 
Alameda22: folds 
AtrY: folds 
jmaxsparty: checks 
*** FLOP *** [Td 3d Tc]
jmaxsparty: checks 
Weegolo: checks 
chessmanA1: checks 
*** TURN *** [Td 3d Tc] [8c]
jmaxsparty: checks 
Weegolo: checks 
chessmanA1: checks 
*** RIVER *** [Td 3d Tc 8c] [Jc]
jmaxsparty: bets $0.25
Weegolo: calls $0.25
chessmanA1: folds 
*** SHOW DOWN ***
jmaxsparty: shows [Ad 4c] (a pair of Tens)
Weegolo: shows [Jh Qd] (two pair, Jacks and Tens)
Weegolo collected $1.30 from pot
*** SUMMARY ***
Total pot $1.35 | Rake $0.05 
Board [Td 3d Tc 8c Jc]
Seat 1: AtrY (small blind) folded before Flop
Seat 2: jmaxsparty (big blind) showed [Ad 4c] and lost with a pair of Tens
Seat 3: attilale001 folded before Flop (didn't bet)
Seat 4: Weegolo showed [Jh Qd] and won ($1.30) with two pair, Jacks and Tens
Seat 5: chessmanA1 folded on the River
Seat 6: AKl3gi0n folded before Flop (didn't bet)
Seat 7: dawinci80 folded before Flop (didn't bet)
Seat 8: Ewax folded before Flop (didn't bet)
Seat 9: Alameda22 (button) folded before Flop (didn't bet)



PokerStars Game #20097482961:  Hold'em No Limit ($0.10/$0.25) - 2008/09/02 16:38:43 ET
Table 'Varsavia' 9-max Seat #1 is the button
Seat 1: AtrY ($26.40 in chips) 
Seat 2: jmaxsparty ($14.30 in chips) 
Seat 3: attilale001 ($3.35 in chips) 
Seat 4: Weegolo ($10.55 in chips) 
Seat 5: chessmanA1 ($14.10 in chips) 
Seat 6: AKl3gi0n ($6.60 in chips) 
Seat 7: dawinci80 ($12.30 in chips) 
Seat 8: Ewax ($25.55 in chips) 
Seat 9: Alameda22 ($27.35 in chips) 
jmaxsparty: posts small blind $0.10
attilale001: posts big blind $0.25
*** HOLE CARDS ***
Dealt to Alameda22 [6s Ts]
Weegolo: folds 
chessmanA1: folds 
AKl3gi0n: folds 
dawinci80: folds 
Ewax: folds 
Alameda22: folds 
AtrY: folds 
jmaxsparty: folds 
Uncalled bet ($0.15) returned to attilale001
attilale001 collected $0.20 from pot
attilale001 is sitting out
attilale001: doesn't show hand 
*** SUMMARY ***
Total pot $0.20 | Rake $0 
Seat 1: AtrY (button) folded before Flop (didn't bet)
Seat 2: jmaxsparty (small blind) folded before Flop
Seat 3: attilale001 (big blind) collected ($0.20)
Seat 4: Weegolo folded before Flop (didn't bet)
Seat 5: chessmanA1 folded before Flop (didn't bet)
Seat 6: AKl3gi0n folded before Flop (didn't bet)
Seat 7: dawinci80 folded before Flop (didn't bet)
Seat 8: Ewax folded before Flop (didn't bet)
Seat 9: Alameda22 folded before Flop (didn't bet)



PokerStars Game #20097506379:  Hold'em No Limit ($0.10/$0.25) - 2008/09/02 16:39:39 ET
Table 'Varsavia' 9-max Seat #2 is the button
Seat 1: AtrY ($26.40 in chips) 
Seat 2: jmaxsparty ($14.20 in chips) 
Seat 4: Weegolo ($10.55 in chips) 
Seat 5: chessmanA1 ($14.10 in chips) 
Seat 6: AKl3gi0n ($6.60 in chips) 
Seat 7: dawinci80 ($12.30 in chips) 
Seat 8: Ewax ($25.55 in chips) 
Seat 9: Alameda22 ($27.35 in chips) 
Weegolo: posts small blind $0.10
attilale001 leaves the table
chessmanA1: posts big blind $0.25
*** HOLE CARDS ***
Dealt to Alameda22 [9s 4c]
AKl3gi0n: folds 
dawinci80: folds 
Ewax: folds 
Alameda22: folds 
AtrY: raises $0.75 to $1
jmaxsparty: folds 
Weegolo: folds 
chessmanA1: folds 
Uncalled bet ($0.75) returned to AtrY
AtrY collected $0.60 from pot
AtrY: doesn't show hand 
*** SUMMARY ***
Total pot $0.60 | Rake $0 
Seat 1: AtrY collected ($0.60)
Seat 2: jmaxsparty (button) folded before Flop (didn't bet)
Seat 4: Weegolo (small blind) folded before Flop
Seat 5: chessmanA1 (big blind) folded before Flop
Seat 6: AKl3gi0n folded before Flop (didn't bet)
Seat 7: dawinci80 folded before Flop (didn't bet)
Seat 8: Ewax folded before Flop (didn't bet)
Seat 9: Alameda22 folded before Flop (didn't bet)



PokerStars Game #20097526419:  Hold'em No Limit ($0.10/$0.25) - 2008/09/02 16:40:27 ET
Table 'Varsavia' 9-max Seat #4 is the button
Seat 1: AtrY ($26.75 in chips) 
Seat 2: jmaxsparty ($14.20 in chips) 
Seat 4: Weegolo ($10.45 in chips) 
Seat 5: chessmanA1 ($13.85 in chips) 
Seat 6: AKl3gi0n ($6.60 in chips) 
Seat 7: dawinci80 ($12.30 in chips) 
Seat 8: Ewax ($25.55 in chips) 
Seat 9: Alameda22 ($27.35 in chips) 
chessmanA1: posts small blind $0.10
AKl3gi0n: posts big blind $0.25
*** HOLE CARDS ***
Dealt to Alameda22 [6c Kc]
Just_Million joins the table at seat #3 
dawinci80: calls $0.25
Ewax: folds 
Alameda22: folds 
AtrY: folds 
jmaxsparty: folds 
Weegolo: folds 
chessmanA1: calls $0.15
jmaxsparty leaves the table
AKl3gi0n: checks 
*** FLOP *** [6d 9s 8h]
chessmanA1: checks 
AKl3gi0n: checks 
dawinci80: bets $0.50
chessmanA1: folds 
AKl3gi0n: calls $0.50
*** TURN *** [6d 9s 8h] [5c]
AKl3gi0n: checks 
dawinci80: bets $0.50
AKl3gi0n: folds 
Uncalled bet ($0.50) returned to dawinci80
iTsTheGrind joins the table at seat #2 
dawinci80 collected $1.70 from pot
*** SUMMARY ***
Total pot $1.75 | Rake $0.05 
Board [6d 9s 8h 5c]
Seat 1: AtrY folded before Flop (didn't bet)
Seat 2: jmaxsparty folded before Flop (didn't bet)
Seat 4: Weegolo (button) folded before Flop (didn't bet)
Seat 5: chessmanA1 (small blind) folded on the Flop
Seat 6: AKl3gi0n (big blind) folded on the Turn
Seat 7: dawinci80 collected ($1.70)
Seat 8: Ewax folded before Flop (didn't bet)
Seat 9: Alameda22 folded before Flop (didn't bet)



PokerStars Game #20097569823:  Hold'em No Limit ($0.10/$0.25) - 2008/09/02 16:42:12 ET
Table 'Varsavia' 9-max Seat #5 is the button
Seat 1: AtrY ($26.75 in chips) 
Seat 2: iTsTheGrind ($15 in chips) 
Seat 4: Weegolo ($10.45 in chips) 
Seat 5: chessmanA1 ($13.60 in chips) 
Seat 6: AKl3gi0n ($5.85 in chips) 
Seat 7: dawinci80 ($13.25 in chips) 
Seat 8: Ewax ($25.55 in chips) 
Seat 9: Alameda22 ($27.35 in chips) 
AKl3gi0n: posts small blind $0.10
dawinci80: posts big blind $0.25
iTsTheGrind: posts big blind $0.25
Just_Million: sits out 
*** HOLE CARDS ***
Dealt to Alameda22 [3d Qh]
Ewax: folds 
Alameda22: folds 
AtrY: folds 
iTsTheGrind: checks 
Weegolo: calls $0.25
chessmanA1: calls $0.25
AKl3gi0n: folds 
dawinci80: checks 
*** FLOP *** [Ks Kc 9h]
dawinci80: checks 
iTsTheGrind: checks 
Weegolo: bets $0.25
chessmanA1: folds 
dawinci80: folds 
iTsTheGrind: folds 
Uncalled bet ($0.25) returned to Weegolo
Weegolo collected $1.05 from pot
Weegolo: doesn't show hand 
*** SUMMARY ***
Total pot $1.10 | Rake $0.05 
Board [Ks Kc 9h]
Seat 1: AtrY folded before Flop (didn't bet)
Seat 2: iTsTheGrind folded on the Flop
Seat 4: Weegolo collected ($1.05)
Seat 5: chessmanA1 (button) folded on the Flop
Seat 6: AKl3gi0n (small blind) folded before Flop
Seat 7: dawinci80 (big blind) folded on the Flop
Seat 8: Ewax folded before Flop (didn't bet)
Seat 9: Alameda22 folded before Flop (didn't bet)



PokerStars Game #20097594881:  Hold'em No Limit ($0.10/$0.25) - 2008/09/02 16:43:12 ET
Table 'Varsavia' 9-max Seat #6 is the button
Seat 1: AtrY ($26.75 in chips) 
Seat 2: iTsTheGrind ($14.75 in chips) 
Seat 4: Weegolo ($11.25 in chips) 
Seat 5: chessmanA1 ($13.35 in chips) 
Seat 6: AKl3gi0n ($5.75 in chips) 
Seat 7: dawinci80 ($13 in chips) 
Seat 8: Ewax ($25.55 in chips) 
Seat 9: Alameda22 ($27.35 in chips) 
dawinci80: posts small blind $0.10
Ewax: posts big blind $0.25
Just_Million: sits out 
*** HOLE CARDS ***
Dealt to Alameda22 [3h Kh]
Alameda22: folds 
AtrY: folds 
iTsTheGrind: folds 
Weegolo: folds 
chessmanA1: folds 
AKl3gi0n: calls $0.25
dawinci80: calls $0.15
Ewax: checks 
*** FLOP *** [5d Tc Ac]
Weegolo leaves the table
GooDSourD joins the table at seat #4 
dawinci80: checks 
Ewax: checks 
AKl3gi0n: bets $0.25
dawinci80: folds 
Ewax: folds 
Uncalled bet ($0.25) returned to AKl3gi0n
AKl3gi0n collected $0.75 from pot
AKl3gi0n: shows [9s Th] (a pair of Tens)
*** SUMMARY ***
Total pot $0.75 | Rake $0 
Board [5d Tc Ac]
Seat 1: AtrY folded before Flop (didn't bet)
Seat 2: iTsTheGrind folded before Flop (didn't bet)
Seat 4: Weegolo folded before Flop (didn't bet)
Seat 5: chessmanA1 folded before Flop (didn't bet)
Seat 6: AKl3gi0n (button) collected ($0.75)
Seat 7: dawinci80 (small blind) folded on the Flop
Seat 8: Ewax (big blind) folded on the Flop
Seat 9: Alameda22 folded before Flop (didn't bet)



PokerStars Game #20097628202:  Hold'em No Limit ($0.10/$0.25) - 2008/09/02 16:44:32 ET
Table 'Varsavia' 9-max Seat #7 is the button
Seat 1: AtrY ($26.75 in chips) 
Seat 2: iTsTheGrind ($14.75 in chips) 
Seat 5: chessmanA1 ($13.35 in chips) 
Seat 6: AKl3gi0n ($6.25 in chips) 
Seat 7: dawinci80 ($12.75 in chips) 
Seat 8: Ewax ($25.30 in chips) 
Seat 9: Alameda22 ($27.35 in chips) 
Ewax: posts small blind $0.10
Alameda22: posts big blind $0.25
Just_Million: sits out 
GooDSourD: sits out 
*** HOLE CARDS ***
Dealt to Alameda22 [3h 8h]
AtrY: folds 
iTsTheGrind: folds 
chessmanA1: raises $1 to $1.25
AKl3gi0n: folds 
dawinci80: folds 
Ewax: folds 
Alameda22: folds 
Uncalled bet ($1) returned to chessmanA1
chessmanA1 collected $0.60 from pot
chessmanA1: doesn't show hand 
*** SUMMARY ***
Total pot $0.60 | Rake $0 
Seat 1: AtrY folded before Flop (didn't bet)
Seat 2: iTsTheGrind folded before Flop (didn't bet)
Seat 5: chessmanA1 collected ($0.60)
Seat 6: AKl3gi0n folded before Flop (didn't bet)
Seat 7: dawinci80 (button) folded before Flop (didn't bet)
Seat 8: Ewax (small blind) folded before Flop
Seat 9: Alameda22 (big blind) folded before Flop



PokerStars Game #20097645363:  Hold'em No Limit ($0.10/$0.25) - 2008/09/02 16:45:14 ET
Table 'Varsavia' 9-max Seat #8 is the button
Seat 1: AtrY ($26.75 in chips) 
Seat 2: iTsTheGrind ($14.75 in chips) 
Seat 5: chessmanA1 ($13.70 in chips) 
Seat 6: AKl3gi0n ($6.25 in chips) 
Seat 7: dawinci80 ($12.75 in chips) 
Seat 8: Ewax ($25.20 in chips) 
Seat 9: Alameda22 ($27.10 in chips) 
Alameda22: posts small blind $0.10
AtrY: posts big blind $0.25
Just_Million: sits out 
GooDSourD: sits out 
*** HOLE CARDS ***
Dealt to Alameda22 [Jh 6d]
iTsTheGrind: raises $1 to $1.25
chessmanA1: folds 
AKl3gi0n: folds 
dawinci80: folds 
Ewax: folds 
Alameda22: folds 
AtrY: folds 
Uncalled bet ($1) returned to iTsTheGrind
iTsTheGrind collected $0.60 from pot
iTsTheGrind: doesn't show hand 
*** SUMMARY ***
Total pot $0.60 | Rake $0 
Seat 1: AtrY (big blind) folded before Flop
Seat 2: iTsTheGrind collected ($0.60)
Seat 5: chessmanA1 folded before Flop (didn't bet)
Seat 6: AKl3gi0n folded before Flop (didn't bet)
Seat 7: dawinci80 folded before Flop (didn't bet)
Seat 8: Ewax (button) folded before Flop (didn't bet)
Seat 9: Alameda22 (small blind) folded before Flop



PokerStars Game #20097655416:  Hold'em No Limit ($0.10/$0.25) - 2008/09/02 16:45:38 ET
Table 'Varsavia' 9-max Seat #9 is the button
Seat 1: AtrY ($26.50 in chips) 
Seat 2: iTsTheGrind ($15.10 in chips) 
Seat 5: chessmanA1 ($13.70 in chips) 
Seat 6: AKl3gi0n ($6.25 in chips) 
Seat 7: dawinci80 ($12.75 in chips) 
Seat 8: Ewax ($25.20 in chips) 
Seat 9: Alameda22 ($27 in chips) 
AtrY: posts small blind $0.10
iTsTheGrind: posts big blind $0.25
Just_Million: sits out 
GooDSourD: sits out 
*** HOLE CARDS ***
Dealt to Alameda22 [3h Td]
chessmanA1: folds 
AKl3gi0n: folds 
dawinci80: folds 
Ewax: folds 
Alameda22: folds 
AtrY: folds 
Uncalled bet ($0.15) returned to iTsTheGrind
iTsTheGrind collected $0.20 from pot
*** SUMMARY ***
Total pot $0.20 | Rake $0 
Seat 1: AtrY (small blind) folded before Flop
Seat 2: iTsTheGrind (big blind) collected ($0.20)
Seat 5: chessmanA1 folded before Flop (didn't bet)
Seat 6: AKl3gi0n folded before Flop (didn't bet)
Seat 7: dawinci80 folded before Flop (didn't bet)
Seat 8: Ewax folded before Flop (didn't bet)
Seat 9: Alameda22 (button) folded before Flop (didn't bet)



PokerStars Game #20097666294:  Hold'em No Limit ($0.10/$0.25) - 2008/09/02 16:46:04 ET
Table 'Varsavia' 9-max Seat #1 is the button
Seat 1: AtrY ($26.40 in chips) 
Seat 2: iTsTheGrind ($15.20 in chips) 
Seat 3: Just_Million ($25 in chips) 
Seat 5: chessmanA1 ($13.70 in chips) 
Seat 6: AKl3gi0n ($6.25 in chips) 
Seat 7: dawinci80 ($12.75 in chips) 
Seat 8: Ewax ($25.20 in chips) 
Seat 9: Alameda22 ($27 in chips) 
iTsTheGrind: posts small blind $0.10
Just_Million: posts big blind $0.25
GooDSourD: sits out 
*** HOLE CARDS ***
Dealt to Alameda22 [3s 5c]
chessmanA1: folds 
AKl3gi0n: folds 
dawinci80: calls $0.25
Ewax: folds 
Alameda22: folds 
AtrY: folds 
iTsTheGrind: calls $0.15
Just_Million: checks 
*** FLOP *** [Qd 6d 6s]
iTsTheGrind: checks 
Just_Million: checks 
dawinci80: checks 
*** TURN *** [Qd 6d 6s] [9d]
iTsTheGrind: bets $2.25
Just_Million: folds 
dawinci80: folds 
Uncalled bet ($2.25) returned to iTsTheGrind
iTsTheGrind collected $0.75 from pot
*** SUMMARY ***
Total pot $0.75 | Rake $0 
Board [Qd 6d 6s 9d]
Seat 1: AtrY (button) folded before Flop (didn't bet)
Seat 2: iTsTheGrind (small blind) collected ($0.75)
Seat 3: Just_Million (big blind) folded on the Turn
Seat 5: chessmanA1 folded before Flop (didn't bet)
Seat 6: AKl3gi0n folded before Flop (didn't bet)
Seat 7: dawinci80 folded on the Turn
Seat 8: Ewax folded before Flop (didn't bet)
Seat 9: Alameda22 folded before Flop (didn't bet)



PokerStars Game #20097694380:  Hold'em No Limit ($0.10/$0.25) - 2008/09/02 16:47:12 ET
Table 'Varsavia' 9-max Seat #2 is the button
Seat 1: AtrY ($26.40 in chips) 
Seat 2: iTsTheGrind ($15.70 in chips) 
Seat 3: Just_Million ($25 in chips) 
Seat 4: GooDSourD ($25 in chips) 
Seat 5: chessmanA1 ($13.70 in chips) 
Seat 6: AKl3gi0n ($6.25 in chips) 
Seat 7: dawinci80 ($12.50 in chips) 
Seat 8: Ewax ($25.20 in chips) 
Seat 9: Alameda22 ($27 in chips) 
Just_Million: posts small blind $0.10
GooDSourD: posts big blind $0.25
*** HOLE CARDS ***
Dealt to Alameda22 [3h 3c]
chessmanA1: folds 
AKl3gi0n: folds 
dawinci80: folds 
Ewax: folds 
Alameda22: folds 
AtrY: folds 
iTsTheGrind: calls $0.25
Just_Million: folds 
GooDSourD: checks 
*** FLOP *** [Ts 4h Ad]
GooDSourD: checks 
iTsTheGrind: checks 
*** TURN *** [Ts 4h Ad] [8s]
GooDSourD: checks 
iTsTheGrind: checks 
*** RIVER *** [Ts 4h Ad 8s] [6d]
GooDSourD: checks 
iTsTheGrind: bets $0.25
GooDSourD: folds 
Uncalled bet ($0.25) returned to iTsTheGrind
iTsTheGrind collected $0.60 from pot
*** SUMMARY ***
Total pot $0.60 | Rake $0 
Board [Ts 4h Ad 8s 6d]
Seat 1: AtrY folded before Flop (didn't bet)
Seat 2: iTsTheGrind (button) collected ($0.60)
Seat 3: Just_Million (small blind) folded before Flop
Seat 4: GooDSourD (big blind) folded on the River
Seat 5: chessmanA1 folded before Flop (didn't bet)
Seat 6: AKl3gi0n folded before Flop (didn't bet)
Seat 7: dawinci80 folded before Flop (didn't bet)
Seat 8: Ewax folded before Flop (didn't bet)
Seat 9: Alameda22 folded before Flop (didn't bet)



PokerStars Game #20097731062:  Hold'em No Limit ($0.10/$0.25) - 2008/09/02 16:48:41 ET
Table 'Varsavia' 9-max Seat #3 is the button
Seat 1: AtrY ($26.40 in chips) 
Seat 2: iTsTheGrind ($16.05 in chips) 
Seat 3: Just_Million ($24.90 in chips) 
Seat 4: GooDSourD ($24.75 in chips) 
Seat 5: chessmanA1 ($13.70 in chips) 
Seat 6: AKl3gi0n ($6.25 in chips) 
Seat 7: dawinci80 ($12.50 in chips) 
Seat 8: Ewax ($25.20 in chips) 
Seat 9: Alameda22 ($27 in chips) 
GooDSourD: posts small blind $0.10
chessmanA1: posts big blind $0.25
*** HOLE CARDS ***
Dealt to Alameda22 [9d 6d]
AKl3gi0n: calls $0.25
dawinci80: folds 
Ewax: folds 
Alameda22: folds 
AtrY: folds 
iTsTheGrind: raises $0.50 to $0.75
Just_Million: folds 
GooDSourD: folds 
chessmanA1: folds 
AKl3gi0n: calls $0.50
*** FLOP *** [4d 2d Ac]
AKl3gi0n: bets $0.50
iTsTheGrind: folds 
Uncalled bet ($0.50) returned to AKl3gi0n
AKl3gi0n collected $1.80 from pot
*** SUMMARY ***
Total pot $1.85 | Rake $0.05 
Board [4d 2d Ac]
Seat 1: AtrY folded before Flop (didn't bet)
Seat 2: iTsTheGrind folded on the Flop
Seat 3: Just_Million (button) folded before Flop (didn't bet)
Seat 4: GooDSourD (small blind) folded before Flop
Seat 5: chessmanA1 (big blind) folded before Flop
Seat 6: AKl3gi0n collected ($1.80)
Seat 7: dawinci80 folded before Flop (didn't bet)
Seat 8: Ewax folded before Flop (didn't bet)
Seat 9: Alameda22 folded before Flop (didn't bet)



PokerStars Game #20097759072:  Hold'em No Limit ($0.10/$0.25) - 2008/09/02 16:49:49 ET
Table 'Varsavia' 9-max Seat #4 is the button
Seat 1: AtrY ($26.40 in chips) 
Seat 2: iTsTheGrind ($24.25 in chips) 
Seat 3: Just_Million ($24.90 in chips) 
Seat 4: GooDSourD ($24.65 in chips) 
Seat 5: chessmanA1 ($13.45 in chips) 
Seat 6: AKl3gi0n ($7.30 in chips) 
Seat 7: dawinci80 ($12.50 in chips) 
Seat 8: Ewax ($25.20 in chips) 
Seat 9: Alameda22 ($27 in chips) 
chessmanA1: posts small blind $0.10
AKl3gi0n: posts big blind $0.25
*** HOLE CARDS ***
Dealt to Alameda22 [7h 8s]
dawinci80: folds 
Ewax: folds 
Alameda22: folds 
AtrY: folds 
iTsTheGrind: folds 
Just_Million: folds 
GooDSourD: raises $0.75 to $1
chessmanA1: folds 
AKl3gi0n: calls $0.75
*** FLOP *** [8c 2s 4h]
AKl3gi0n: bets $0.50
GooDSourD: calls $0.50
*** TURN *** [8c 2s 4h] [7s]
AKl3gi0n: bets $1
GooDSourD: folds 
Uncalled bet ($1) returned to AKl3gi0n
AKl3gi0n collected $2.95 from pot
AKl3gi0n: shows [Kc Td] (high card King)
*** SUMMARY ***
Total pot $3.10 | Rake $0.15 
Board [8c 2s 4h 7s]
Seat 1: AtrY folded before Flop (didn't bet)
Seat 2: iTsTheGrind folded before Flop (didn't bet)
Seat 3: Just_Million folded before Flop (didn't bet)
Seat 4: GooDSourD (button) folded on the Turn
Seat 5: chessmanA1 (small blind) folded before Flop
Seat 6: AKl3gi0n (big blind) collected ($2.95)
Seat 7: dawinci80 folded before Flop (didn't bet)
Seat 8: Ewax folded before Flop (didn't bet)
Seat 9: Alameda22 folded before Flop (didn't bet)



PokerStars Game #20097782860:  Hold'em No Limit ($0.10/$0.25) - 2008/09/02 16:50:46 ET
Table 'Varsavia' 9-max Seat #5 is the button
Seat 1: AtrY ($26.40 in chips) 
Seat 2: iTsTheGrind ($24.25 in chips) 
Seat 3: Just_Million ($25 in chips) 
Seat 4: GooDSourD ($23.15 in chips) 
Seat 5: chessmanA1 ($13.35 in chips) 
Seat 6: AKl3gi0n ($8.75 in chips) 
Seat 7: dawinci80 ($12.50 in chips) 
Seat 8: Ewax ($25.20 in chips) 
Seat 9: Alameda22 ($27 in chips) 
AKl3gi0n: posts small blind $0.10
dawinci80: posts big blind $0.25
*** HOLE CARDS ***
Dealt to Alameda22 [Js Qd]
Ewax: folds 
Alameda22: folds 
AtrY: folds 
iTsTheGrind: calls $0.25
Just_Million: raises $1 to $1.25
GooDSourD: folds 
chessmanA1: folds 
AKl3gi0n: folds 
dawinci80: folds 
iTsTheGrind: calls $1
*** FLOP *** [Jc 5h 7d]
iTsTheGrind: checks 
Just_Million: bets $2
iTsTheGrind: calls $2
*** TURN *** [Jc 5h 7d] [3c]
iTsTheGrind: checks 
Just_Million: bets $3.50
iTsTheGrind said, "bluff"
iTsTheGrind: raises $17.50 to $21 and is all-in
Just_Million said, "never"
iTsTheGrind said, "well"
iTsTheGrind said, "pull the trigger"
Just_Million said, "youre a sucker and hit two pair or stuff... fold QQ"
Just_Million: folds 
Uncalled bet ($17.50) returned to iTsTheGrind
iTsTheGrind collected $13.20 from pot
iTsTheGrind: shows [4c 4h] (a pair of Fours)
*** SUMMARY ***
Total pot $13.85 | Rake $0.65 
Board [Jc 5h 7d 3c]
Seat 1: AtrY folded before Flop (didn't bet)
Seat 2: iTsTheGrind collected ($13.20)
Seat 3: Just_Million folded on the Turn
Seat 4: GooDSourD folded before Flop (didn't bet)
Seat 5: chessmanA1 (button) folded before Flop (didn't bet)
Seat 6: AKl3gi0n (small blind) folded before Flop
Seat 7: dawinci80 (big blind) folded before Flop
Seat 8: Ewax folded before Flop (didn't bet)
Seat 9: Alameda22 folded before Flop (didn't bet)



PokerStars Game #20097839901:  Hold'em No Limit ($0.10/$0.25) - 2008/09/02 16:53:04 ET
Table 'Varsavia' 9-max Seat #6 is the button
Seat 1: AtrY ($26.40 in chips) 
Seat 2: iTsTheGrind ($30.70 in chips) 
Seat 3: Just_Million ($25 in chips) 
Seat 4: GooDSourD ($23.15 in chips) 
Seat 5: chessmanA1 ($13.35 in chips) 
Seat 6: AKl3gi0n ($8.65 in chips) 
Seat 7: dawinci80 ($12.25 in chips) 
Seat 8: Ewax ($25.20 in chips) 
Seat 9: Alameda22 ($27 in chips) 
dawinci80: posts small blind $0.10
Ewax: posts big blind $0.25
*** HOLE CARDS ***
Dealt to Alameda22 [Jc Ac]
iTsTheGrind said, "*****"
iTsTheGrind said, "p u ssy"
Alameda22: folds 
AtrY: folds 
iTsTheGrind: folds 
Just_Million: folds 
GooDSourD: folds 
chessmanA1: folds 
AKl3gi0n: calls $0.25
dawinci80: folds 
Ewax: checks 
*** FLOP *** [Ah 3h Kc]
Ewax: checks 
AKl3gi0n: checks 
*** TURN *** [Ah 3h Kc] [4h]
Ewax: checks 
Just_Million said, "lol one of those funny guys who got no real self confidence and play poker in order to compare muscles .. nice hand boy"
iTsTheGrind leaves the table
Just_Million said, "*son"
AKl3gi0n: checks 
*** RIVER *** [Ah 3h Kc 4h] [Jh]
Ewax: checks 
AKl3gi0n: bets $0.25
Ewax: folds 
Uncalled bet ($0.25) returned to AKl3gi0n
AKl3gi0n collected $0.60 from pot
AKl3gi0n: doesn't show hand 
*** SUMMARY ***
Total pot $0.60 | Rake $0 
Board [Ah 3h Kc 4h Jh]
Seat 1: AtrY folded before Flop (didn't bet)
Seat 2: iTsTheGrind folded before Flop (didn't bet)
Seat 3: Just_Million folded before Flop (didn't bet)
Seat 4: GooDSourD folded before Flop (didn't bet)
Seat 5: chessmanA1 folded before Flop (didn't bet)
Seat 6: AKl3gi0n (button) collected ($0.60)
Seat 7: dawinci80 (small blind) folded before Flop
Seat 8: Ewax (big blind) folded on the River
Seat 9: Alameda22 folded before Flop (didn't bet)



PokerStars Game #20097874846:  Hold'em No Limit ($0.10/$0.25) - 2008/09/02 16:54:28 ET
Table 'Varsavia' 9-max Seat #7 is the button
Seat 1: AtrY ($26.40 in chips) 
Seat 3: Just_Million ($25 in chips) 
Seat 4: GooDSourD ($23.15 in chips) 
Seat 5: chessmanA1 ($13.35 in chips) 
Seat 6: AKl3gi0n ($9 in chips) 
Seat 7: dawinci80 ($12.15 in chips) 
Seat 8: Ewax ($24.95 in chips) 
Seat 9: Alameda22 ($27 in chips) 
Ewax: posts small blind $0.10
Alameda22: posts big blind $0.25
*** HOLE CARDS ***
Dealt to Alameda22 [4d 7d]
AtrY: folds 
Just_Million: folds 
GooDSourD: folds 
chessmanA1: folds 
AKl3gi0n: calls $0.25
dawinci80: folds 
Moschek joins the table at seat #2 
Ewax: folds 
Alameda22: checks 
*** FLOP *** [Jd 3d Ts]
Alameda22: bets $0.50
AKl3gi0n: calls $0.50
*** TURN *** [Jd 3d Ts] [Qh]
Alameda22: checks 
AKl3gi0n: bets $0.50
Alameda22: folds 
Uncalled bet ($0.50) returned to AKl3gi0n
AKl3gi0n collected $1.55 from pot
AKl3gi0n: doesn't show hand 
*** SUMMARY ***
Total pot $1.60 | Rake $0.05 
Board [Jd 3d Ts Qh]
Seat 1: AtrY folded before Flop (didn't bet)
Seat 3: Just_Million folded before Flop (didn't bet)
Seat 4: GooDSourD folded before Flop (didn't bet)
Seat 5: chessmanA1 folded before Flop (didn't bet)
Seat 6: AKl3gi0n collected ($1.55)
Seat 7: dawinci80 (button) folded before Flop (didn't bet)
Seat 8: Ewax (small blind) folded before Flop
Seat 9: Alameda22 (big blind) folded on the Turn



PokerStars Game #20097910729:  Hold'em No Limit ($0.10/$0.25) - 2008/09/02 16:55:55 ET
Table 'Varsavia' 9-max Seat #8 is the button
Seat 1: AtrY ($26.40 in chips) 
Seat 2: Moschek ($5 in chips) 
Seat 3: Just_Million ($25 in chips) 
Seat 4: GooDSourD ($23.15 in chips) 
Seat 5: chessmanA1 ($13.35 in chips) 
Seat 6: AKl3gi0n ($9.80 in chips) 
Seat 7: dawinci80 ($12.15 in chips) 
Seat 8: Ewax ($24.85 in chips) 
Seat 9: Alameda22 ($26.25 in chips) 
Alameda22: posts small blind $0.10
AtrY: posts big blind $0.25
Moschek: posts big blind $0.25
*** HOLE CARDS ***
Dealt to Alameda22 [7h 7d]
Moschek: checks 
Just_Million: folds 
GooDSourD: folds 
chessmanA1: folds 
AKl3gi0n: calls $0.25
dawinci80: folds 
Ewax: folds 
Alameda22: calls $0.15
AtrY: checks 
*** FLOP *** [3d Th Qc]
Alameda22: checks 
AtrY: checks 
Moschek: bets $0.50
AKl3gi0n: calls $0.50
Alameda22: folds 
AtrY: folds 
*** TURN *** [3d Th Qc] [4h]
Moschek: checks 
AKl3gi0n: checks 
*** RIVER *** [3d Th Qc 4h] [3s]
Moschek: bets $0.50
AKl3gi0n: folds 
Uncalled bet ($0.50) returned to Moschek
Moschek collected $1.95 from pot
Moschek: doesn't show hand 
*** SUMMARY ***
Total pot $2 | Rake $0.05 
Board [3d Th Qc 4h 3s]
Seat 1: AtrY (big blind) folded on the Flop
Seat 2: Moschek collected ($1.95)
Seat 3: Just_Million folded before Flop (didn't bet)
Seat 4: GooDSourD folded before Flop (didn't bet)
Seat 5: chessmanA1 folded before Flop (didn't bet)
Seat 6: AKl3gi0n folded on the River
Seat 7: dawinci80 folded before Flop (didn't bet)
Seat 8: Ewax (button) folded before Flop (didn't bet)
Seat 9: Alameda22 (small blind) folded on the Flop



PokerStars Game #20097942046:  Hold'em No Limit ($0.10/$0.25) - 2008/09/02 16:57:12 ET
Table 'Varsavia' 9-max Seat #9 is the button
Seat 1: AtrY ($26.15 in chips) 
Seat 2: Moschek ($6.20 in chips) 
Seat 3: Just_Million ($25 in chips) 
Seat 4: GooDSourD ($25 in chips) 
Seat 5: chessmanA1 ($13.35 in chips) 
Seat 6: AKl3gi0n ($9.05 in chips) 
Seat 7: dawinci80 ($12.15 in chips) 
Seat 8: Ewax ($24.85 in chips) 
Seat 9: Alameda22 ($26 in chips) 
AtrY: posts small blind $0.10
Moschek: posts big blind $0.25
*** HOLE CARDS ***
Dealt to Alameda22 [Kc Jd]
Just_Million: folds 
GooDSourD: folds 
chessmanA1: folds 
AKl3gi0n: folds 
dawinci80: folds 
Ewax: folds 
Alameda22: folds 
AtrY: folds 
Uncalled bet ($0.15) returned to Moschek
Moschek collected $0.20 from pot
Moschek: doesn't show hand 
*** SUMMARY ***
Total pot $0.20 | Rake $0 
Seat 1: AtrY (small blind) folded before Flop
Seat 2: Moschek (big blind) collected ($0.20)
Seat 3: Just_Million folded before Flop (didn't bet)
Seat 4: GooDSourD folded before Flop (didn't bet)
Seat 5: chessmanA1 folded before Flop (didn't bet)
Seat 6: AKl3gi0n folded before Flop (didn't bet)
Seat 7: dawinci80 folded before Flop (didn't bet)
Seat 8: Ewax folded before Flop (didn't bet)
Seat 9: Alameda22 (button) folded before Flop (didn't bet)



PokerStars Game #20097960622:  Hold'em No Limit ($0.10/$0.25) - 2008/09/02 16:57:59 ET
Table 'Varsavia' 9-max Seat #1 is the button
Seat 1: AtrY ($26.05 in chips) 
Seat 2: Moschek ($6.30 in chips) 
Seat 3: Just_Million ($25 in chips) 
Seat 4: GooDSourD ($25 in chips) 
Seat 5: chessmanA1 ($13.35 in chips) 
Seat 6: AKl3gi0n ($9.05 in chips) 
Seat 7: dawinci80 ($12.15 in chips) 
Seat 8: Ewax ($24.85 in chips) 
Seat 9: Alameda22 ($26 in chips) 
Moschek: posts small blind $0.10
Just_Million: posts big blind $0.25
*** HOLE CARDS ***
Dealt to Alameda22 [8d 3h]
GooDSourD: folds 
chessmanA1: folds 
AKl3gi0n: calls $0.25
dawinci80: folds 
Ewax: folds 
Alameda22: folds 
AtrY: folds 
Moschek: calls $0.15
Just_Million: checks 
*** FLOP *** [8h Tc 5d]
Moschek: bets $0.50
Just_Million: folds 
AKl3gi0n: calls $0.50
*** TURN *** [8h Tc 5d] [Qh]
Moschek: bets $1
AKl3gi0n: calls $1
*** RIVER *** [8h Tc 5d Qh] [9h]
Moschek: bets $0.50
AKl3gi0n: raises $2 to $2.50
Moschek: calls $2
*** SHOW DOWN ***
AKl3gi0n: shows [Jh Td] (a straight, Eight to Queen)
Moschek: shows [Js 6h] (a straight, Eight to Queen)
Moschek collected $4.20 from pot
AKl3gi0n collected $4.15 from pot
*** SUMMARY ***
Total pot $8.75 | Rake $0.40 
Board [8h Tc 5d Qh 9h]
Seat 1: AtrY (button) folded before Flop (didn't bet)
Seat 2: Moschek (small blind) showed [Js 6h] and won ($4.20) with a straight, Eight to Queen
Seat 3: Just_Million (big blind) folded on the Flop
Seat 4: GooDSourD folded before Flop (didn't bet)
Seat 5: chessmanA1 folded before Flop (didn't bet)
Seat 6: AKl3gi0n showed [Jh Td] and won ($4.15) with a straight, Eight to Queen
Seat 7: dawinci80 folded before Flop (didn't bet)
Seat 8: Ewax folded before Flop (didn't bet)
Seat 9: Alameda22 folded before Flop (didn't bet)



PokerStars Game #20097996692:  Hold'em No Limit ($0.10/$0.25) - 2008/09/02 16:59:27 ET
Table 'Varsavia' 9-max Seat #2 is the button
Seat 1: AtrY ($26.05 in chips) 
Seat 2: Moschek ($6.25 in chips) 
Seat 3: Just_Million ($24.75 in chips) 
Seat 4: GooDSourD ($25 in chips) 
Seat 5: chessmanA1 ($13.35 in chips) 
Seat 6: AKl3gi0n ($8.95 in chips) 
Seat 7: dawinci80 ($12.15 in chips) 
Seat 8: Ewax ($24.85 in chips) 
Seat 9: Alameda22 ($26 in chips) 
Just_Million: posts small blind $0.10
GooDSourD: posts big blind $0.25
*** HOLE CARDS ***
Dealt to Alameda22 [2h 4s]
chessmanA1: folds 
AKl3gi0n: folds 
dawinci80: folds 
Ewax: folds 
Alameda22: folds 
AtrY: folds 
Moschek: folds 
Just_Million: raises $0.50 to $0.75
GooDSourD: folds 
Uncalled bet ($0.50) returned to Just_Million
Just_Million collected $0.50 from pot
Just_Million: doesn't show hand 
*** SUMMARY ***
Total pot $0.50 | Rake $0 
Seat 1: AtrY folded before Flop (didn't bet)
Seat 2: Moschek (button) folded before Flop (didn't bet)
Seat 3: Just_Million (small blind) collected ($0.50)
Seat 4: GooDSourD (big blind) folded before Flop
Seat 5: chessmanA1 folded before Flop (didn't bet)
Seat 6: AKl3gi0n folded before Flop (didn't bet)
Seat 7: dawinci80 folded before Flop (didn't bet)
Seat 8: Ewax folded before Flop (didn't bet)
Seat 9: Alameda22 folded before Flop (didn't bet)



PokerStars Game #20098020493:  Hold'em No Limit ($0.10/$0.25) - 2008/09/02 17:00:23 ET
Table 'Varsavia' 9-max Seat #3 is the button
Seat 1: AtrY ($26.05 in chips) 
Seat 2: Moschek ($6.25 in chips) 
Seat 3: Just_Million ($25 in chips) 
Seat 4: GooDSourD ($24.75 in chips) 
Seat 5: chessmanA1 ($13.35 in chips) 
Seat 6: AKl3gi0n ($8.95 in chips) 
Seat 7: dawinci80 ($12.15 in chips) 
Seat 8: Ewax ($24.85 in chips) 
Seat 9: Alameda22 ($26 in chips) 
GooDSourD: posts small blind $0.10
chessmanA1: posts big blind $0.25
*** HOLE CARDS ***
Dealt to Alameda22 [Jd 9c]
AKl3gi0n: folds 
dawinci80: calls $0.25
Ewax: folds 
Alameda22: folds 
AtrY: folds 
Moschek: folds 
Just_Million: folds 
GooDSourD: folds 
chessmanA1: checks 
*** FLOP *** [Td 9h 3d]
chessmanA1: checks 
dawinci80: bets $0.25
chessmanA1: calls $0.25
*** TURN *** [Td 9h 3d] [As]
chessmanA1: checks 
dawinci80: bets $0.50
chessmanA1: folds 
Uncalled bet ($0.50) returned to dawinci80
dawinci80 collected $1.05 from pot
*** SUMMARY ***
Total pot $1.10 | Rake $0.05 
Board [Td 9h 3d As]
Seat 1: AtrY folded before Flop (didn't bet)
Seat 2: Moschek folded before Flop (didn't bet)
Seat 3: Just_Million (button) folded before Flop (didn't bet)
Seat 4: GooDSourD (small blind) folded before Flop
Seat 5: chessmanA1 (big blind) folded on the Turn
Seat 6: AKl3gi0n folded before Flop (didn't bet)
Seat 7: dawinci80 collected ($1.05)
Seat 8: Ewax folded before Flop (didn't bet)
Seat 9: Alameda22 folded before Flop (didn't bet)



PokerStars Game #20098053565:  Hold'em No Limit ($0.10/$0.25) - 2008/09/02 17:01:41 ET
Table 'Varsavia' 9-max Seat #4 is the button
Seat 1: AtrY ($26.05 in chips) 
Seat 2: Moschek ($6.25 in chips) 
Seat 3: Just_Million ($25 in chips) 
Seat 4: GooDSourD ($24.65 in chips) 
Seat 5: chessmanA1 ($12.85 in chips) 
Seat 6: AKl3gi0n ($8.95 in chips) 
Seat 7: dawinci80 ($12.70 in chips) 
Seat 8: Ewax ($24.85 in chips) 
Seat 9: Alameda22 ($26 in chips) 
chessmanA1: posts small blind $0.10
AKl3gi0n: posts big blind $0.25
*** HOLE CARDS ***
Dealt to Alameda22 [Qd Ah]
dawinci80: folds 
Ewax: folds 
Alameda22: raises $0.75 to $1
AtrY: raises $2 to $3
Moschek: folds 
Just_Million: folds 
GooDSourD: folds 
chessmanA1: folds 
AKl3gi0n: folds 
Alameda22: folds 
Uncalled bet ($2) returned to AtrY
AtrY collected $2.35 from pot
AtrY: doesn't show hand 
*** SUMMARY ***
Total pot $2.35 | Rake $0 
Seat 1: AtrY collected ($2.35)
Seat 2: Moschek folded before Flop (didn't bet)
Seat 3: Just_Million folded before Flop (didn't bet)
Seat 4: GooDSourD (button) folded before Flop (didn't bet)
Seat 5: chessmanA1 (small blind) folded before Flop
Seat 6: AKl3gi0n (big blind) folded before Flop
Seat 7: dawinci80 folded before Flop (didn't bet)
Seat 8: Ewax folded before Flop (didn't bet)
Seat 9: Alameda22 folded before Flop



PokerStars Game #20098076723:  Hold'em No Limit ($0.10/$0.25) - 2008/09/02 17:02:35 ET
Table 'Varsavia' 9-max Seat #5 is the button
Seat 1: AtrY ($27.40 in chips) 
Seat 2: Moschek ($6.25 in chips) 
Seat 3: Just_Million ($25 in chips) 
Seat 4: GooDSourD ($24.65 in chips) 
Seat 5: chessmanA1 ($12.75 in chips) 
Seat 6: AKl3gi0n ($8.70 in chips) 
Seat 7: dawinci80 ($12.70 in chips) 
Seat 8: Ewax ($24.85 in chips) 
Seat 9: Alameda22 ($25 in chips) 
AKl3gi0n: posts small blind $0.10
dawinci80: posts big blind $0.25
*** HOLE CARDS ***
Dealt to Alameda22 [7c 6c]
Ewax: folds 
Alameda22: folds 
AtrY: folds 
Moschek: folds 
Just_Million: folds 
GooDSourD: raises $0.75 to $1
AtrY leaves the table
chessmanA1: folds 
AKl3gi0n: calls $0.90
dawinci80: calls $0.75
*** FLOP *** [7s 4s 6d]
AKl3gi0n: bets $0.50
dawinci80: raises $0.50 to $1
GooDSourD: folds 
AKl3gi0n: calls $0.50
*** TURN *** [7s 4s 6d] [7d]
AKl3gi0n: checks 
dawinci80: bets $1
AKl3gi0n: calls $1
*** RIVER *** [7s 4s 6d 7d] [3d]
AKl3gi0n: checks 
dawinci80: checks 
*** SHOW DOWN ***
AKl3gi0n: shows [2s 2c] (two pair, Sevens and Deuces)
dawinci80: shows [8d 8h] (two pair, Eights and Sevens)
dawinci80 collected $6.70 from pot
*** SUMMARY ***
Total pot $7 | Rake $0.30 
Board [7s 4s 6d 7d 3d]
Seat 1: AtrY folded before Flop (didn't bet)
Seat 2: Moschek folded before Flop (didn't bet)
Seat 3: Just_Million folded before Flop (didn't bet)
Seat 4: GooDSourD folded on the Flop
Seat 5: chessmanA1 (button) folded before Flop (didn't bet)
Seat 6: AKl3gi0n (small blind) showed [2s 2c] and lost with two pair, Sevens and Deuces
Seat 7: dawinci80 (big blind) showed [8d 8h] and won ($6.70) with two pair, Eights and Sevens
Seat 8: Ewax folded before Flop (didn't bet)
Seat 9: Alameda22 folded before Flop (didn't bet)



PokerStars Game #20098121334:  Hold'em No Limit ($0.10/$0.25) - 2008/09/02 17:04:19 ET
Table 'Varsavia' 9-max Seat #6 is the button
Seat 2: Moschek ($6.25 in chips) 
Seat 3: Just_Million ($25 in chips) 
Seat 4: GooDSourD ($23.65 in chips) 
Seat 5: chessmanA1 ($12.75 in chips) 
Seat 6: AKl3gi0n ($5.70 in chips) 
Seat 7: dawinci80 ($16.40 in chips) 
Seat 8: Ewax ($24.85 in chips) 
Seat 9: Alameda22 ($25 in chips) 
dawinci80: posts small blind $0.10
Ewax: posts big blind $0.25
*** HOLE CARDS ***
Dealt to Alameda22 [Kh 3d]
Alameda22: folds 
Moschek: folds 
Just_Million: folds 
GooDSourD: folds 
chessmanA1: folds 
AKl3gi0n: calls $0.25
dawinci80: calls $0.15
Ewax: checks 
*** FLOP *** [2c 7h Tc]
dawinci80: checks 
Ewax: checks 
AKl3gi0n: bets $0.25
dawinci80: folds 
Ewax: calls $0.25
*** TURN *** [2c 7h Tc] [8s]
Ewax: checks 
AKl3gi0n: bets $0.25
Ewax: raises $0.75 to $1
AKl3gi0n: folds 
Uncalled bet ($0.75) returned to Ewax
Ewax collected $1.70 from pot
Ewax: doesn't show hand 
*** SUMMARY ***
Total pot $1.75 | Rake $0.05 
Board [2c 7h Tc 8s]
Seat 2: Moschek folded before Flop (didn't bet)
Seat 3: Just_Million folded before Flop (didn't bet)
Seat 4: GooDSourD folded before Flop (didn't bet)
Seat 5: chessmanA1 folded before Flop (didn't bet)
Seat 6: AKl3gi0n (button) folded on the Turn
Seat 7: dawinci80 (small blind) folded on the Flop
Seat 8: Ewax (big blind) collected ($1.70)
Seat 9: Alameda22 folded before Flop (didn't bet)



PokerStars Game #20098144145:  Hold'em No Limit ($0.10/$0.25) - 2008/09/02 17:05:13 ET
Table 'Varsavia' 9-max Seat #7 is the button
Seat 2: Moschek ($6.25 in chips) 
Seat 3: Just_Million ($25 in chips) 
Seat 4: GooDSourD ($23.65 in chips) 
Seat 5: chessmanA1 ($12.75 in chips) 
Seat 6: AKl3gi0n ($4.95 in chips) 
Seat 7: dawinci80 ($16.15 in chips) 
Seat 8: Ewax ($25.80 in chips) 
Seat 9: Alameda22 ($25 in chips) 
Ewax: posts small blind $0.10
Alameda22: posts big blind $0.25
*** HOLE CARDS ***
Dealt to Alameda22 [Qd Js]
Moschek: folds 
Just_Million: folds 
GooDSourD: folds 
Logan 2o joins the table at seat #1 
chessmanA1: folds 
AKl3gi0n: folds 
dawinci80: folds 
Ewax: folds 
Uncalled bet ($0.15) returned to Alameda22
Alameda22 collected $0.20 from pot
Alameda22: doesn't show hand 
*** SUMMARY ***
Total pot $0.20 | Rake $0 
Seat 2: Moschek folded before Flop (didn't bet)
Seat 3: Just_Million folded before Flop (didn't bet)
Seat 4: GooDSourD folded before Flop (didn't bet)
Seat 5: chessmanA1 folded before Flop (didn't bet)
Seat 6: AKl3gi0n folded before Flop (didn't bet)
Seat 7: dawinci80 (button) folded before Flop (didn't bet)
Seat 8: Ewax (small blind) folded before Flop
Seat 9: Alameda22 (big blind) collected ($0.20)



PokerStars Game #20098152974:  Hold'em No Limit ($0.10/$0.25) - 2008/09/02 17:05:34 ET
Table 'Varsavia' 9-max Seat #8 is the button
Seat 1: Logan 2o ($10 in chips) 
Seat 2: Moschek ($6.25 in chips) 
Seat 3: Just_Million ($25 in chips) 
Seat 4: GooDSourD ($23.65 in chips) 
Seat 5: chessmanA1 ($12.75 in chips) 
Seat 6: AKl3gi0n ($4.95 in chips) 
Seat 7: dawinci80 ($16.15 in chips) 
Seat 8: Ewax ($25.70 in chips) 
Seat 9: Alameda22 ($25.10 in chips) 
Alameda22: posts small blind $0.10
Logan 2o: posts big blind $0.25
*** HOLE CARDS ***
Dealt to Alameda22 [6h 4h]
Moschek: raises $0.75 to $1
Just_Million: folds 
GooDSourD: folds 
chessmanA1: folds 
AKl3gi0n: raises $3.95 to $4.95 and is all-in
dawinci80: folds 
Ewax: folds 
Alameda22: folds 
Logan 2o: folds 
Moschek: calls $3.95
*** FLOP *** [3s 9d Qd]
*** TURN *** [3s 9d Qd] [7s]
*** RIVER *** [3s 9d Qd 7s] [7d]
*** SHOW DOWN ***
Moschek: shows [5c Ad] (a pair of Sevens)
AKl3gi0n: mucks hand 
Moschek collected $9.75 from pot
*** SUMMARY ***
Total pot $10.25 | Rake $0.50 
Board [3s 9d Qd 7s 7d]
Seat 1: Logan 2o (big blind) folded before Flop
Seat 2: Moschek showed [5c Ad] and won ($9.75) with a pair of Sevens
Seat 3: Just_Million folded before Flop (didn't bet)
Seat 4: GooDSourD folded before Flop (didn't bet)
Seat 5: chessmanA1 folded before Flop (didn't bet)
Seat 6: AKl3gi0n mucked [Ks Jc]
Seat 7: dawinci80 folded before Flop (didn't bet)
Seat 8: Ewax (button) folded before Flop (didn't bet)
Seat 9: Alameda22 (small blind) folded before Flop



PokerStars Game #20098177800:  Hold'em No Limit ($0.10/$0.25) - 2008/09/02 17:06:32 ET
Table 'Varsavia' 9-max Seat #9 is the button
Seat 1: Logan 2o ($9.75 in chips) 
Seat 2: Moschek ($11.05 in chips) 
Seat 3: Just_Million ($25 in chips) 
Seat 4: GooDSourD ($23.65 in chips) 
Seat 5: chessmanA1 ($12.75 in chips) 
Seat 7: dawinci80 ($16.15 in chips) 
Seat 8: Ewax ($25.70 in chips) 
Seat 9: Alameda22 ($25 in chips) 
Logan 2o: posts small blind $0.10
Moschek: posts big blind $0.25
*** HOLE CARDS ***
Dealt to Alameda22 [Ac 2d]
Just_Million: folds 
AKl3gi0n has returned
GooDSourD: folds 
chessmanA1: folds 
dawinci80: folds 
Ewax: raises $0.75 to $1
Alameda22: folds 
Logan 2o: folds 
Moschek: folds 
Uncalled bet ($0.75) returned to Ewax
Ewax collected $0.60 from pot
Ewax: doesn't show hand 
*** SUMMARY ***
Total pot $0.60 | Rake $0 
Seat 1: Logan 2o (small blind) folded before Flop
Seat 2: Moschek (big blind) folded before Flop
Seat 3: Just_Million folded before Flop (didn't bet)
Seat 4: GooDSourD folded before Flop (didn't bet)
Seat 5: chessmanA1 folded before Flop (didn't bet)
Seat 7: dawinci80 folded before Flop (didn't bet)
Seat 8: Ewax collected ($0.60)
Seat 9: Alameda22 (button) folded before Flop (didn't bet)



PokerStars Game #20098195849:  Hold'em No Limit ($0.10/$0.25) - 2008/09/02 17:07:14 ET
Table 'Varsavia' 9-max Seat #1 is the button
Seat 1: Logan 2o ($9.65 in chips) 
Seat 2: Moschek ($10.80 in chips) 
Seat 3: Just_Million ($25 in chips) 
Seat 4: GooDSourD ($23.65 in chips) 
Seat 5: chessmanA1 ($12.75 in chips) 
Seat 6: AKl3gi0n ($19.80 in chips) 
Seat 7: dawinci80 ($16.15 in chips) 
Seat 8: Ewax ($26.05 in chips) 
Seat 9: Alameda22 ($25 in chips) 
Moschek: posts small blind $0.10
Just_Million: posts big blind $0.25
*** HOLE CARDS ***
Dealt to Alameda22 [8c Qc]
GooDSourD: folds 
chessmanA1: folds 
AKl3gi0n: folds 
dawinci80: folds 
Ewax: folds 
Alameda22: folds 
Logan 2o: raises $0.25 to $0.50
Moschek: raises $1 to $1.50
Just_Million: folds 
Logan 2o: calls $1
*** FLOP *** [6s 5s Ac]
Moschek: bets $1.50
Logan 2o: calls $1.50
*** TURN *** [6s 5s Ac] [7h]
Moschek: bets $1.50
Just_Million leaves the table
Logan 2o: calls $1.50
*** RIVER *** [6s 5s Ac 7h] [Kd]
Moschek: bets $6.30 and is all-in
Logan 2o: calls $5.15 and is all-in
Uncalled bet ($1.15) returned to Moschek
*** SHOW DOWN ***
Moschek: shows [Qh Ah] (a pair of Aces)
Logan 2o: mucks hand 
Moschek collected $18.60 from pot
*** SUMMARY ***
Total pot $19.55 | Rake $0.95 
Board [6s 5s Ac 7h Kd]
Seat 1: Logan 2o (button) mucked [2s As]
Seat 2: Moschek (small blind) showed [Qh Ah] and won ($18.60) with a pair of Aces
Seat 3: Just_Million (big blind) folded before Flop
Seat 4: GooDSourD folded before Flop (didn't bet)
Seat 5: chessmanA1 folded before Flop (didn't bet)
Seat 6: AKl3gi0n folded before Flop (didn't bet)
Seat 7: dawinci80 folded before Flop (didn't bet)
Seat 8: Ewax folded before Flop (didn't bet)
Seat 9: Alameda22 folded before Flop (didn't bet)



PokerStars Game #20098229094:  Hold'em No Limit ($0.10/$0.25) - 2008/09/02 17:08:32 ET
Table 'Varsavia' 9-max Seat #2 is the button
Seat 2: Moschek ($19.75 in chips) 
Seat 4: GooDSourD ($23.65 in chips) 
Seat 6: AKl3gi0n ($19.80 in chips) 
Seat 7: dawinci80 ($16.15 in chips) 
Seat 8: Ewax ($26.05 in chips) 
Seat 9: Alameda22 ($25 in chips) 
GooDSourD: posts small blind $0.10
Logan 2o leaves the table
chessmanA1: is sitting out 
AKl3gi0n: posts big blind $0.25
*** HOLE CARDS ***
Dealt to Alameda22 [Ks Td]
chessmanA1 leaves the table
dawinci80: folds 
Ewax: folds 
Alameda22: folds 
Moschek: folds 
GooDSourD: raises $0.75 to $1
AKl3gi0n: calls $0.75
*** FLOP *** [7h 6c Kc]
GooDSourD: bets $1.25
AKl3gi0n: raises $1.25 to $2.50
GooDSourD: folds 
Uncalled bet ($1.25) returned to AKl3gi0n
AKl3gi0n collected $4.30 from pot
AKl3gi0n: doesn't show hand 
*** SUMMARY ***
Total pot $4.50 | Rake $0.20 
Board [7h 6c Kc]
Seat 2: Moschek (button) folded before Flop (didn't bet)
Seat 4: GooDSourD (small blind) folded on the Flop
Seat 6: AKl3gi0n (big blind) collected ($4.30)
Seat 7: dawinci80 folded before Flop (didn't bet)
Seat 8: Ewax folded before Flop (didn't bet)
Seat 9: Alameda22 folded before Flop (didn't bet)



PokerStars Game #20098254118:  Hold'em No Limit ($0.10/$0.25) - 2008/09/02 17:09:31 ET
Table 'Varsavia' 9-max Seat #4 is the button
Seat 2: Moschek ($19.75 in chips) 
Seat 4: GooDSourD ($21.40 in chips) 
Seat 6: AKl3gi0n ($21.85 in chips) 
Seat 7: dawinci80 ($16.15 in chips) 
Seat 8: Ewax ($26.05 in chips) 
Seat 9: Alameda22 ($25 in chips) 
AKl3gi0n: posts small blind $0.10
dawinci80: posts big blind $0.25
*** HOLE CARDS ***
Dealt to Alameda22 [7h 7s]
Ewax: folds 
Alameda22: folds 
Moschek: folds 
GooDSourD: folds 
AKl3gi0n: calls $0.15
dawinci80: checks 
*** FLOP *** [Th 9s Kd]
AKl3gi0n: bets $0.25
dawinci80: calls $0.25
*** TURN *** [Th 9s Kd] [4c]
AKl3gi0n: bets $0.50
dawinci80: calls $0.50
*** RIVER *** [Th 9s Kd 4c] [Qd]
AKl3gi0n: bets $1
dawinci80: raises $1 to $2
AKl3gi0n: calls $1
*** SHOW DOWN ***
dawinci80: shows [Jc 2c] (a straight, Nine to King)
AKl3gi0n: mucks hand 
dawinci80 collected $5.75 from pot
*** SUMMARY ***
Total pot $6 | Rake $0.25 
Board [Th 9s Kd 4c Qd]
Seat 2: Moschek folded before Flop (didn't bet)
Seat 4: GooDSourD (button) folded before Flop (didn't bet)
Seat 6: AKl3gi0n (small blind) mucked [9c Ks]
Seat 7: dawinci80 (big blind) showed [Jc 2c] and won ($5.75) with a straight, Nine to King
Seat 8: Ewax folded before Flop (didn't bet)
Seat 9: Alameda22 folded before Flop (didn't bet)



PokerStars Game #20098269776:  Hold'em No Limit ($0.10/$0.25) - 2008/09/02 17:10:07 ET
Table 'Varsavia' 9-max Seat #6 is the button
Seat 2: Moschek ($19.75 in chips) 
Seat 4: GooDSourD ($21.40 in chips) 
Seat 6: AKl3gi0n ($18.85 in chips) 
Seat 7: dawinci80 ($18.90 in chips) 
Seat 9: Alameda22 ($25 in chips) 
dawinci80: posts small blind $0.10
Ewax: is sitting out 
Alameda22: posts big blind $0.25
*** HOLE CARDS ***
Dealt to Alameda22 [7c Kh]
Ewax leaves the table
Moschek: raises $1.25 to $1.50
GooDSourD: folds 
AKl3gi0n: folds 
dawinci80: folds 
Alameda22: folds 
Uncalled bet ($1.25) returned to Moschek
Moschek collected $0.60 from pot
Moschek: doesn't show hand 
*** SUMMARY ***
Total pot $0.60 | Rake $0 
Seat 2: Moschek collected ($0.60)
Seat 4: GooDSourD folded before Flop (didn't bet)
Seat 6: AKl3gi0n (button) folded before Flop (didn't bet)
Seat 7: dawinci80 (small blind) folded before Flop
Seat 9: Alameda22 (big blind) folded before Flop



PokerStars Game #20098290120:  Hold'em No Limit ($0.10/$0.25) - 2008/09/02 17:10:55 ET
Table 'Varsavia' 9-max Seat #7 is the button
Seat 6: AKl3gi0n ($18.85 in chips) 
Seat 7: dawinci80 ($18.80 in chips) 
Seat 9: Alameda22 ($24.75 in chips) 
Alameda22: posts small blind $0.10
Moschek: is sitting out 
Moschek leaves the table
GooDSourD: is sitting out 
AKl3gi0n: posts big blind $0.25
*** HOLE CARDS ***
Dealt to Alameda22 [8s Ac]
dawinci80: raises $0.75 to $1
Alameda22: folds 
AKl3gi0n: folds 
Uncalled bet ($0.75) returned to dawinci80
dawinci80 collected $0.60 from pot
*** SUMMARY ***
Total pot $0.60 | Rake $0 
Seat 6: AKl3gi0n (big blind) folded before Flop
Seat 7: dawinci80 (button) collected ($0.60)
Seat 9: Alameda22 (small blind) folded before Flop



